index,date,season,year,month,hour,holiday,weekday,working_day,weather_situation,temperature,feels_like_temperature,humidity,wind_speed,casual_users,registered_users,total_rentals,calculated_total_rentals,is_total_rentals_correct
1,2011-01-01,1,0,1,0,0,6,0,1,0.24,0.2879,0.81,0.0,3,13,16,16,True
2,2011-01-01,1,0,1,1,0,6,0,1,0.22,0.2727,0.8,0.0,8,32,40,40,True
3,2011-01-01,1,0,1,2,0,6,0,1,0.22,0.2727,0.8,0.0,5,27,32,32,True
4,2011-01-01,1,0,1,3,0,6,0,1,0.24,0.2879,0.75,0.0,3,10,13,13,True
5,2011-01-01,1,0,1,4,0,6,0,1,0.24,0.2879,0.75,0.0,0,1,1,1,True
6,2011-01-01,1,0,1,5,0,6,0,2,0.24,0.2576,0.75,0.0896,0,1,1,1,True
7,2011-01-01,1,0,1,6,0,6,0,1,0.22,0.2727,0.8,0.0,2,0,2,2,True
8,2011-01-01,1,0,1,7,0,6,0,1,0.2,0.2576,0.86,0.0,1,2,3,3,True
9,2011-01-01,1,0,1,8,0,6,0,1,0.24,0.2879,0.75,0.0,1,7,8,8,True
10,2011-01-01,1,0,1,9,0,6,0,1,0.32,0.3485,0.76,0.0,8,6,14,14,True
11,2011-01-01,1,0,1,10,0,6,0,1,0.38,0.3939,0.76,0.2537,12,24,36,36,True
12,2011-01-01,1,0,1,11,0,6,0,1,0.36,0.3333,0.81,0.2836,26,30,56,56,True
13,2011-01-01,1,0,1,12,0,6,0,1,0.42,0.4242,0.77,0.2836,29,55,84,84,True
14,2011-01-01,1,0,1,13,0,6,0,2,0.46,0.4545,0.72,0.2985,47,47,94,94,True
15,2011-01-01,1,0,1,14,0,6,0,2,0.46,0.4545,0.72,0.2836,35,71,106,106,True
16,2011-01-01,1,0,1,15,0,6,0,2,0.44,0.4394,0.77,0.2985,40,70,110,110,True
17,2011-01-01,1,0,1,16,0,6,0,2,0.42,0.4242,0.82,0.2985,41,52,93,93,True
18,2011-01-01,1,0,1,17,0,6,0,2,0.44,0.4394,0.82,0.2836,15,52,67,67,True
19,2011-01-01,1,0,1,18,0,6,0,3,0.42,0.4242,0.88,0.2537,9,26,35,35,True
20,2011-01-01,1,0,1,19,0,6,0,3,0.42,0.4242,0.88,0.2537,6,31,37,37,True
21,2011-01-01,1,0,1,20,0,6,0,2,0.4,0.4091,0.87,0.2537,11,25,36,36,True
22,2011-01-01,1,0,1,21,0,6,0,2,0.4,0.4091,0.87,0.194,3,31,34,34,True
23,2011-01-01,1,0,1,22,0,6,0,2,0.4,0.4091,0.94,0.2239,11,17,28,28,True
24,2011-01-01,1,0,1,23,0,6,0,2,0.46,0.4545,0.88,0.2985,15,24,39,39,True
25,2011-01-02,1,0,1,0,0,0,0,2,0.46,0.4545,0.88,0.2985,4,13,17,17,True
26,2011-01-02,1,0,1,1,0,0,0,2,0.44,0.4394,0.94,0.2537,1,16,17,17,True
27,2011-01-02,1,0,1,2,0,0,0,2,0.42,0.4242,1.0,0.2836,1,8,9,9,True
28,2011-01-02,1,0,1,3,0,0,0,2,0.46,0.4545,0.94,0.194,2,4,6,6,True
29,2011-01-02,1,0,1,4,0,0,0,2,0.46,0.4545,0.94,0.194,2,1,3,3,True
30,2011-01-02,1,0,1,6,0,0,0,3,0.42,0.4242,0.77,0.2985,0,2,2,2,True
31,2011-01-02,1,0,1,7,0,0,0,2,0.4,0.4091,0.76,0.194,0,1,1,1,True
32,2011-01-02,1,0,1,8,0,0,0,3,0.4,0.4091,0.71,0.2239,0,8,8,8,True
33,2011-01-02,1,0,1,9,0,0,0,2,0.38,0.3939,0.76,0.2239,1,19,20,20,True
34,2011-01-02,1,0,1,10,0,0,0,2,0.36,0.3485,0.81,0.2239,7,46,53,53,True
35,2011-01-02,1,0,1,11,0,0,0,2,0.36,0.3333,0.71,0.2537,16,54,70,70,True
36,2011-01-02,1,0,1,12,0,0,0,2,0.36,0.3333,0.66,0.2985,20,73,93,93,True
37,2011-01-02,1,0,1,13,0,0,0,2,0.36,0.3485,0.66,0.1343,11,64,75,75,True
38,2011-01-02,1,0,1,14,0,0,0,3,0.36,0.3485,0.76,0.194,4,55,59,59,True
39,2011-01-02,1,0,1,15,0,0,0,3,0.34,0.3333,0.81,0.1642,19,55,74,74,True
40,2011-01-02,1,0,1,16,0,0,0,3,0.34,0.3333,0.71,0.1642,9,67,76,76,True
41,2011-01-02,1,0,1,17,0,0,0,1,0.34,0.3333,0.57,0.194,7,58,65,65,True
42,2011-01-02,1,0,1,18,0,0,0,2,0.36,0.3333,0.46,0.3284,10,43,53,53,True
43,2011-01-02,1,0,1,19,0,0,0,1,0.32,0.2879,0.42,0.4478,1,29,30,30,True
44,2011-01-02,1,0,1,20,0,0,0,1,0.3,0.2727,0.39,0.3582,5,17,22,22,True
45,2011-01-02,1,0,1,21,0,0,0,1,0.26,0.2273,0.44,0.3284,11,20,31,31,True
46,2011-01-02,1,0,1,22,0,0,0,1,0.24,0.2121,0.44,0.2985,0,9,9,9,True
47,2011-01-02,1,0,1,23,0,0,0,1,0.22,0.2273,0.47,0.1642,0,8,8,8,True
48,2011-01-03,1,0,1,0,0,1,1,1,0.22,0.197,0.44,0.3582,0,5,5,5,True
49,2011-01-03,1,0,1,1,0,1,1,1,0.2,0.1667,0.44,0.4179,0,2,2,2,True
50,2011-01-03,1,0,1,4,0,1,1,1,0.16,0.1364,0.47,0.3881,0,1,1,1,True
51,2011-01-03,1,0,1,5,0,1,1,1,0.16,0.1364,0.47,0.2836,0,3,3,3,True
52,2011-01-03,1,0,1,6,0,1,1,1,0.14,0.1061,0.5,0.3881,0,30,30,30,True
53,2011-01-03,1,0,1,7,0,1,1,1,0.14,0.1364,0.5,0.194,1,63,64,64,True
54,2011-01-03,1,0,1,8,0,1,1,1,0.14,0.1212,0.5,0.2836,1,153,154,154,True
55,2011-01-03,1,0,1,9,0,1,1,1,0.16,0.1364,0.43,0.3881,7,81,88,88,True
56,2011-01-03,1,0,1,10,0,1,1,1,0.18,0.1667,0.43,0.2537,11,33,44,44,True
57,2011-01-03,1,0,1,11,0,1,1,1,0.2,0.1818,0.4,0.3284,10,41,51,51,True
58,2011-01-03,1,0,1,12,0,1,1,1,0.22,0.2121,0.35,0.2985,13,48,61,61,True
59,2011-01-03,1,0,1,13,0,1,1,1,0.24,0.2121,0.35,0.2836,8,53,61,61,True
60,2011-01-03,1,0,1,14,0,1,1,1,0.26,0.2424,0.3,0.2836,11,66,77,77,True
61,2011-01-03,1,0,1,15,0,1,1,1,0.26,0.2424,0.3,0.2537,14,58,72,72,True
62,2011-01-03,1,0,1,16,0,1,1,1,0.26,0.2424,0.3,0.2537,9,67,76,76,True
63,2011-01-03,1,0,1,17,0,1,1,1,0.24,0.2273,0.3,0.2239,11,146,157,157,True
64,2011-01-03,1,0,1,18,0,1,1,1,0.24,0.2576,0.32,0.1045,9,148,157,157,True
65,2011-01-03,1,0,1,19,0,1,1,1,0.2,0.2576,0.47,0.0,8,102,110,110,True
66,2011-01-03,1,0,1,20,0,1,1,1,0.2,0.2273,0.47,0.1045,3,49,52,52,True
67,2011-01-03,1,0,1,21,0,1,1,1,0.18,0.197,0.64,0.1343,3,49,52,52,True
68,2011-01-03,1,0,1,22,0,1,1,1,0.14,0.1515,0.69,0.1343,0,20,20,20,True
69,2011-01-03,1,0,1,23,0,1,1,1,0.18,0.2121,0.55,0.1045,1,11,12,12,True
70,2011-01-04,1,0,1,0,0,2,1,1,0.16,0.1818,0.55,0.1045,0,5,5,5,True
71,2011-01-04,1,0,1,1,0,2,1,1,0.16,0.1818,0.59,0.1045,0,2,2,2,True
72,2011-01-04,1,0,1,2,0,2,1,1,0.14,0.1515,0.63,0.1343,0,1,1,1,True
73,2011-01-04,1,0,1,4,0,2,1,1,0.14,0.1818,0.63,0.0896,0,2,2,2,True
74,2011-01-04,1,0,1,5,0,2,1,1,0.12,0.1515,0.68,0.1045,0,4,4,4,True
75,2011-01-04,1,0,1,6,0,2,1,1,0.12,0.1515,0.74,0.1045,0,36,36,36,True
76,2011-01-04,1,0,1,7,0,2,1,1,0.12,0.1515,0.74,0.1343,2,92,94,94,True
77,2011-01-04,1,0,1,8,0,2,1,1,0.14,0.1515,0.69,0.1642,2,177,179,179,True
78,2011-01-04,1,0,1,9,0,2,1,1,0.16,0.1515,0.64,0.2239,2,98,100,100,True
79,2011-01-04,1,0,1,10,0,2,1,2,0.16,0.1364,0.69,0.3284,5,37,42,42,True
80,2011-01-04,1,0,1,11,0,2,1,1,0.22,0.2121,0.51,0.2985,7,50,57,57,True
81,2011-01-04,1,0,1,12,0,2,1,1,0.22,0.2273,0.51,0.1642,12,66,78,78,True
82,2011-01-04,1,0,1,13,0,2,1,1,0.24,0.2273,0.56,0.194,18,79,97,97,True
83,2011-01-04,1,0,1,14,0,2,1,1,0.26,0.2576,0.52,0.2239,9,54,63,63,True
84,2011-01-04,1,0,1,15,0,2,1,1,0.28,0.2727,0.52,0.2537,17,48,65,65,True
85,2011-01-04,1,0,1,16,0,2,1,1,0.3,0.2879,0.49,0.2537,15,68,83,83,True
86,2011-01-04,1,0,1,17,0,2,1,1,0.28,0.2727,0.48,0.2239,10,202,212,212,True
87,2011-01-04,1,0,1,18,0,2,1,1,0.26,0.2576,0.48,0.194,3,179,182,182,True
88,2011-01-04,1,0,1,19,0,2,1,1,0.24,0.2576,0.48,0.1045,2,110,112,112,True
89,2011-01-04,1,0,1,20,0,2,1,1,0.24,0.2576,0.48,0.1045,1,53,54,54,True
90,2011-01-04,1,0,1,21,0,2,1,1,0.22,0.2727,0.64,0.0,0,48,48,48,True
91,2011-01-04,1,0,1,22,0,2,1,1,0.22,0.2576,0.64,0.0896,1,34,35,35,True
92,2011-01-04,1,0,1,23,0,2,1,1,0.2,0.2273,0.69,0.0896,2,9,11,11,True
93,2011-01-05,1,0,1,0,0,3,1,1,0.2,0.2576,0.64,0.0,0,6,6,6,True
94,2011-01-05,1,0,1,1,0,3,1,1,0.16,0.197,0.74,0.0896,0,6,6,6,True
95,2011-01-05,1,0,1,2,0,3,1,1,0.16,0.197,0.74,0.0896,0,2,2,2,True
96,2011-01-05,1,0,1,4,0,3,1,1,0.24,0.2273,0.48,0.2239,0,2,2,2,True
97,2011-01-05,1,0,1,5,0,3,1,1,0.22,0.2273,0.47,0.1642,0,3,3,3,True
98,2011-01-05,1,0,1,6,0,3,1,1,0.2,0.197,0.47,0.2239,0,33,33,33,True
99,2011-01-05,1,0,1,7,0,3,1,1,0.18,0.1818,0.43,0.194,1,87,88,88,True
100,2011-01-05,1,0,1,8,0,3,1,1,0.2,0.1818,0.4,0.2985,3,192,195,195,True
101,2011-01-05,1,0,1,9,0,3,1,1,0.22,0.197,0.37,0.3284,6,109,115,115,True
102,2011-01-05,1,0,1,10,0,3,1,1,0.22,0.197,0.37,0.3284,4,53,57,57,True
103,2011-01-05,1,0,1,11,0,3,1,1,0.26,0.2273,0.33,0.3284,12,34,46,46,True
104,2011-01-05,1,0,1,12,0,3,1,1,0.26,0.2273,0.33,0.3284,5,74,79,79,True
105,2011-01-05,1,0,1,13,0,3,1,1,0.28,0.2576,0.3,0.2985,6,65,71,71,True
106,2011-01-05,1,0,1,14,0,3,1,1,0.3,0.2879,0.28,0.194,10,52,62,62,True
107,2011-01-05,1,0,1,15,0,3,1,1,0.3,0.2879,0.28,0.194,7,55,62,62,True
108,2011-01-05,1,0,1,16,0,3,1,1,0.3,0.3182,0.28,0.0896,4,85,89,89,True
109,2011-01-05,1,0,1,17,0,3,1,1,0.24,0.2273,0.38,0.194,4,186,190,190,True
110,2011-01-05,1,0,1,18,0,3,1,1,0.24,0.2424,0.38,0.1343,3,166,169,169,True
111,2011-01-05,1,0,1,19,0,3,1,1,0.24,0.2576,0.38,0.1045,5,127,132,132,True
112,2011-01-05,1,0,1,20,0,3,1,1,0.22,0.2273,0.47,0.1642,7,82,89,89,True
113,2011-01-05,1,0,1,21,0,3,1,1,0.2,0.197,0.51,0.194,3,40,43,43,True
114,2011-01-05,1,0,1,22,0,3,1,1,0.18,0.197,0.55,0.1343,1,41,42,42,True
115,2011-01-05,1,0,1,23,0,3,1,1,0.2,0.2576,0.47,0.0,1,18,19,19,True
116,2011-01-06,1,0,1,0,0,4,1,1,0.18,0.2424,0.55,0.0,0,11,11,11,True
117,2011-01-06,1,0,1,1,0,4,1,1,0.16,0.2273,0.64,0.0,0,4,4,4,True
118,2011-01-06,1,0,1,2,0,4,1,1,0.16,0.2273,0.64,0.0,0,2,2,2,True
119,2011-01-06,1,0,1,4,0,4,1,2,0.16,0.197,0.64,0.0896,0,1,1,1,True
120,2011-01-06,1,0,1,5,0,4,1,2,0.14,0.1818,0.69,0.0896,0,4,4,4,True
121,2011-01-06,1,0,1,6,0,4,1,2,0.14,0.1667,0.63,0.1045,0,36,36,36,True
122,2011-01-06,1,0,1,7,0,4,1,2,0.16,0.2273,0.59,0.0,0,95,95,95,True
123,2011-01-06,1,0,1,8,0,4,1,1,0.16,0.2273,0.59,0.0,3,216,219,219,True
124,2011-01-06,1,0,1,9,0,4,1,2,0.18,0.2424,0.51,0.0,6,116,122,122,True
125,2011-01-06,1,0,1,10,0,4,1,1,0.2,0.2576,0.47,0.0,3,42,45,45,True
126,2011-01-06,1,0,1,11,0,4,1,1,0.22,0.2576,0.44,0.0896,2,57,59,59,True
127,2011-01-06,1,0,1,12,0,4,1,1,0.26,0.2879,0.35,0.0,6,78,84,84,True
128,2011-01-06,1,0,1,13,0,4,1,1,0.26,0.2727,0.35,0.1045,12,55,67,67,True
129,2011-01-06,1,0,1,14,0,4,1,1,0.28,0.2727,0.36,0.1642,11,59,70,70,True
130,2011-01-06,1,0,1,15,0,4,1,1,0.28,0.2727,0.36,0.0,8,54,62,62,True
131,2011-01-06,1,0,1,16,0,4,1,1,0.26,0.2576,0.38,0.1642,12,74,86,86,True
132,2011-01-06,1,0,1,17,0,4,1,1,0.22,0.2273,0.51,0.1642,9,163,172,172,True
133,2011-01-06,1,0,1,18,0,4,1,1,0.22,0.2273,0.51,0.1343,5,158,163,163,True
134,2011-01-06,1,0,1,19,0,4,1,1,0.22,0.2576,0.55,0.0896,3,109,112,112,True
135,2011-01-06,1,0,1,20,0,4,1,1,0.2,0.2121,0.51,0.1642,3,66,69,69,True
136,2011-01-06,1,0,1,21,0,4,1,2,0.22,0.2121,0.55,0.2239,0,48,48,48,True
137,2011-01-06,1,0,1,22,0,4,1,2,0.22,0.2121,0.51,0.2836,1,51,52,52,True
138,2011-01-06,1,0,1,23,0,4,1,2,0.2,0.197,0.59,0.194,4,19,23,23,True
139,2011-01-07,1,0,1,0,0,5,1,2,0.2,0.197,0.64,0.194,4,13,17,17,True
140,2011-01-07,1,0,1,1,0,5,1,2,0.2,0.197,0.69,0.2239,2,5,7,7,True
141,2011-01-07,1,0,1,2,0,5,1,2,0.2,0.197,0.69,0.2239,0,1,1,1,True
142,2011-01-07,1,0,1,4,0,5,1,2,0.2,0.2121,0.69,0.1343,0,1,1,1,True
143,2011-01-07,1,0,1,5,0,5,1,3,0.22,0.2727,0.55,0.0,0,5,5,5,True
144,2011-01-07,1,0,1,6,0,5,1,2,0.2,0.2576,0.69,0.0,8,26,34,34,True
145,2011-01-07,1,0,1,7,0,5,1,1,0.2,0.2121,0.69,0.1343,8,76,84,84,True
146,2011-01-07,1,0,1,8,0,5,1,1,0.2,0.197,0.51,0.2537,20,190,210,210,True
147,2011-01-07,1,0,1,9,0,5,1,1,0.2,0.1818,0.47,0.2985,9,125,134,134,True
148,2011-01-07,1,0,1,10,0,5,1,1,0.22,0.197,0.37,0.3284,16,47,63,63,True
149,2011-01-07,1,0,1,11,0,5,1,2,0.2,0.197,0.4,0.2239,19,48,67,67,True
150,2011-01-07,1,0,1,12,0,5,1,2,0.2,0.197,0.37,0.2537,9,50,59,59,True
151,2011-01-07,1,0,1,13,0,5,1,2,0.2,0.1818,0.37,0.2836,9,64,73,73,True
152,2011-01-07,1,0,1,14,0,5,1,2,0.2,0.197,0.4,0.2537,7,43,50,50,True
153,2011-01-07,1,0,1,15,0,5,1,2,0.2,0.2121,0.37,0.1642,9,63,72,72,True
154,2011-01-07,1,0,1,16,0,5,1,2,0.2,0.2121,0.37,0.1642,5,82,87,87,True
155,2011-01-07,1,0,1,17,0,5,1,2,0.2,0.2576,0.37,0.0,9,178,187,187,True
156,2011-01-07,1,0,1,18,0,5,1,1,0.2,0.2273,0.4,0.0896,7,116,123,123,True
157,2011-01-07,1,0,1,19,0,5,1,1,0.16,0.197,0.55,0.0896,3,92,95,95,True
158,2011-01-07,1,0,1,20,0,5,1,1,0.18,0.2121,0.47,0.1045,1,50,51,51,True
159,2011-01-07,1,0,1,21,0,5,1,1,0.18,0.197,0.47,0.1343,0,39,39,39,True
160,2011-01-07,1,0,1,22,0,5,1,2,0.18,0.197,0.43,0.1642,2,34,36,36,True
161,2011-01-07,1,0,1,23,0,5,1,2,0.18,0.197,0.51,0.1642,1,14,15,15,True
162,2011-01-08,1,0,1,0,0,6,0,2,0.18,0.197,0.51,0.1642,1,24,25,25,True
163,2011-01-08,1,0,1,1,0,6,0,2,0.18,0.2121,0.55,0.0896,1,15,16,16,True
164,2011-01-08,1,0,1,2,0,6,0,2,0.18,0.2424,0.55,0.0,3,13,16,16,True
165,2011-01-08,1,0,1,3,0,6,0,3,0.18,0.197,0.55,0.1642,0,7,7,7,True
166,2011-01-08,1,0,1,4,0,6,0,3,0.18,0.197,0.55,0.1642,0,1,1,1,True
167,2011-01-08,1,0,1,5,0,6,0,2,0.16,0.1667,0.74,0.1642,0,5,5,5,True
168,2011-01-08,1,0,1,6,0,6,0,2,0.16,0.1667,0.74,0.1642,0,2,2,2,True
169,2011-01-08,1,0,1,7,0,6,0,2,0.16,0.1818,0.74,0.1045,1,8,9,9,True
170,2011-01-08,1,0,1,8,0,6,0,3,0.16,0.1818,0.93,0.1045,0,15,15,15,True
171,2011-01-08,1,0,1,9,0,6,0,3,0.16,0.1818,0.93,0.1045,0,20,20,20,True
172,2011-01-08,1,0,1,10,0,6,0,2,0.18,0.197,0.8,0.1642,5,56,61,61,True
173,2011-01-08,1,0,1,11,0,6,0,2,0.2,0.1818,0.69,0.3881,2,60,62,62,True
174,2011-01-08,1,0,1,12,0,6,0,2,0.2,0.1818,0.59,0.3582,8,90,98,98,True
175,2011-01-08,1,0,1,13,0,6,0,1,0.2,0.1818,0.44,0.3284,7,95,102,102,True
176,2011-01-08,1,0,1,14,0,6,0,1,0.2,0.1667,0.32,0.4775,12,83,95,95,True
177,2011-01-08,1,0,1,15,0,6,0,1,0.2,0.1667,0.32,0.4478,5,69,74,74,True
178,2011-01-08,1,0,1,16,0,6,0,1,0.18,0.1364,0.29,0.4478,8,68,76,76,True
179,2011-01-08,1,0,1,17,0,6,0,1,0.16,0.1212,0.37,0.4775,5,64,69,69,True
180,2011-01-08,1,0,1,18,0,6,0,1,0.14,0.1212,0.39,0.2985,3,52,55,55,True
181,2011-01-08,1,0,1,19,0,6,0,1,0.14,0.1212,0.36,0.2537,4,26,30,30,True
182,2011-01-08,1,0,1,20,0,6,0,1,0.12,0.1212,0.36,0.2537,0,28,28,28,True
183,2011-01-08,1,0,1,21,0,6,0,1,0.12,0.1061,0.39,0.3582,2,35,37,37,True
184,2011-01-08,1,0,1,22,0,6,0,1,0.12,0.1061,0.36,0.3881,1,33,34,34,True
185,2011-01-08,1,0,1,23,0,6,0,1,0.1,0.0606,0.39,0.4478,0,22,22,22,True
186,2011-01-09,1,0,1,0,0,0,0,1,0.1,0.0758,0.42,0.3881,1,24,25,25,True
187,2011-01-09,1,0,1,1,0,0,0,1,0.1,0.0606,0.42,0.4627,0,12,12,12,True
188,2011-01-09,1,0,1,2,0,0,0,1,0.1,0.0606,0.46,0.4627,0,11,11,11,True
189,2011-01-09,1,0,1,3,0,0,0,1,0.1,0.0758,0.46,0.4179,0,4,4,4,True
190,2011-01-09,1,0,1,4,0,0,0,1,0.08,0.0909,0.53,0.194,0,1,1,1,True
191,2011-01-09,1,0,1,5,0,0,0,1,0.08,0.0909,0.53,0.194,0,1,1,1,True
192,2011-01-09,1,0,1,6,0,0,0,1,0.1,0.0909,0.49,0.2836,0,1,1,1,True
193,2011-01-09,1,0,1,7,0,0,0,1,0.08,0.0909,0.53,0.194,1,5,6,6,True
194,2011-01-09,1,0,1,8,0,0,0,1,0.1,0.0909,0.49,0.2836,0,10,10,10,True
195,2011-01-09,1,0,1,9,0,0,0,1,0.12,0.0758,0.46,0.4775,0,19,19,19,True
196,2011-01-09,1,0,1,10,0,0,0,1,0.14,0.1061,0.43,0.3881,0,49,49,49,True
197,2011-01-09,1,0,1,11,0,0,0,1,0.16,0.1212,0.4,0.4775,2,47,49,49,True
198,2011-01-09,1,0,1,12,0,0,0,1,0.18,0.1364,0.37,0.4478,4,79,83,83,True
199,2011-01-09,1,0,1,13,0,0,0,1,0.2,0.1667,0.34,0.4478,6,69,75,75,True
200,2011-01-09,1,0,1,14,0,0,0,1,0.22,0.1818,0.32,0.4627,8,64,72,72,True
201,2011-01-09,1,0,1,15,0,0,0,1,0.22,0.197,0.35,0.3582,5,77,82,82,True
202,2011-01-09,1,0,1,16,0,0,0,1,0.2,0.1667,0.34,0.4478,13,79,92,92,True
203,2011-01-09,1,0,1,17,0,0,0,1,0.18,0.1515,0.37,0.3881,3,59,62,62,True
204,2011-01-09,1,0,1,18,0,0,0,1,0.16,0.1364,0.4,0.3284,4,44,48,48,True
205,2011-01-09,1,0,1,19,0,0,0,1,0.16,0.1364,0.43,0.3284,1,40,41,41,True
206,2011-01-09,1,0,1,20,0,0,0,1,0.14,0.1212,0.46,0.2537,0,38,38,38,True
207,2011-01-09,1,0,1,21,0,0,0,1,0.14,0.1061,0.46,0.4179,1,19,20,20,True
208,2011-01-09,1,0,1,22,0,0,0,1,0.14,0.1212,0.46,0.2985,5,10,15,15,True
209,2011-01-09,1,0,1,23,0,0,0,1,0.12,0.1364,0.5,0.194,0,6,6,6,True
210,2011-01-10,1,0,1,0,0,1,1,1,0.12,0.1212,0.5,0.2836,2,3,5,5,True
211,2011-01-10,1,0,1,1,0,1,1,1,0.12,0.1212,0.5,0.2836,1,0,1,1,True
212,2011-01-10,1,0,1,2,0,1,1,1,0.12,0.1212,0.5,0.2239,0,3,3,3,True
213,2011-01-10,1,0,1,3,0,1,1,1,0.12,0.1212,0.5,0.2239,0,1,1,1,True
214,2011-01-10,1,0,1,4,0,1,1,1,0.1,0.1212,0.54,0.1343,1,2,3,3,True
215,2011-01-10,1,0,1,5,0,1,1,1,0.1,0.1061,0.54,0.2537,0,3,3,3,True
216,2011-01-10,1,0,1,6,0,1,1,1,0.12,0.1212,0.5,0.2836,0,31,31,31,True
217,2011-01-10,1,0,1,7,0,1,1,1,0.12,0.1212,0.5,0.2239,2,75,77,77,True
218,2011-01-10,1,0,1,8,0,1,1,2,0.12,0.1212,0.5,0.2836,4,184,188,188,True
219,2011-01-10,1,0,1,9,0,1,1,2,0.14,0.1212,0.5,0.2537,2,92,94,94,True
220,2011-01-10,1,0,1,10,0,1,1,2,0.14,0.1212,0.5,0.2985,0,31,31,31,True
221,2011-01-10,1,0,1,11,0,1,1,2,0.16,0.1364,0.47,0.2836,2,28,30,30,True
222,2011-01-10,1,0,1,12,0,1,1,2,0.2,0.1818,0.4,0.2836,5,47,52,52,True
223,2011-01-10,1,0,1,13,0,1,1,2,0.2,0.1818,0.4,0.2836,4,50,54,54,True
224,2011-01-10,1,0,1,14,0,1,1,2,0.2,0.197,0.4,0.2239,0,47,47,47,True
225,2011-01-10,1,0,1,15,0,1,1,2,0.2,0.197,0.4,0.2239,2,43,45,45,True
226,2011-01-10,1,0,1,16,0,1,1,1,0.2,0.2121,0.4,0.1343,4,70,74,74,True
227,2011-01-10,1,0,1,17,0,1,1,1,0.2,0.2273,0.4,0.1045,4,174,178,178,True
228,2011-01-10,1,0,1,18,0,1,1,1,0.2,0.197,0.4,0.2239,1,154,155,155,True
229,2011-01-10,1,0,1,19,0,1,1,1,0.16,0.1667,0.47,0.1642,3,92,95,95,True
230,2011-01-10,1,0,1,20,0,1,1,1,0.16,0.1667,0.5,0.1642,1,73,74,74,True
231,2011-01-10,1,0,1,21,0,1,1,1,0.14,0.1364,0.59,0.194,1,37,38,38,True
232,2011-01-10,1,0,1,22,0,1,1,1,0.14,0.1515,0.59,0.1642,2,22,24,24,True
233,2011-01-10,1,0,1,23,0,1,1,1,0.14,0.1515,0.59,0.1642,0,18,18,18,True
234,2011-01-11,1,0,1,0,0,2,1,1,0.14,0.1667,0.59,0.1045,2,10,12,12,True
235,2011-01-11,1,0,1,1,0,2,1,1,0.14,0.1515,0.59,0.1642,0,3,3,3,True
236,2011-01-11,1,0,1,2,0,2,1,2,0.16,0.1515,0.55,0.194,0,3,3,3,True
237,2011-01-11,1,0,1,5,0,2,1,2,0.16,0.1818,0.55,0.1343,0,6,6,6,True
238,2011-01-11,1,0,1,6,0,2,1,2,0.16,0.1818,0.55,0.1343,0,27,27,27,True
239,2011-01-11,1,0,1,7,0,2,1,2,0.16,0.2273,0.55,0.0,2,97,99,99,True
240,2011-01-11,1,0,1,8,0,2,1,2,0.18,0.2121,0.51,0.0896,3,214,217,217,True
241,2011-01-11,1,0,1,9,0,2,1,2,0.18,0.197,0.51,0.1642,3,127,130,130,True
242,2011-01-11,1,0,1,10,0,2,1,2,0.2,0.2121,0.51,0.1642,3,51,54,54,True
243,2011-01-11,1,0,1,11,0,2,1,2,0.2,0.2121,0.47,0.1343,4,31,35,35,True
244,2011-01-11,1,0,1,12,0,2,1,2,0.2,0.2273,0.51,0.1045,2,55,57,57,True
245,2011-01-11,1,0,1,13,0,2,1,2,0.2,0.2273,0.59,0.0896,6,46,52,52,True
246,2011-01-11,1,0,1,14,0,2,1,2,0.2,0.2273,0.59,0.0896,3,60,63,63,True
247,2011-01-11,1,0,1,15,0,2,1,2,0.16,0.197,0.8,0.0896,2,45,47,47,True
248,2011-01-11,1,0,1,16,0,2,1,2,0.16,0.1515,0.86,0.2239,4,72,76,76,True
249,2011-01-11,1,0,1,17,0,2,1,2,0.16,0.1515,0.86,0.2239,6,130,136,136,True
250,2011-01-11,1,0,1,18,0,2,1,3,0.16,0.1818,0.93,0.1045,1,94,95,95,True
251,2011-01-11,1,0,1,19,0,2,1,3,0.16,0.2273,0.93,0.0,0,51,51,51,True
252,2011-01-11,1,0,1,20,0,2,1,3,0.16,0.1515,0.93,0.194,0,32,32,32,True
253,2011-01-11,1,0,1,21,0,2,1,3,0.16,0.197,0.86,0.0896,0,20,20,20,True
254,2011-01-11,1,0,1,22,0,2,1,3,0.16,0.1818,0.93,0.1045,1,28,29,29,True
255,2011-01-11,1,0,1,23,0,2,1,3,0.16,0.197,0.93,0.0896,1,18,19,19,True
256,2011-01-12,1,0,1,0,0,3,1,2,0.16,0.197,0.86,0.0896,0,7,7,7,True
257,2011-01-12,1,0,1,1,0,3,1,2,0.16,0.1818,0.86,0.1045,0,6,6,6,True
258,2011-01-12,1,0,1,2,0,3,1,1,0.14,0.1515,0.86,0.1343,0,1,1,1,True
259,2011-01-12,1,0,1,5,0,3,1,1,0.14,0.1515,0.86,0.1642,0,5,5,5,True
260,2011-01-12,1,0,1,6,0,3,1,1,0.12,0.1515,0.93,0.1343,0,16,16,16,True
261,2011-01-12,1,0,1,7,0,3,1,1,0.14,0.1515,0.69,0.1343,0,54,54,54,True
262,2011-01-12,1,0,1,8,0,3,1,1,0.16,0.1667,0.59,0.1642,3,125,128,128,True
263,2011-01-12,1,0,1,9,0,3,1,1,0.16,0.1364,0.59,0.3284,3,78,81,81,True
264,2011-01-12,1,0,1,10,0,3,1,1,0.18,0.1818,0.55,0.2239,0,39,39,39,True
265,2011-01-12,1,0,1,11,0,3,1,1,0.2,0.1818,0.51,0.3881,3,32,35,35,True
266,2011-01-12,1,0,1,12,0,3,1,1,0.2,0.1515,0.47,0.4775,3,52,55,55,True
267,2011-01-12,1,0,1,13,0,3,1,1,0.22,0.197,0.44,0.3582,0,49,49,49,True
268,2011-01-12,1,0,1,14,0,3,1,1,0.2,0.1818,0.47,0.3284,0,44,44,44,True
269,2011-01-12,1,0,1,15,0,3,1,1,0.2,0.1667,0.47,0.4179,1,48,49,49,True
270,2011-01-12,1,0,1,16,0,3,1,1,0.22,0.197,0.44,0.3284,5,63,68,68,True
271,2011-01-12,1,0,1,17,0,3,1,1,0.2,0.1818,0.47,0.3582,0,139,139,139,True
272,2011-01-12,1,0,1,18,0,3,1,1,0.2,0.1515,0.47,0.4775,2,135,137,137,True
273,2011-01-12,1,0,1,19,0,3,1,1,0.18,0.1515,0.47,0.4179,1,82,83,83,True
274,2011-01-12,1,0,1,20,0,3,1,1,0.16,0.1364,0.5,0.3284,2,54,56,56,True
275,2011-01-12,1,0,1,21,0,3,1,1,0.16,0.1364,0.55,0.3284,0,57,57,57,True
276,2011-01-12,1,0,1,22,0,3,1,1,0.16,0.1212,0.55,0.4478,1,32,33,33,True
277,2011-01-12,1,0,1,23,0,3,1,1,0.14,0.1061,0.59,0.4179,1,19,20,20,True
278,2011-01-13,1,0,1,0,0,4,1,1,0.14,0.1212,0.59,0.2836,1,6,7,7,True
279,2011-01-13,1,0,1,1,0,4,1,1,0.14,0.1212,0.5,0.2836,0,2,2,2,True
280,2011-01-13,1,0,1,2,0,4,1,1,0.14,0.1212,0.5,0.3582,0,2,2,2,True
281,2011-01-13,1,0,1,3,0,4,1,1,0.14,0.1212,0.5,0.3284,0,3,3,3,True
282,2011-01-13,1,0,1,4,0,4,1,1,0.14,0.1212,0.5,0.2537,0,4,4,4,True
283,2011-01-13,1,0,1,5,0,4,1,1,0.14,0.1212,0.5,0.2985,0,3,3,3,True
284,2011-01-13,1,0,1,6,0,4,1,1,0.12,0.1515,0.54,0.1343,0,28,28,28,True
285,2011-01-13,1,0,1,7,0,4,1,1,0.12,0.1515,0.54,0.1343,0,72,72,72,True
286,2011-01-13,1,0,1,8,0,4,1,1,0.14,0.1364,0.5,0.194,5,197,202,202,True
287,2011-01-13,1,0,1,9,0,4,1,1,0.14,0.1212,0.5,0.3284,2,137,139,139,True
288,2011-01-13,1,0,1,10,0,4,1,2,0.16,0.1364,0.5,0.3582,2,36,38,38,True
289,2011-01-13,1,0,1,11,0,4,1,2,0.2,0.1667,0.44,0.4478,4,33,37,37,True
290,2011-01-13,1,0,1,12,0,4,1,1,0.2,0.1667,0.44,0.4179,3,49,52,52,True
291,2011-01-13,1,0,1,13,0,4,1,1,0.22,0.197,0.41,0.4478,2,81,83,83,True
292,2011-01-13,1,0,1,14,0,4,1,1,0.22,0.197,0.41,0.3881,3,39,42,42,True
293,2011-01-13,1,0,1,15,0,4,1,1,0.24,0.2121,0.38,0.2985,5,55,60,60,True
294,2011-01-13,1,0,1,16,0,4,1,1,0.24,0.2121,0.38,0.3582,2,76,78,78,True
295,2011-01-13,1,0,1,17,0,4,1,1,0.2,0.1818,0.4,0.2836,4,158,162,162,True
296,2011-01-13,1,0,1,18,0,4,1,1,0.2,0.1818,0.4,0.3284,3,141,144,144,True
297,2011-01-13,1,0,1,19,0,4,1,1,0.16,0.1515,0.47,0.2537,1,98,99,99,True
298,2011-01-13,1,0,1,20,0,4,1,1,0.16,0.1515,0.47,0.2239,0,64,64,64,True
299,2011-01-13,1,0,1,21,0,4,1,1,0.14,0.1212,0.46,0.2985,0,40,40,40,True
300,2011-01-13,1,0,1,22,0,4,1,1,0.14,0.1212,0.46,0.3284,0,30,30,30,True
301,2011-01-13,1,0,1,23,0,4,1,1,0.12,0.1364,0.5,0.194,1,14,15,15,True
302,2011-01-14,1,0,1,0,0,5,1,1,0.12,0.1364,0.5,0.194,0,14,14,14,True
303,2011-01-14,1,0,1,1,0,5,1,1,0.1,0.1212,0.54,0.1642,0,5,5,5,True
304,2011-01-14,1,0,1,2,0,5,1,1,0.1,0.1212,0.54,0.1343,0,1,1,1,True
305,2011-01-14,1,0,1,3,0,5,1,1,0.1,0.1364,0.54,0.1045,0,1,1,1,True
306,2011-01-14,1,0,1,5,0,5,1,1,0.1,0.1364,0.54,0.0896,0,8,8,8,True
307,2011-01-14,1,0,1,6,0,5,1,1,0.1,0.1818,0.54,0.0,0,17,17,17,True
308,2011-01-14,1,0,1,7,0,5,1,1,0.1,0.1212,0.74,0.1642,0,70,70,70,True
309,2011-01-14,1,0,1,8,0,5,1,1,0.12,0.1667,0.68,0.0,2,156,158,158,True
310,2011-01-14,1,0,1,9,0,5,1,1,0.14,0.1515,0.69,0.1343,0,117,117,117,True
311,2011-01-14,1,0,1,10,0,5,1,1,0.18,0.1818,0.55,0.194,4,40,44,44,True
312,2011-01-14,1,0,1,11,0,5,1,1,0.18,0.1667,0.51,0.2836,6,47,53,53,True
313,2011-01-14,1,0,1,12,0,5,1,1,0.2,0.197,0.44,0.2537,2,59,61,61,True
314,2011-01-14,1,0,1,13,0,5,1,1,0.22,0.197,0.37,0.3881,4,73,77,77,True
315,2011-01-14,1,0,1,14,0,5,1,1,0.22,0.2121,0.41,0.2836,5,59,64,64,True
316,2011-01-14,1,0,1,15,0,5,1,1,0.24,0.2424,0.38,0.1642,9,59,68,68,True
317,2011-01-14,1,0,1,16,0,5,1,1,0.22,0.2424,0.41,0.1045,3,87,90,90,True
318,2011-01-14,1,0,1,17,0,5,1,1,0.22,0.2273,0.41,0.1642,4,155,159,159,True
319,2011-01-14,1,0,1,18,0,5,1,1,0.2,0.2576,0.47,0.0,5,134,139,139,True
320,2011-01-14,1,0,1,19,0,5,1,1,0.16,0.197,0.59,0.0896,3,89,92,92,True
321,2011-01-14,1,0,1,20,0,5,1,1,0.18,0.2424,0.59,0.0,0,68,68,68,True
322,2011-01-14,1,0,1,21,0,5,1,1,0.16,0.2273,0.69,0.0,4,48,52,52,True
323,2011-01-14,1,0,1,22,0,5,1,2,0.16,0.2273,0.69,0.0,2,34,36,36,True
324,2011-01-14,1,0,1,23,0,5,1,2,0.18,0.2424,0.55,0.0,1,26,27,27,True
325,2011-01-15,1,0,1,0,0,6,0,1,0.18,0.2424,0.55,0.0,3,25,28,28,True
326,2011-01-15,1,0,1,1,0,6,0,2,0.16,0.197,0.59,0.0896,2,18,20,20,True
327,2011-01-15,1,0,1,2,0,6,0,2,0.16,0.197,0.59,0.0896,0,12,12,12,True
328,2011-01-15,1,0,1,3,0,6,0,2,0.16,0.2273,0.59,0.0,1,7,8,8,True
329,2011-01-15,1,0,1,4,0,6,0,2,0.16,0.2273,0.59,0.0,0,5,5,5,True
330,2011-01-15,1,0,1,5,0,6,0,1,0.16,0.2273,0.59,0.0,0,1,1,1,True
331,2011-01-15,1,0,1,6,0,6,0,1,0.14,0.1667,0.63,0.1045,1,2,3,3,True
332,2011-01-15,1,0,1,7,0,6,0,1,0.14,0.2121,0.63,0.0,1,9,10,10,True
333,2011-01-15,1,0,1,8,0,6,0,1,0.14,0.1515,0.63,0.1343,1,22,23,23,True
334,2011-01-15,1,0,1,9,0,6,0,1,0.16,0.1818,0.64,0.1343,2,31,33,33,True
335,2011-01-15,1,0,1,10,0,6,0,1,0.18,0.197,0.59,0.1642,2,57,59,59,True
336,2011-01-15,1,0,1,11,0,6,0,1,0.2,0.197,0.55,0.2239,18,54,72,72,True
337,2011-01-15,1,0,1,12,0,6,0,1,0.24,0.2273,0.48,0.2239,15,74,89,89,True
338,2011-01-15,1,0,1,13,0,6,0,1,0.28,0.2576,0.38,0.2985,21,80,101,101,True
339,2011-01-15,1,0,1,14,0,6,0,1,0.3,0.2879,0.39,0.2836,26,92,118,118,True
340,2011-01-15,1,0,1,15,0,6,0,2,0.32,0.3182,0.36,0.194,21,108,129,129,True
341,2011-01-15,1,0,1,16,0,6,0,2,0.34,0.3333,0.34,0.194,33,95,128,128,True
342,2011-01-15,1,0,1,17,0,6,0,2,0.32,0.303,0.36,0.2836,29,54,83,83,True
343,2011-01-15,1,0,1,18,0,6,0,2,0.3,0.2879,0.45,0.2537,15,69,84,84,True
344,2011-01-15,1,0,1,19,0,6,0,2,0.32,0.303,0.39,0.2537,14,60,74,74,True
345,2011-01-15,1,0,1,20,0,6,0,2,0.32,0.303,0.39,0.2537,6,35,41,41,True
346,2011-01-15,1,0,1,21,0,6,0,2,0.32,0.303,0.39,0.2239,6,51,57,57,True
347,2011-01-15,1,0,1,22,0,6,0,2,0.3,0.3182,0.42,0.1045,0,26,26,26,True
348,2011-01-15,1,0,1,23,0,6,0,1,0.3,0.2879,0.45,0.2836,5,39,44,44,True
349,2011-01-16,1,0,1,0,0,0,0,1,0.26,0.303,0.56,0.0,6,33,39,39,True
350,2011-01-16,1,0,1,1,0,0,0,1,0.26,0.2727,0.56,0.1343,4,19,23,23,True
351,2011-01-16,1,0,1,2,0,0,0,1,0.26,0.2879,0.56,0.0896,3,13,16,16,True
352,2011-01-16,1,0,1,3,0,0,0,1,0.22,0.2727,0.69,0.0,9,6,15,15,True
353,2011-01-16,1,0,1,4,0,0,0,1,0.26,0.2576,0.56,0.1642,0,1,1,1,True
354,2011-01-16,1,0,1,5,0,0,0,2,0.26,0.2576,0.56,0.1642,1,1,2,2,True
355,2011-01-16,1,0,1,6,0,0,0,2,0.26,0.2576,0.56,0.1642,0,1,1,1,True
356,2011-01-16,1,0,1,7,0,0,0,2,0.24,0.2121,0.56,0.2985,0,3,3,3,True
357,2011-01-16,1,0,1,8,0,0,0,1,0.22,0.2121,0.55,0.2836,0,18,18,18,True
358,2011-01-16,1,0,1,9,0,0,0,1,0.22,0.2121,0.51,0.2537,3,29,32,32,True
359,2011-01-16,1,0,1,10,0,0,0,1,0.22,0.2121,0.51,0.2836,8,71,79,79,True
360,2011-01-16,1,0,1,11,0,0,0,1,0.24,0.2273,0.44,0.2537,23,70,93,93,True
361,2011-01-16,1,0,1,12,0,0,0,1,0.24,0.2121,0.41,0.2836,29,75,104,104,True
362,2011-01-16,1,0,1,13,0,0,0,1,0.26,0.2273,0.35,0.2985,23,95,118,118,True
363,2011-01-16,1,0,1,14,0,0,0,1,0.28,0.2727,0.36,0.2537,22,69,91,91,True
364,2011-01-16,1,0,1,15,0,0,0,1,0.26,0.2424,0.38,0.2537,35,78,113,113,True
365,2011-01-16,1,0,1,16,0,0,0,1,0.24,0.2273,0.38,0.2239,22,77,99,99,True
366,2011-01-16,1,0,1,17,0,0,0,1,0.22,0.2121,0.37,0.2537,23,82,105,105,True
367,2011-01-16,1,0,1,18,0,0,0,1,0.2,0.2121,0.4,0.1642,11,56,67,67,True
368,2011-01-16,1,0,1,19,0,0,0,1,0.18,0.197,0.47,0.1343,14,47,61,61,True
369,2011-01-16,1,0,1,20,0,0,0,1,0.18,0.197,0.47,0.1642,7,50,57,57,True
370,2011-01-16,1,0,1,21,0,0,0,1,0.18,0.197,0.51,0.1642,6,22,28,28,True
371,2011-01-16,1,0,1,22,0,0,0,2,0.2,0.2121,0.49,0.1343,2,19,21,21,True
372,2011-01-16,1,0,1,23,0,0,0,2,0.2,0.2273,0.4,0.1045,0,18,18,18,True
373,2011-01-17,1,0,1,0,1,1,0,2,0.2,0.197,0.47,0.2239,1,16,17,17,True
374,2011-01-17,1,0,1,1,1,1,0,2,0.2,0.197,0.44,0.194,1,15,16,16,True
375,2011-01-17,1,0,1,2,1,1,0,2,0.18,0.1667,0.43,0.2537,0,8,8,8,True
376,2011-01-17,1,0,1,3,1,1,0,2,0.18,0.1818,0.43,0.194,0,2,2,2,True
377,2011-01-17,1,0,1,4,1,1,0,2,0.18,0.197,0.43,0.1343,1,2,3,3,True
378,2011-01-17,1,0,1,5,1,1,0,2,0.18,0.197,0.43,0.1642,0,1,1,1,True
379,2011-01-17,1,0,1,6,1,1,0,2,0.18,0.1818,0.43,0.194,0,5,5,5,True
380,2011-01-17,1,0,1,7,1,1,0,2,0.16,0.1818,0.5,0.1343,4,9,13,13,True
381,2011-01-17,1,0,1,8,1,1,0,2,0.16,0.1515,0.47,0.2239,3,30,33,33,True
382,2011-01-17,1,0,1,9,1,1,0,2,0.16,0.1515,0.47,0.2239,8,39,47,47,True
383,2011-01-17,1,0,1,10,1,1,0,2,0.16,0.1515,0.5,0.2537,7,50,57,57,True
384,2011-01-17,1,0,1,11,1,1,0,2,0.16,0.1515,0.55,0.194,9,55,64,64,True
385,2011-01-17,1,0,1,12,1,1,0,2,0.18,0.197,0.47,0.1343,10,70,80,80,True
386,2011-01-17,1,0,1,13,1,1,0,2,0.18,0.197,0.47,0.1343,13,80,93,93,True
387,2011-01-17,1,0,1,14,1,1,0,2,0.18,0.2121,0.43,0.1045,12,74,86,86,True
388,2011-01-17,1,0,1,15,1,1,0,2,0.2,0.2121,0.47,0.1642,21,72,93,93,True
389,2011-01-17,1,0,1,16,1,1,0,2,0.2,0.2121,0.47,0.1642,6,76,82,82,True
390,2011-01-17,1,0,1,17,1,1,0,1,0.2,0.197,0.51,0.194,4,67,71,71,True
391,2011-01-17,1,0,1,18,1,1,0,2,0.18,0.1667,0.55,0.2537,7,85,92,92,True
392,2011-01-17,1,0,1,19,1,1,0,3,0.18,0.1818,0.59,0.194,2,58,60,60,True
393,2011-01-17,1,0,1,20,1,1,0,3,0.16,0.1515,0.8,0.194,4,29,33,33,True
394,2011-01-17,1,0,1,21,1,1,0,3,0.16,0.1515,0.8,0.194,3,24,27,27,True
395,2011-01-17,1,0,1,22,1,1,0,3,0.14,0.1212,0.93,0.2537,0,13,13,13,True
396,2011-01-17,1,0,1,23,1,1,0,3,0.16,0.1364,0.86,0.2836,1,3,4,4,True
397,2011-01-18,1,0,1,12,0,2,1,2,0.2,0.1818,0.86,0.3284,0,3,3,3,True
398,2011-01-18,1,0,1,13,0,2,1,2,0.2,0.197,0.86,0.2239,0,22,22,22,True
399,2011-01-18,1,0,1,14,0,2,1,2,0.22,0.2273,0.8,0.1642,2,26,28,28,True
400,2011-01-18,1,0,1,15,0,2,1,2,0.22,0.2273,0.87,0.1642,3,32,35,35,True
401,2011-01-18,1,0,1,16,0,2,1,2,0.22,0.2273,0.87,0.194,0,61,61,61,True
402,2011-01-18,1,0,1,17,0,2,1,2,0.22,0.2273,0.82,0.194,1,124,125,125,True
403,2011-01-18,1,0,1,18,0,2,1,2,0.22,0.2273,0.8,0.1642,1,132,133,133,True
404,2011-01-18,1,0,1,19,0,2,1,2,0.22,0.2273,0.8,0.1343,1,98,99,99,True
405,2011-01-18,1,0,1,20,0,2,1,2,0.22,0.2727,0.87,0.0,0,83,83,83,True
406,2011-01-18,1,0,1,21,0,2,1,2,0.22,0.2424,0.93,0.1045,0,41,41,41,True
407,2011-01-18,1,0,1,22,0,2,1,2,0.22,0.2576,0.93,0.0896,0,33,33,33,True
408,2011-01-18,1,0,1,23,0,2,1,2,0.22,0.2727,0.93,0.0,1,19,20,20,True
409,2011-01-19,1,0,1,0,0,3,1,2,0.22,0.2727,0.93,0.0,0,3,3,3,True
410,2011-01-19,1,0,1,1,0,3,1,3,0.22,0.2273,0.93,0.1343,1,6,7,7,True
411,2011-01-19,1,0,1,2,0,3,1,3,0.22,0.2273,0.93,0.1343,0,3,3,3,True
412,2011-01-19,1,0,1,4,0,3,1,3,0.22,0.2273,0.93,0.1343,1,1,2,2,True
413,2011-01-19,1,0,1,5,0,3,1,2,0.22,0.2576,0.93,0.0896,0,7,7,7,True
414,2011-01-19,1,0,1,6,0,3,1,2,0.22,0.2576,0.93,0.0896,0,32,32,32,True
415,2011-01-19,1,0,1,7,0,3,1,2,0.24,0.2576,0.92,0.1045,1,89,90,90,True
416,2011-01-19,1,0,1,8,0,3,1,2,0.24,0.2576,0.93,0.1045,1,196,197,197,True
417,2011-01-19,1,0,1,9,0,3,1,2,0.24,0.2576,0.93,0.1045,2,107,109,109,True
418,2011-01-19,1,0,1,10,0,3,1,2,0.26,0.2727,0.93,0.1343,1,46,47,47,True
419,2011-01-19,1,0,1,11,0,3,1,2,0.28,0.303,0.87,0.0896,5,47,52,52,True
420,2011-01-19,1,0,1,12,0,3,1,2,0.3,0.3182,0.81,0.0896,5,65,70,70,True
421,2011-01-19,1,0,1,13,0,3,1,1,0.4,0.4091,0.62,0.2836,11,67,78,78,True
422,2011-01-19,1,0,1,14,0,3,1,1,0.4,0.4091,0.58,0.2537,7,68,75,75,True
423,2011-01-19,1,0,1,15,0,3,1,1,0.4,0.4091,0.54,0.2836,4,78,82,82,True
424,2011-01-19,1,0,1,16,0,3,1,1,0.38,0.3939,0.58,0.3881,10,94,104,104,True
425,2011-01-19,1,0,1,17,0,3,1,1,0.36,0.3333,0.57,0.3284,7,190,197,197,True
426,2011-01-19,1,0,1,18,0,3,1,1,0.34,0.3182,0.61,0.2836,5,156,161,161,True
427,2011-01-19,1,0,1,19,0,3,1,1,0.32,0.2879,0.57,0.4179,4,108,112,112,True
428,2011-01-19,1,0,1,20,0,3,1,1,0.32,0.303,0.49,0.2985,2,74,76,76,True
429,2011-01-19,1,0,1,21,0,3,1,1,0.32,0.2879,0.49,0.4179,4,55,59,59,True
430,2011-01-19,1,0,1,22,0,3,1,1,0.3,0.303,0.52,0.1642,6,53,59,59,True
431,2011-01-19,1,0,1,23,0,3,1,1,0.3,0.2727,0.52,0.4627,1,27,28,28,True
432,2011-01-20,1,0,1,0,0,4,1,1,0.26,0.2273,0.56,0.3881,5,8,13,13,True
433,2011-01-20,1,0,1,1,0,4,1,1,0.26,0.2727,0.56,0.0,2,3,5,5,True
434,2011-01-20,1,0,1,2,0,4,1,1,0.26,0.2727,0.56,0.0,0,2,2,2,True
435,2011-01-20,1,0,1,3,0,4,1,1,0.26,0.2576,0.56,0.1642,0,1,1,1,True
436,2011-01-20,1,0,1,4,0,4,1,1,0.26,0.2576,0.56,0.1642,0,1,1,1,True
437,2011-01-20,1,0,1,5,0,4,1,1,0.24,0.2273,0.6,0.2239,0,6,6,6,True
438,2011-01-20,1,0,1,6,0,4,1,1,0.22,0.2121,0.6,0.2239,0,35,35,35,True
439,2011-01-20,1,0,1,7,0,4,1,1,0.22,0.2121,0.55,0.2239,1,100,101,101,True
440,2011-01-20,1,0,1,8,0,4,1,1,0.22,0.2121,0.55,0.2836,2,247,249,249,True
441,2011-01-20,1,0,1,9,0,4,1,2,0.24,0.2273,0.52,0.2239,3,140,143,143,True
442,2011-01-20,1,0,1,10,0,4,1,1,0.26,0.2273,0.48,0.2985,1,56,57,57,True
443,2011-01-20,1,0,1,11,0,4,1,2,0.28,0.2727,0.45,0.1642,5,63,68,68,True
444,2011-01-20,1,0,1,12,0,4,1,2,0.3,0.3333,0.42,0.0,7,77,84,84,True
445,2011-01-20,1,0,1,13,0,4,1,2,0.28,0.2879,0.45,0.1045,12,86,98,98,True
446,2011-01-20,1,0,1,14,0,4,1,2,0.3,0.303,0.45,0.1343,6,75,81,81,True
447,2011-01-20,1,0,1,15,0,4,1,2,0.32,0.3182,0.45,0.194,8,62,70,70,True
448,2011-01-20,1,0,1,16,0,4,1,2,0.3,0.303,0.49,0.1343,8,83,91,91,True
449,2011-01-20,1,0,1,17,0,4,1,2,0.3,0.3182,0.49,0.1045,8,207,215,215,True
450,2011-01-20,1,0,1,18,0,4,1,2,0.26,0.2576,0.56,0.194,1,184,185,185,True
451,2011-01-20,1,0,1,19,0,4,1,1,0.26,0.2273,0.56,0.3284,6,146,152,152,True
452,2011-01-20,1,0,1,20,0,4,1,2,0.26,0.2424,0.6,0.2836,2,124,126,126,True
453,2011-01-20,1,0,1,21,0,4,1,2,0.24,0.2273,0.6,0.2537,3,54,57,57,True
454,2011-01-20,1,0,1,22,0,4,1,2,0.24,0.2121,0.65,0.2836,0,56,56,56,True
455,2011-01-20,1,0,1,23,0,4,1,2,0.24,0.2121,0.65,0.3284,3,28,31,31,True
456,2011-01-21,1,0,1,0,0,5,1,2,0.24,0.2273,0.7,0.2537,1,20,21,21,True
457,2011-01-21,1,0,1,1,0,5,1,2,0.24,0.2273,0.7,0.2537,0,6,6,6,True
458,2011-01-21,1,0,1,2,0,5,1,3,0.24,0.2424,0.75,0.1642,0,2,2,2,True
459,2011-01-21,1,0,1,3,0,5,1,3,0.22,0.2121,0.8,0.2985,0,1,1,1,True
460,2011-01-21,1,0,1,4,0,5,1,2,0.22,0.2576,0.87,0.0896,0,1,1,1,True
461,2011-01-21,1,0,1,5,0,5,1,1,0.24,0.197,0.6,0.4179,1,4,5,5,True
462,2011-01-21,1,0,1,6,0,5,1,1,0.22,0.2121,0.55,0.2537,0,27,27,27,True
463,2011-01-21,1,0,1,7,0,5,1,1,0.2,0.1818,0.51,0.2836,2,66,68,68,True
464,2011-01-21,1,0,1,8,0,5,1,1,0.2,0.1818,0.47,0.3284,7,210,217,217,True
465,2011-01-21,1,0,1,9,0,5,1,1,0.2,0.1818,0.51,0.3582,7,159,166,166,True
466,2011-01-21,1,0,1,10,0,5,1,1,0.2,0.1667,0.47,0.4627,6,57,63,63,True
467,2011-01-21,1,0,1,11,0,5,1,1,0.22,0.1818,0.41,0.4627,6,53,59,59,True
468,2011-01-21,1,0,1,12,0,5,1,1,0.22,0.1818,0.27,0.4775,11,67,78,78,True
469,2011-01-21,1,0,1,13,0,5,1,1,0.2,0.1515,0.21,0.4775,8,65,73,73,True
470,2011-01-21,1,0,1,14,0,5,1,1,0.2,0.1515,0.25,0.4775,6,56,62,62,True
471,2011-01-21,1,0,1,15,0,5,1,1,0.16,0.1212,0.26,0.4478,4,61,65,65,True
472,2011-01-21,1,0,1,16,0,5,1,1,0.16,0.1364,0.26,0.3582,0,97,97,97,True
473,2011-01-21,1,0,1,17,0,5,1,1,0.14,0.1212,0.28,0.3582,10,151,161,161,True
474,2011-01-21,1,0,1,18,0,5,1,1,0.12,0.1212,0.3,0.2537,1,119,120,120,True
475,2011-01-21,1,0,1,19,0,5,1,1,0.12,0.1061,0.3,0.3284,3,93,96,96,True
476,2011-01-21,1,0,1,20,0,5,1,1,0.1,0.0758,0.33,0.4179,1,52,53,53,True
477,2011-01-21,1,0,1,21,0,5,1,1,0.08,0.0758,0.38,0.2836,0,41,41,41,True
478,2011-01-21,1,0,1,22,0,5,1,1,0.06,0.0303,0.41,0.3881,1,33,34,34,True
479,2011-01-21,1,0,1,23,0,5,1,1,0.06,0.0455,0.38,0.3284,0,27,27,27,True
480,2011-01-22,1,0,1,0,0,6,0,1,0.04,0.0303,0.45,0.2537,0,13,13,13,True
481,2011-01-22,1,0,1,1,0,6,0,2,0.04,0.0,0.41,0.3881,3,9,12,12,True
482,2011-01-22,1,0,1,2,0,6,0,2,0.04,0.0303,0.41,0.2537,0,11,11,11,True
483,2011-01-22,1,0,1,3,0,6,0,2,0.04,0.0303,0.41,0.2836,1,6,7,7,True
484,2011-01-22,1,0,1,4,0,6,0,2,0.02,0.0152,0.48,0.2985,0,3,3,3,True
485,2011-01-22,1,0,1,6,0,6,0,2,0.02,0.0303,0.44,0.2239,0,2,2,2,True
486,2011-01-22,1,0,1,7,0,6,0,1,0.02,0.0152,0.44,0.2836,0,8,8,8,True
487,2011-01-22,1,0,1,8,0,6,0,1,0.02,0.0,0.44,0.3284,1,26,27,27,True
488,2011-01-22,1,0,1,9,0,6,0,1,0.04,0.0303,0.41,0.2537,3,37,40,40,True
489,2011-01-22,1,0,1,10,0,6,0,2,0.04,0.0606,0.41,0.1642,3,50,53,53,True
490,2011-01-22,1,0,1,11,0,6,0,2,0.06,0.0758,0.38,0.1343,4,59,63,63,True
491,2011-01-22,1,0,1,12,0,6,0,2,0.06,0.1061,0.38,0.1045,10,60,70,70,True
492,2011-01-22,1,0,1,13,0,6,0,1,0.08,0.1667,0.35,0.0,12,72,84,84,True
493,2011-01-22,1,0,1,14,0,6,0,1,0.1,0.1364,0.33,0.1045,11,64,75,75,True
494,2011-01-22,1,0,1,15,0,6,0,1,0.12,0.1515,0.28,0.0,10,93,103,103,True
495,2011-01-22,1,0,1,16,0,6,0,1,0.12,0.1364,0.28,0.194,11,72,83,83,True
496,2011-01-22,1,0,1,17,0,6,0,1,0.12,0.197,0.28,0.0,8,59,67,67,True
497,2011-01-22,1,0,1,18,0,6,0,1,0.08,0.0909,0.35,0.194,0,54,54,54,True
498,2011-01-22,1,0,1,19,0,6,0,1,0.08,0.1061,0.35,0.1343,6,53,59,59,True
499,2011-01-22,1,0,1,20,0,6,0,1,0.06,0.0758,0.45,0.1642,1,44,45,45,True
500,2011-01-22,1,0,1,21,0,6,0,1,0.06,0.1061,0.41,0.0896,0,39,39,39,True
501,2011-01-22,1,0,1,22,0,6,0,1,0.06,0.1515,0.49,0.0,7,23,30,30,True
502,2011-01-22,1,0,1,23,0,6,0,1,0.04,0.0758,0.57,0.1045,2,31,33,33,True
503,2011-01-23,1,0,1,0,0,0,0,1,0.04,0.0758,0.57,0.1045,2,20,22,22,True
504,2011-01-23,1,0,1,1,0,0,0,1,0.04,0.0758,0.57,0.1045,1,12,13,13,True
505,2011-01-23,1,0,1,2,0,0,0,1,0.02,0.0606,0.62,0.1343,3,15,18,18,True
506,2011-01-23,1,0,1,3,0,0,0,1,0.02,0.0606,0.62,0.1343,1,4,5,5,True
507,2011-01-23,1,0,1,5,0,0,0,2,0.04,0.0758,0.57,0.1045,0,3,3,3,True
508,2011-01-23,1,0,1,6,0,0,0,2,0.04,0.0758,0.57,0.1045,0,1,1,1,True
509,2011-01-23,1,0,1,7,0,0,0,1,0.08,0.1061,0.58,0.1642,1,1,2,2,True
510,2011-01-23,1,0,1,8,0,0,0,1,0.06,0.0758,0.62,0.1642,2,17,19,19,True
511,2011-01-23,1,0,1,9,0,0,0,1,0.1,0.0758,0.54,0.3582,3,25,28,28,True
512,2011-01-23,1,0,1,10,0,0,0,1,0.14,0.1061,0.46,0.3881,7,51,58,58,True
513,2011-01-23,1,0,1,11,0,0,0,1,0.14,0.1364,0.43,0.2239,22,77,99,99,True
514,2011-01-23,1,0,1,12,0,0,0,1,0.16,0.1212,0.37,0.4627,24,92,116,116,True
515,2011-01-23,1,0,1,13,0,0,0,1,0.14,0.1061,0.33,0.3881,12,75,87,87,True
516,2011-01-23,1,0,1,14,0,0,0,1,0.16,0.1364,0.28,0.3582,17,93,110,110,True
517,2011-01-23,1,0,1,15,0,0,0,1,0.16,0.1364,0.28,0.3582,13,64,77,77,True
518,2011-01-23,1,0,1,16,0,0,0,1,0.16,0.1364,0.26,0.3284,9,56,65,65,True
519,2011-01-23,1,0,1,17,0,0,0,1,0.14,0.1061,0.26,0.3881,5,50,55,55,True
520,2011-01-23,1,0,1,18,0,0,0,1,0.12,0.1212,0.3,0.2537,5,44,49,49,True
521,2011-01-23,1,0,1,19,0,0,0,1,0.12,0.1212,0.3,0.2836,5,45,50,50,True
522,2011-01-23,1,0,1,20,0,0,0,1,0.1,0.1061,0.36,0.2537,4,31,35,35,True
523,2011-01-23,1,0,1,21,0,0,0,1,0.1,0.1061,0.36,0.194,5,20,25,25,True
524,2011-01-23,1,0,1,22,0,0,0,1,0.08,0.0909,0.38,0.194,5,23,28,28,True
525,2011-01-23,1,0,1,23,0,0,0,1,0.06,0.0606,0.41,0.2239,4,17,21,21,True
526,2011-01-24,1,0,1,0,0,1,1,1,0.06,0.0606,0.41,0.194,0,7,7,7,True
527,2011-01-24,1,0,1,1,0,1,1,1,0.04,0.0455,0.45,0.194,0,1,1,1,True
528,2011-01-24,1,0,1,3,0,1,1,1,0.04,0.0303,0.45,0.2537,0,1,1,1,True
529,2011-01-24,1,0,1,4,0,1,1,1,0.02,0.0606,0.48,0.1343,0,1,1,1,True
530,2011-01-24,1,0,1,5,0,1,1,1,0.02,0.0606,0.48,0.1343,0,5,5,5,True
531,2011-01-24,1,0,1,6,0,1,1,1,0.02,0.0758,0.48,0.0896,0,15,15,15,True
532,2011-01-24,1,0,1,7,0,1,1,1,0.02,0.1212,0.48,0.0,5,79,84,84,True
533,2011-01-24,1,0,1,8,0,1,1,1,0.04,0.1364,0.49,0.0,6,171,177,177,True
534,2011-01-24,1,0,1,9,0,1,1,1,0.06,0.1515,0.41,0.0,4,98,102,102,True
535,2011-01-24,1,0,1,10,0,1,1,1,0.1,0.1364,0.42,0.0,6,34,40,40,True
536,2011-01-24,1,0,1,11,0,1,1,1,0.1,0.1212,0.46,0.1343,3,43,46,46,True
537,2011-01-24,1,0,1,12,0,1,1,2,0.12,0.1364,0.42,0.194,11,52,63,63,True
538,2011-01-24,1,0,1,13,0,1,1,2,0.14,0.1364,0.43,0.2239,6,54,60,60,True
539,2011-01-24,1,0,1,14,0,1,1,2,0.14,0.1364,0.46,0.2239,2,43,45,45,True
540,2011-01-24,1,0,1,15,0,1,1,1,0.16,0.1667,0.4,0.1642,7,50,57,57,True
541,2011-01-24,1,0,1,16,0,1,1,1,0.16,0.1515,0.47,0.2537,4,66,70,70,True
542,2011-01-24,1,0,1,17,0,1,1,1,0.14,0.1212,0.5,0.2537,6,178,184,184,True
543,2011-01-24,1,0,1,18,0,1,1,1,0.14,0.1364,0.59,0.194,8,145,153,153,True
544,2011-01-24,1,0,1,19,0,1,1,1,0.14,0.1515,0.54,0.1642,5,101,106,106,True
545,2011-01-24,1,0,1,20,0,1,1,1,0.14,0.1364,0.59,0.194,1,80,81,81,True
546,2011-01-24,1,0,1,21,0,1,1,1,0.14,0.1515,0.63,0.1642,6,53,59,59,True
547,2011-01-24,1,0,1,22,0,1,1,2,0.14,0.1364,0.63,0.2239,3,32,35,35,True
548,2011-01-24,1,0,1,23,0,1,1,2,0.16,0.1515,0.64,0.2537,3,21,24,24,True
549,2011-01-25,1,0,1,0,0,2,1,2,0.16,0.1364,0.69,0.2836,3,6,9,9,True
550,2011-01-25,1,0,1,1,0,2,1,2,0.16,0.1667,0.69,0.1642,0,5,5,5,True
551,2011-01-25,1,0,1,2,0,2,1,1,0.16,0.1515,0.69,0.2239,0,2,2,2,True
552,2011-01-25,1,0,1,4,0,2,1,1,0.14,0.1667,0.74,0.1045,0,1,1,1,True
553,2011-01-25,1,0,1,5,0,2,1,1,0.14,0.1364,0.74,0.2239,0,9,9,9,True
554,2011-01-25,1,0,1,6,0,2,1,1,0.16,0.1818,0.74,0.1045,1,35,36,36,True
555,2011-01-25,1,0,1,7,0,2,1,1,0.16,0.1515,0.74,0.2239,5,103,108,108,True
556,2011-01-25,1,0,1,8,0,2,1,2,0.16,0.1818,0.74,0.1343,5,233,238,238,True
557,2011-01-25,1,0,1,9,0,2,1,2,0.2,0.2273,0.64,0.0896,10,134,144,144,True
558,2011-01-25,1,0,1,10,0,2,1,2,0.22,0.2424,0.6,0.1045,6,49,55,55,True
559,2011-01-25,1,0,1,11,0,2,1,2,0.24,0.2424,0.6,0.1343,6,55,61,61,True
560,2011-01-25,1,0,1,12,0,2,1,2,0.26,0.2879,0.56,0.0896,21,85,106,106,True
561,2011-01-25,1,0,1,13,0,2,1,2,0.26,0.2727,0.56,0.1343,21,72,93,93,True
562,2011-01-25,1,0,1,14,0,2,1,2,0.3,0.3333,0.45,0.0,11,57,68,68,True
563,2011-01-25,1,0,1,15,0,2,1,2,0.32,0.3485,0.42,0.0,21,63,84,84,True
564,2011-01-25,1,0,1,16,0,2,1,2,0.32,0.3485,0.42,0.0,14,102,116,116,True
565,2011-01-25,1,0,1,17,0,2,1,1,0.3,0.3333,0.45,0.0,14,208,222,222,True
566,2011-01-25,1,0,1,18,0,2,1,2,0.3,0.3182,0.49,0.0896,7,218,225,225,True
567,2011-01-25,1,0,1,19,0,2,1,2,0.26,0.2576,0.65,0.1642,13,133,146,146,True
568,2011-01-25,1,0,1,20,0,2,1,1,0.24,0.2273,0.65,0.194,16,103,119,119,True
569,2011-01-25,1,0,1,21,0,2,1,1,0.24,0.2273,0.65,0.194,5,40,45,45,True
570,2011-01-25,1,0,1,22,0,2,1,1,0.22,0.2273,0.64,0.1642,4,49,53,53,True
571,2011-01-25,1,0,1,23,0,2,1,2,0.22,0.2273,0.64,0.1642,3,37,40,40,True
572,2011-01-26,1,0,1,0,0,3,1,2,0.22,0.2273,0.69,0.1343,3,14,17,17,True
573,2011-01-26,1,0,1,1,0,3,1,2,0.24,0.2424,0.65,0.1343,0,5,5,5,True
574,2011-01-26,1,0,1,2,0,3,1,3,0.22,0.2273,0.69,0.194,3,7,10,10,True
575,2011-01-26,1,0,1,5,0,3,1,3,0.2,0.1818,0.86,0.2836,0,1,1,1,True
576,2011-01-26,1,0,1,6,0,3,1,3,0.2,0.1818,0.86,0.2836,0,8,8,8,True
577,2011-01-26,1,0,1,7,0,3,1,3,0.22,0.2121,0.87,0.2985,1,29,30,30,True
578,2011-01-26,1,0,1,8,0,3,1,3,0.22,0.2121,0.87,0.2985,3,69,72,72,True
579,2011-01-26,1,0,1,9,0,3,1,3,0.22,0.2121,0.87,0.2985,3,55,58,58,True
580,2011-01-26,1,0,1,10,0,3,1,3,0.22,0.2121,0.93,0.2836,2,26,28,28,True
581,2011-01-26,1,0,1,11,0,3,1,3,0.22,0.197,0.93,0.3284,6,35,41,41,True
582,2011-01-26,1,0,1,12,0,3,1,3,0.22,0.197,0.93,0.3284,7,41,48,48,True
583,2011-01-26,1,0,1,13,0,3,1,3,0.22,0.197,0.93,0.3284,4,43,47,47,True
584,2011-01-26,1,0,1,14,0,3,1,3,0.22,0.197,0.93,0.3582,0,36,36,36,True
585,2011-01-26,1,0,1,15,0,3,1,3,0.22,0.1818,0.93,0.4627,1,42,43,43,True
586,2011-01-26,1,0,1,16,0,3,1,4,0.22,0.197,0.93,0.3284,1,35,36,36,True
587,2011-01-26,1,0,1,17,0,3,1,3,0.2,0.1818,0.93,0.3582,0,26,26,26,True
588,2011-01-27,1,0,1,16,0,4,1,1,0.22,0.2273,0.55,0.194,1,23,24,24,True
589,2011-01-27,1,0,1,17,0,4,1,1,0.22,0.2424,0.55,0.1045,2,82,84,84,True
590,2011-01-27,1,0,1,18,0,4,1,1,0.2,0.2273,0.69,0.0896,3,101,104,104,True
591,2011-01-27,1,0,1,19,0,4,1,1,0.2,0.2273,0.69,0.0896,3,76,79,79,True
592,2011-01-27,1,0,1,20,0,4,1,1,0.18,0.2121,0.74,0.0896,4,55,59,59,True
593,2011-01-27,1,0,1,21,0,4,1,1,0.18,0.2121,0.74,0.0896,2,36,38,38,True
594,2011-01-27,1,0,1,22,0,4,1,1,0.18,0.2121,0.74,0.0896,0,27,27,27,True
595,2011-01-27,1,0,1,23,0,4,1,1,0.18,0.197,0.8,0.1642,0,16,16,16,True
596,2011-01-28,1,0,1,0,0,5,1,2,0.2,0.2121,0.75,0.1343,0,9,9,9,True
597,2011-01-28,1,0,1,1,0,5,1,2,0.2,0.2121,0.75,0.1343,1,2,3,3,True
598,2011-01-28,1,0,1,2,0,5,1,2,0.2,0.2121,0.75,0.1642,0,2,2,2,True
599,2011-01-28,1,0,1,3,0,5,1,2,0.2,0.2273,0.75,0.1045,1,0,1,1,True
600,2011-01-28,1,0,1,5,0,5,1,2,0.18,0.2121,0.8,0.1045,0,4,4,4,True
601,2011-01-28,1,0,1,6,0,5,1,2,0.18,0.197,0.8,0.1343,0,16,16,16,True
602,2011-01-28,1,0,1,7,0,5,1,2,0.16,0.197,0.86,0.0896,2,58,60,60,True
603,2011-01-28,1,0,1,8,0,5,1,2,0.16,0.197,0.86,0.0896,2,155,157,157,True
604,2011-01-28,1,0,1,9,0,5,1,3,0.18,0.2121,0.86,0.0896,6,95,101,101,True
605,2011-01-28,1,0,1,10,0,5,1,3,0.18,0.2121,0.86,0.1045,0,49,49,49,True
606,2011-01-28,1,0,1,11,0,5,1,3,0.18,0.2121,0.93,0.1045,0,30,30,30,True
607,2011-01-28,1,0,1,12,0,5,1,3,0.18,0.2121,0.93,0.1045,1,28,29,29,True
608,2011-01-28,1,0,1,13,0,5,1,3,0.18,0.2121,0.93,0.1045,0,31,31,31,True
609,2011-01-28,1,0,1,14,0,5,1,3,0.22,0.2727,0.8,0.0,2,36,38,38,True
610,2011-01-28,1,0,1,15,0,5,1,2,0.2,0.2576,0.86,0.0,1,40,41,41,True
611,2011-01-28,1,0,1,16,0,5,1,1,0.22,0.2727,0.8,0.0,10,70,80,80,True
612,2011-01-28,1,0,1,17,0,5,1,1,0.24,0.2424,0.75,0.1343,2,147,149,149,True
613,2011-01-28,1,0,1,18,0,5,1,1,0.24,0.2273,0.75,0.194,2,107,109,109,True
614,2011-01-28,1,0,1,19,0,5,1,2,0.24,0.2424,0.75,0.1343,5,84,89,89,True
615,2011-01-28,1,0,1,20,0,5,1,2,0.24,0.2273,0.7,0.194,1,61,62,62,True
616,2011-01-28,1,0,1,21,0,5,1,2,0.22,0.2273,0.75,0.1343,1,57,58,58,True
617,2011-01-28,1,0,1,22,0,5,1,1,0.24,0.2121,0.65,0.3582,0,26,26,26,True
618,2011-01-28,1,0,1,23,0,5,1,1,0.24,0.2273,0.6,0.2239,1,22,23,23,True
619,2011-01-29,1,0,1,0,0,6,0,1,0.22,0.197,0.64,0.3582,2,26,28,28,True
620,2011-01-29,1,0,1,1,0,6,0,1,0.22,0.2273,0.64,0.194,0,20,20,20,True
621,2011-01-29,1,0,1,2,0,6,0,1,0.22,0.2273,0.64,0.1642,0,15,15,15,True
622,2011-01-29,1,0,1,3,0,6,0,1,0.2,0.2121,0.64,0.1343,3,5,8,8,True
623,2011-01-29,1,0,1,4,0,6,0,1,0.16,0.1818,0.69,0.1045,1,2,3,3,True
624,2011-01-29,1,0,1,6,0,6,0,1,0.16,0.1818,0.64,0.1343,0,2,2,2,True
625,2011-01-29,1,0,1,7,0,6,0,1,0.16,0.1818,0.59,0.1045,1,4,5,5,True
626,2011-01-29,1,0,1,8,0,6,0,1,0.18,0.197,0.55,0.1642,3,31,34,34,True
627,2011-01-29,1,0,1,9,0,6,0,1,0.18,0.2121,0.59,0.0896,0,34,34,34,True
628,2011-01-29,1,0,1,10,0,6,0,2,0.18,0.2121,0.64,0.1045,4,51,55,55,True
629,2011-01-29,1,0,1,11,0,6,0,2,0.18,0.197,0.64,0.1343,4,60,64,64,True
630,2011-01-29,1,0,1,12,0,6,0,2,0.2,0.197,0.59,0.194,12,66,78,78,True
631,2011-01-29,1,0,1,13,0,6,0,2,0.22,0.2273,0.55,0.1642,9,56,65,65,True
632,2011-01-29,1,0,1,14,0,6,0,2,0.22,0.2273,0.6,0.1343,10,89,99,99,True
633,2011-01-29,1,0,1,15,0,6,0,1,0.22,0.2121,0.69,0.2537,22,98,120,120,True
634,2011-01-29,1,0,1,16,0,6,0,1,0.24,0.2424,0.6,0.1642,19,88,107,107,True
635,2011-01-29,1,0,1,17,0,6,0,1,0.24,0.2879,0.6,0.0,9,82,91,91,True
636,2011-01-29,1,0,1,18,0,6,0,1,0.22,0.2273,0.69,0.1343,9,59,68,68,True
637,2011-01-29,1,0,1,19,0,6,0,2,0.22,0.2121,0.69,0.2537,6,52,58,58,True
638,2011-01-29,1,0,1,20,0,6,0,1,0.18,0.2121,0.74,0.0896,1,42,43,43,True
639,2011-01-29,1,0,1,21,0,6,0,1,0.18,0.2121,0.74,0.0896,1,35,36,36,True
640,2011-01-29,1,0,1,22,0,6,0,1,0.16,0.197,0.8,0.0896,4,28,32,32,True
641,2011-01-29,1,0,1,23,0,6,0,1,0.16,0.197,0.8,0.0896,3,30,33,33,True
642,2011-01-30,1,0,1,0,0,0,0,1,0.16,0.1818,0.8,0.1045,0,33,33,33,True
643,2011-01-30,1,0,1,1,0,0,0,1,0.14,0.2121,0.8,0.0,7,22,29,29,True
644,2011-01-30,1,0,1,2,0,0,0,1,0.16,0.2273,0.8,0.0,1,10,11,11,True
645,2011-01-30,1,0,1,3,0,0,0,1,0.14,0.2121,0.93,0.0,1,7,8,8,True
646,2011-01-30,1,0,1,4,0,0,0,1,0.14,0.2121,0.93,0.0,0,1,1,1,True
647,2011-01-30,1,0,1,5,0,0,0,1,0.14,0.2121,0.86,0.0,0,3,3,3,True
648,2011-01-30,1,0,1,7,0,0,0,1,0.14,0.2121,0.86,0.0,0,3,3,3,True
649,2011-01-30,1,0,1,8,0,0,0,2,0.14,0.2121,0.86,0.0,1,11,12,12,True
650,2011-01-30,1,0,1,9,0,0,0,2,0.16,0.2273,0.8,0.0,4,34,38,38,True
651,2011-01-30,1,0,1,10,0,0,0,2,0.18,0.2424,0.8,0.0,7,57,64,64,True
652,2011-01-30,1,0,1,11,0,0,0,1,0.22,0.2727,0.75,0.0,9,50,59,59,True
653,2011-01-30,1,0,1,12,0,0,0,1,0.3,0.3182,0.52,0.1045,10,87,97,97,True
654,2011-01-30,1,0,1,13,0,0,0,1,0.28,0.2879,0.61,0.1045,13,71,84,84,True
655,2011-01-30,1,0,1,14,0,0,0,1,0.28,0.303,0.61,0.0896,18,104,122,122,True
656,2011-01-30,1,0,1,15,0,0,0,1,0.3,0.3333,0.56,0.0,14,95,109,109,True
657,2011-01-30,1,0,1,16,0,0,0,1,0.3,0.3333,0.56,0.0,19,104,123,123,True
658,2011-01-30,1,0,1,17,0,0,0,1,0.3,0.2879,0.56,0.194,6,71,77,77,True
659,2011-01-30,1,0,1,18,0,0,0,1,0.26,0.2576,0.65,0.1642,8,57,65,65,True
660,2011-01-30,1,0,1,19,0,0,0,1,0.26,0.2576,0.65,0.194,9,46,55,55,True
661,2011-01-30,1,0,1,20,0,0,0,2,0.26,0.2727,0.65,0.1045,3,30,33,33,True
662,2011-01-30,1,0,1,21,0,0,0,2,0.24,0.2424,0.7,0.1642,3,25,28,28,True
663,2011-01-30,1,0,1,22,0,0,0,2,0.24,0.2273,0.7,0.194,2,19,21,21,True
664,2011-01-30,1,0,1,23,0,0,0,2,0.24,0.2121,0.65,0.2836,5,16,21,21,True
665,2011-01-31,1,0,1,0,0,1,1,2,0.24,0.2273,0.65,0.2239,1,6,7,7,True
666,2011-01-31,1,0,1,1,0,1,1,1,0.22,0.2121,0.64,0.2537,2,5,7,7,True
667,2011-01-31,1,0,1,2,0,1,1,1,0.22,0.2273,0.64,0.194,0,1,1,1,True
668,2011-01-31,1,0,1,3,0,1,1,1,0.22,0.2273,0.64,0.194,0,2,2,2,True
669,2011-01-31,1,0,1,4,0,1,1,1,0.2,0.197,0.59,0.2239,0,2,2,2,True
670,2011-01-31,1,0,1,5,0,1,1,1,0.18,0.1667,0.64,0.2836,0,8,8,8,True
671,2011-01-31,1,0,1,6,0,1,1,1,0.16,0.1364,0.69,0.3284,0,37,37,37,True
672,2011-01-31,1,0,1,7,0,1,1,2,0.16,0.1364,0.64,0.2836,1,71,72,72,True
673,2011-01-31,1,0,1,8,0,1,1,2,0.16,0.1364,0.59,0.2836,3,182,185,185,True
674,2011-01-31,1,0,1,9,0,1,1,2,0.16,0.1364,0.59,0.2985,0,112,112,112,True
675,2011-01-31,1,0,1,10,0,1,1,2,0.16,0.1515,0.59,0.194,1,68,69,69,True
676,2011-01-31,1,0,1,11,0,1,1,2,0.16,0.1515,0.59,0.194,2,46,48,48,True
677,2011-01-31,1,0,1,12,0,1,1,2,0.18,0.2121,0.55,0.1045,6,62,68,68,True
678,2011-01-31,1,0,1,13,0,1,1,2,0.16,0.2273,0.59,0.0,2,52,54,54,True
679,2011-01-31,1,0,1,14,0,1,1,2,0.18,0.197,0.55,0.1343,1,85,86,86,True
680,2011-01-31,1,0,1,15,0,1,1,2,0.16,0.1818,0.59,0.1343,3,41,44,44,True
681,2011-01-31,1,0,1,16,0,1,1,2,0.16,0.1818,0.56,0.194,3,83,86,86,True
682,2011-01-31,1,0,1,17,0,1,1,2,0.16,0.1515,0.59,0.194,6,155,161,161,True
683,2011-01-31,1,0,1,18,0,1,1,2,0.16,0.1515,0.55,0.2239,3,153,156,156,True
684,2011-01-31,1,0,1,19,0,1,1,1,0.3,0.3182,0.61,0.1045,3,108,111,111,True
685,2011-01-31,1,0,1,20,0,1,1,3,0.16,0.1667,0.59,0.1642,0,78,78,78,True
686,2011-01-31,1,0,1,21,0,1,1,3,0.16,0.197,0.59,0.0896,3,53,56,56,True
687,2011-01-31,1,0,1,22,0,1,1,2,0.16,0.1818,0.59,0.1045,0,34,34,34,True
688,2011-01-31,1,0,1,23,0,1,1,2,0.16,0.197,0.64,0.0896,2,15,17,17,True
689,2011-02-01,1,0,2,0,0,2,1,2,0.16,0.1818,0.64,0.1045,2,6,8,8,True
690,2011-02-01,1,0,2,1,0,2,1,2,0.16,0.1818,0.69,0.1045,0,3,3,3,True
691,2011-02-01,1,0,2,2,0,2,1,2,0.16,0.2273,0.69,0.0,0,2,2,2,True
692,2011-02-01,1,0,2,3,0,2,1,2,0.16,0.2273,0.69,0.0,0,2,2,2,True
693,2011-02-01,1,0,2,5,0,2,1,3,0.14,0.2121,0.93,0.0,0,3,3,3,True
694,2011-02-01,1,0,2,6,0,2,1,3,0.14,0.2121,0.93,0.0,0,22,22,22,True
695,2011-02-01,1,0,2,7,0,2,1,3,0.16,0.2273,0.93,0.0,0,52,52,52,True
696,2011-02-01,1,0,2,8,0,2,1,3,0.16,0.2273,0.93,0.0,3,132,135,135,True
697,2011-02-01,1,0,2,9,0,2,1,2,0.16,0.2273,0.93,0.0,2,114,116,116,True
698,2011-02-01,1,0,2,10,0,2,1,2,0.16,0.2273,0.93,0.0,0,47,47,47,True
699,2011-02-01,1,0,2,11,0,2,1,2,0.18,0.2424,0.86,0.0,2,49,51,51,True
700,2011-02-01,1,0,2,12,0,2,1,2,0.2,0.2576,0.86,0.0,2,53,55,55,True
701,2011-02-01,1,0,2,13,0,2,1,2,0.2,0.2576,0.86,0.0,3,49,52,52,True
702,2011-02-01,1,0,2,14,0,2,1,2,0.22,0.2576,0.8,0.0896,5,49,54,54,True
703,2011-02-01,1,0,2,15,0,2,1,2,0.24,0.2879,0.75,0.0,7,45,52,52,True
704,2011-02-01,1,0,2,16,0,2,1,2,0.24,0.2424,0.75,0.1343,3,61,64,64,True
705,2011-02-01,1,0,2,17,0,2,1,2,0.24,0.2879,0.75,0.0,4,172,176,176,True
706,2011-02-01,1,0,2,18,0,2,1,2,0.24,0.2576,0.81,0.1045,3,165,168,168,True
707,2011-02-01,1,0,2,19,0,2,1,2,0.24,0.2424,0.81,0.1343,3,105,108,108,True
708,2011-02-01,1,0,2,20,0,2,1,2,0.22,0.2273,0.87,0.1343,5,69,74,74,True
709,2011-02-01,1,0,2,21,0,2,1,2,0.22,0.2273,0.87,0.1343,0,64,64,64,True
710,2011-02-01,1,0,2,22,0,2,1,2,0.22,0.2576,0.87,0.0896,2,34,36,36,True
711,2011-02-01,1,0,2,23,0,2,1,3,0.2,0.197,0.93,0.194,1,15,16,16,True
712,2011-02-02,1,0,2,0,0,3,1,3,0.22,0.2424,0.93,0.1045,0,2,2,2,True
713,2011-02-02,1,0,2,1,0,3,1,3,0.22,0.2273,0.93,0.194,0,3,3,3,True
714,2011-02-02,1,0,2,2,0,3,1,3,0.22,0.2273,0.93,0.1343,4,0,4,4,True
715,2011-02-02,1,0,2,3,0,3,1,3,0.22,0.2273,0.93,0.1343,0,1,1,1,True
716,2011-02-02,1,0,2,4,0,3,1,3,0.22,0.2121,0.93,0.2836,0,1,1,1,True
717,2011-02-02,1,0,2,5,0,3,1,3,0.22,0.2424,0.93,0.1045,0,3,3,3,True
718,2011-02-02,1,0,2,6,0,3,1,3,0.22,0.2424,0.93,0.1045,1,17,18,18,True
719,2011-02-02,1,0,2,7,0,3,1,3,0.22,0.2121,0.93,0.2239,1,48,49,49,True
720,2011-02-02,1,0,2,8,0,3,1,3,0.22,0.2121,0.93,0.2239,1,154,155,155,True
721,2011-02-02,1,0,2,9,0,3,1,2,0.24,0.2576,0.93,0.0896,4,119,123,123,True
722,2011-02-02,1,0,2,10,0,3,1,2,0.22,0.2727,1.0,0.0,2,59,61,61,True
723,2011-02-02,1,0,2,11,0,3,1,2,0.24,0.2273,0.93,0.194,5,47,52,52,True
724,2011-02-02,1,0,2,12,0,3,1,2,0.24,0.2273,0.93,0.2239,3,61,64,64,True
725,2011-02-02,1,0,2,13,0,3,1,1,0.34,0.3333,0.93,0.1642,1,74,75,75,True
726,2011-02-02,1,0,2,14,0,3,1,1,0.38,0.3939,0.82,0.3881,2,61,63,63,True
727,2011-02-02,1,0,2,15,0,3,1,1,0.38,0.3939,0.76,0.3284,10,66,76,76,True
728,2011-02-02,1,0,2,16,0,3,1,1,0.36,0.3333,0.71,0.2985,8,95,103,103,True
729,2011-02-02,1,0,2,17,0,3,1,1,0.36,0.3182,0.53,0.4775,7,183,190,190,True
730,2011-02-02,1,0,2,18,0,3,1,1,0.34,0.2879,0.42,0.4775,7,175,182,182,True
731,2011-02-02,1,0,2,19,0,3,1,1,0.28,0.2424,0.45,0.4775,3,88,91,91,True
732,2011-02-02,1,0,2,20,0,3,1,1,0.24,0.197,0.48,0.4775,4,71,75,75,True
733,2011-02-02,1,0,2,21,0,3,1,1,0.22,0.197,0.47,0.3284,1,62,63,63,True
734,2011-02-02,1,0,2,22,0,3,1,1,0.22,0.2121,0.44,0.2537,5,35,40,40,True
735,2011-02-02,1,0,2,23,0,3,1,1,0.2,0.1667,0.44,0.4478,3,29,32,32,True
736,2011-02-03,1,0,2,0,0,4,1,1,0.2,0.1667,0.4,0.4478,1,11,12,12,True
737,2011-02-03,1,0,2,1,0,4,1,1,0.2,0.1515,0.44,0.4775,0,5,5,5,True
738,2011-02-03,1,0,2,2,0,4,1,1,0.18,0.1667,0.43,0.2537,0,2,2,2,True
739,2011-02-03,1,0,2,3,0,4,1,1,0.18,0.1667,0.43,0.2537,0,1,1,1,True
740,2011-02-03,1,0,2,5,0,4,1,1,0.16,0.1364,0.5,0.2985,0,2,2,2,True
741,2011-02-03,1,0,2,6,0,4,1,1,0.16,0.1364,0.43,0.3582,0,39,39,39,True
742,2011-02-03,1,0,2,7,0,4,1,1,0.14,0.1212,0.5,0.3284,1,86,87,87,True
743,2011-02-03,1,0,2,8,0,4,1,1,0.14,0.1212,0.5,0.3582,4,184,188,188,True
744,2011-02-03,1,0,2,9,0,4,1,1,0.16,0.1364,0.47,0.2985,6,127,133,133,True
745,2011-02-03,1,0,2,10,0,4,1,1,0.18,0.1515,0.43,0.3284,2,50,52,52,True
746,2011-02-03,1,0,2,11,0,4,1,1,0.18,0.1364,0.43,0.4478,9,55,64,64,True
747,2011-02-03,1,0,2,12,0,4,1,1,0.2,0.1818,0.4,0.3582,2,67,69,69,True
748,2011-02-03,1,0,2,13,0,4,1,1,0.2,0.1667,0.4,0.4179,4,47,51,51,True
749,2011-02-03,1,0,2,14,0,4,1,1,0.22,0.197,0.37,0.3881,4,43,47,47,True
750,2011-02-03,1,0,2,15,0,4,1,1,0.22,0.197,0.37,0.3284,4,56,60,60,True
751,2011-02-03,1,0,2,16,0,4,1,1,0.22,0.2121,0.37,0.2537,5,73,78,78,True
752,2011-02-03,1,0,2,17,0,4,1,1,0.2,0.197,0.4,0.194,5,170,175,175,True
753,2011-02-03,1,0,2,18,0,4,1,1,0.2,0.2121,0.4,0.1642,2,145,147,147,True
754,2011-02-03,1,0,2,19,0,4,1,1,0.2,0.2576,0.4,0.0,4,92,96,96,True
755,2011-02-03,1,0,2,20,0,4,1,1,0.2,0.2273,0.47,0.0896,1,108,109,109,True
756,2011-02-03,1,0,2,21,0,4,1,1,0.18,0.2121,0.55,0.1045,1,53,54,54,True
757,2011-02-03,1,0,2,22,0,4,1,1,0.18,0.2121,0.51,0.0896,2,39,41,41,True
758,2011-02-03,1,0,2,23,0,4,1,1,0.2,0.2273,0.47,0.1045,4,34,38,38,True
759,2011-02-04,1,0,2,0,0,5,1,2,0.2,0.2576,0.44,0.0,3,10,13,13,True
760,2011-02-04,1,0,2,1,0,5,1,2,0.16,0.2273,0.59,0.0,0,7,7,7,True
761,2011-02-04,1,0,2,2,0,5,1,2,0.14,0.1667,0.63,0.1045,0,1,1,1,True
762,2011-02-04,1,0,2,3,0,5,1,2,0.14,0.1667,0.63,0.1045,0,1,1,1,True
763,2011-02-04,1,0,2,5,0,5,1,2,0.14,0.1515,0.63,0.1343,0,7,7,7,True
764,2011-02-04,1,0,2,6,0,5,1,2,0.16,0.2273,0.55,0.0,2,26,28,28,True
765,2011-02-04,1,0,2,7,0,5,1,1,0.14,0.2121,0.59,0.0,0,87,87,87,True
766,2011-02-04,1,0,2,8,0,5,1,1,0.14,0.1515,0.74,0.1343,3,217,220,220,True
767,2011-02-04,1,0,2,9,0,5,1,2,0.16,0.1818,0.8,0.1343,3,124,127,127,True
768,2011-02-04,1,0,2,10,0,5,1,2,0.2,0.2121,0.51,0.1343,5,46,51,51,True
769,2011-02-04,1,0,2,11,0,5,1,1,0.22,0.2273,0.51,0.1642,3,61,64,64,True
770,2011-02-04,1,0,2,12,0,5,1,2,0.24,0.2424,0.48,0.1642,8,78,86,86,True
771,2011-02-04,1,0,2,13,0,5,1,2,0.26,0.2576,0.5,0.2239,9,73,82,82,True
772,2011-02-04,1,0,2,14,0,5,1,2,0.28,0.2727,0.45,0.1642,15,76,91,91,True
773,2011-02-04,1,0,2,15,0,5,1,2,0.28,0.2727,0.48,0.2537,9,81,90,90,True
774,2011-02-04,1,0,2,16,0,5,1,2,0.3,0.2879,0.42,0.2239,8,91,99,99,True
775,2011-02-04,1,0,2,17,0,5,1,2,0.26,0.2727,0.56,0.1343,10,195,205,205,True
776,2011-02-04,1,0,2,18,0,5,1,2,0.24,0.2576,0.6,0.1045,3,152,155,155,True
777,2011-02-04,1,0,2,19,0,5,1,2,0.24,0.2424,0.65,0.1343,1,102,103,103,True
778,2011-02-04,1,0,2,20,0,5,1,2,0.24,0.2424,0.65,0.1642,2,69,71,71,True
779,2011-02-04,1,0,2,21,0,5,1,2,0.24,0.2424,0.7,0.1642,2,41,43,43,True
780,2011-02-04,1,0,2,22,0,5,1,2,0.24,0.2424,0.65,0.1642,1,45,46,46,True
781,2011-02-04,1,0,2,23,0,5,1,2,0.24,0.2424,0.7,0.1343,1,30,31,31,True
782,2011-02-05,1,0,2,0,0,6,0,2,0.24,0.2424,0.7,0.1642,3,36,39,39,True
783,2011-02-05,1,0,2,1,0,6,0,2,0.24,0.2424,0.65,0.1642,1,17,18,18,True
784,2011-02-05,1,0,2,2,0,6,0,2,0.24,0.2424,0.75,0.1642,5,12,17,17,True
785,2011-02-05,1,0,2,3,0,6,0,2,0.24,0.2424,0.75,0.1642,1,10,11,11,True
786,2011-02-05,1,0,2,4,0,6,0,3,0.22,0.2273,0.93,0.1343,0,8,8,8,True
787,2011-02-05,1,0,2,5,0,6,0,3,0.2,0.2273,1.0,0.0896,0,9,9,9,True
788,2011-02-05,1,0,2,6,0,6,0,3,0.2,0.2576,1.0,0.0,0,4,4,4,True
789,2011-02-05,1,0,2,7,0,6,0,3,0.22,0.2576,0.93,0.0896,0,4,4,4,True
790,2011-02-05,1,0,2,8,0,6,0,3,0.2,0.2273,1.0,0.0896,0,10,10,10,True
791,2011-02-05,1,0,2,9,0,6,0,3,0.2,0.2273,1.0,0.0896,3,17,20,20,True
792,2011-02-05,1,0,2,10,0,6,0,3,0.2,0.2121,1.0,0.1343,3,31,34,34,True
793,2011-02-05,1,0,2,11,0,6,0,3,0.22,0.2273,1.0,0.1343,1,46,47,47,True
794,2011-02-05,1,0,2,12,0,6,0,3,0.22,0.2273,1.0,0.1642,10,42,52,52,True
795,2011-02-05,1,0,2,13,0,6,0,3,0.22,0.2273,1.0,0.1642,10,62,72,72,True
796,2011-02-05,1,0,2,14,0,6,0,3,0.22,0.2727,1.0,0.0,5,50,55,55,True
797,2011-02-05,1,0,2,15,0,6,0,3,0.22,0.2727,1.0,0.0,11,49,60,60,True
798,2011-02-05,1,0,2,16,0,6,0,3,0.22,0.2273,1.0,0.1343,8,63,71,71,True
799,2011-02-05,1,0,2,17,0,6,0,2,0.24,0.2121,1.0,0.2836,14,64,78,78,True
800,2011-02-05,1,0,2,18,0,6,0,2,0.28,0.2424,0.93,0.4478,2,81,83,83,True
801,2011-02-05,1,0,2,19,0,6,0,2,0.28,0.2424,0.93,0.4478,6,78,84,84,True
802,2011-02-05,1,0,2,20,0,6,0,1,0.3,0.2879,0.87,0.2537,5,64,69,69,True
803,2011-02-05,1,0,2,21,0,6,0,1,0.26,0.2576,1.0,0.194,3,53,56,56,True
804,2011-02-05,1,0,2,22,0,6,0,1,0.26,0.2727,0.93,0.1343,2,43,45,45,True
805,2011-02-05,1,0,2,23,0,6,0,1,0.26,0.2576,0.93,0.2239,7,52,59,59,True
806,2011-02-06,1,0,2,0,0,0,0,1,0.26,0.2576,0.7,0.194,2,37,39,39,True
807,2011-02-06,1,0,2,1,0,0,0,1,0.26,0.2273,0.65,0.4179,4,40,44,44,True
808,2011-02-06,1,0,2,2,0,0,0,1,0.26,0.2273,0.6,0.3284,0,20,20,20,True
809,2011-02-06,1,0,2,3,0,0,0,1,0.26,0.2879,0.6,0.0896,3,10,13,13,True
810,2011-02-06,1,0,2,4,0,0,0,1,0.26,0.2273,0.6,0.3582,0,2,2,2,True
811,2011-02-06,1,0,2,5,0,0,0,1,0.26,0.2576,0.6,0.2239,0,1,1,1,True
812,2011-02-06,1,0,2,6,0,0,0,1,0.26,0.2576,0.6,0.2239,0,1,1,1,True
813,2011-02-06,1,0,2,7,0,0,0,1,0.24,0.2424,0.65,0.1642,0,8,8,8,True
814,2011-02-06,1,0,2,8,0,0,0,1,0.24,0.2576,0.65,0.1045,2,21,23,23,True
815,2011-02-06,1,0,2,9,0,0,0,1,0.28,0.2879,0.56,0.1045,7,38,45,45,True
816,2011-02-06,1,0,2,10,0,0,0,1,0.3,0.2879,0.52,0.2537,15,74,89,89,True
817,2011-02-06,1,0,2,11,0,0,0,1,0.32,0.303,0.49,0.2537,28,89,117,117,True
818,2011-02-06,1,0,2,12,0,0,0,1,0.34,0.3333,0.46,0.0,48,126,174,174,True
819,2011-02-06,1,0,2,13,0,0,0,1,0.34,0.3636,0.46,0.0,47,135,182,182,True
820,2011-02-06,1,0,2,14,0,0,0,1,0.34,0.3485,0.46,0.0896,47,114,161,161,True
821,2011-02-06,1,0,2,15,0,0,0,1,0.34,0.3485,0.46,0.0896,52,130,182,182,True
822,2011-02-06,1,0,2,16,0,0,0,1,0.34,0.3485,0.49,0.1045,42,115,157,157,True
823,2011-02-06,1,0,2,17,0,0,0,1,0.34,0.3636,0.46,0.0,24,97,121,121,True
824,2011-02-06,1,0,2,18,0,0,0,1,0.3,0.303,0.56,0.1642,13,65,78,78,True
825,2011-02-06,1,0,2,19,0,0,0,1,0.28,0.2879,0.61,0.1343,1,20,21,21,True
826,2011-02-06,1,0,2,20,0,0,0,1,0.28,0.2879,0.61,0.1045,5,21,26,26,True
827,2011-02-06,1,0,2,21,0,0,0,1,0.26,0.303,0.6,0.0,5,22,27,27,True
828,2011-02-06,1,0,2,22,0,0,0,1,0.26,0.303,0.6,0.0,5,57,62,62,True
829,2011-02-06,1,0,2,23,0,0,0,1,0.24,0.2879,0.65,0.0,4,26,30,30,True
830,2011-02-07,1,0,2,0,0,1,1,1,0.24,0.2879,0.65,0.0,1,14,15,15,True
831,2011-02-07,1,0,2,1,0,1,1,1,0.22,0.2727,0.75,0.0,1,4,5,5,True
832,2011-02-07,1,0,2,2,0,1,1,1,0.2,0.2576,0.8,0.0,0,3,3,3,True
833,2011-02-07,1,0,2,3,0,1,1,1,0.2,0.2576,0.86,0.0,0,1,1,1,True
834,2011-02-07,1,0,2,4,0,1,1,1,0.2,0.2576,0.86,0.0,1,1,2,2,True
835,2011-02-07,1,0,2,5,0,1,1,1,0.2,0.2576,0.86,0.0,1,9,10,10,True
836,2011-02-07,1,0,2,6,0,1,1,1,0.18,0.2424,0.93,0.0,1,29,30,30,True
837,2011-02-07,1,0,2,7,0,1,1,1,0.18,0.2424,0.86,0.0,6,89,95,95,True
838,2011-02-07,1,0,2,8,0,1,1,2,0.16,0.2273,1.0,0.0,7,223,230,230,True
839,2011-02-07,1,0,2,9,0,1,1,1,0.22,0.2727,0.8,0.0,3,115,118,118,True
840,2011-02-07,1,0,2,10,0,1,1,1,0.24,0.2576,0.75,0.1045,6,49,55,55,True
841,2011-02-07,1,0,2,11,0,1,1,1,0.3,0.3182,0.65,0.0896,11,36,47,47,True
842,2011-02-07,1,0,2,12,0,1,1,2,0.32,0.3485,0.62,0.0,7,59,66,66,True
843,2011-02-07,1,0,2,13,0,1,1,2,0.36,0.3636,0.57,0.0896,10,54,64,64,True
844,2011-02-07,1,0,2,14,0,1,1,2,0.36,0.3636,0.57,0.0896,8,52,60,60,True
845,2011-02-07,1,0,2,15,0,1,1,2,0.38,0.3939,0.54,0.0896,4,46,50,50,True
846,2011-02-07,1,0,2,16,0,1,1,2,0.36,0.3485,0.57,0.1343,16,98,114,114,True
847,2011-02-07,1,0,2,17,0,1,1,2,0.32,0.3182,0.7,0.1642,9,207,216,216,True
848,2011-02-07,1,0,2,18,0,1,1,2,0.34,0.3333,0.66,0.1343,5,170,175,175,True
849,2011-02-07,1,0,2,19,0,1,1,2,0.32,0.3485,0.7,0.0,5,123,128,128,True
850,2011-02-07,1,0,2,20,0,1,1,2,0.32,0.3333,0.7,0.1045,6,82,88,88,True
851,2011-02-07,1,0,2,21,0,1,1,1,0.32,0.3485,0.7,0.0,3,75,78,78,True
852,2011-02-07,1,0,2,22,0,1,1,1,0.28,0.303,0.81,0.0896,3,34,37,37,True
853,2011-02-07,1,0,2,23,0,1,1,2,0.3,0.3333,0.81,0.0,6,19,25,25,True
854,2011-02-08,1,0,2,0,0,2,1,2,0.28,0.3182,0.87,0.0,4,6,10,10,True
855,2011-02-08,1,0,2,1,0,2,1,2,0.28,0.3182,0.87,0.0,0,4,4,4,True
856,2011-02-08,1,0,2,2,0,2,1,2,0.26,0.2727,0.93,0.1045,1,1,2,2,True
857,2011-02-08,1,0,2,3,0,2,1,3,0.28,0.2727,0.93,0.1642,0,1,1,1,True
858,2011-02-08,1,0,2,4,0,2,1,1,0.26,0.2576,0.93,0.1642,0,3,3,3,True
859,2011-02-08,1,0,2,5,0,2,1,1,0.26,0.2273,0.81,0.3284,0,2,2,2,True
860,2011-02-08,1,0,2,6,0,2,1,1,0.26,0.2273,0.7,0.3284,0,39,39,39,True
861,2011-02-08,1,0,2,7,0,2,1,1,0.24,0.197,0.65,0.4179,3,97,100,100,True
862,2011-02-08,1,0,2,8,0,2,1,1,0.24,0.197,0.56,0.4775,7,236,243,243,True
863,2011-02-08,1,0,2,9,0,2,1,1,0.24,0.197,0.52,0.4775,7,128,135,135,True
864,2011-02-08,1,0,2,10,0,2,1,1,0.22,0.1818,0.47,0.4775,4,44,48,48,True
865,2011-02-08,1,0,2,11,0,2,1,1,0.22,0.1818,0.47,0.4627,1,49,50,50,True
866,2011-02-08,1,0,2,12,0,2,1,1,0.24,0.197,0.38,0.4775,2,63,65,65,True
867,2011-02-08,1,0,2,13,0,2,1,2,0.24,0.197,0.32,0.4478,2,48,50,50,True
868,2011-02-08,1,0,2,14,0,2,1,1,0.22,0.197,0.37,0.4179,3,61,64,64,True
869,2011-02-08,1,0,2,15,0,2,1,1,0.22,0.197,0.35,0.3881,6,45,51,51,True
870,2011-02-08,1,0,2,16,0,2,1,1,0.22,0.1818,0.35,0.4775,4,79,83,83,True
871,2011-02-08,1,0,2,17,0,2,1,1,0.22,0.1818,0.32,0.4775,4,172,176,176,True
872,2011-02-08,1,0,2,18,0,2,1,1,0.2,0.1818,0.32,0.3881,1,151,152,152,True
873,2011-02-08,1,0,2,19,0,2,1,1,0.16,0.1212,0.4,0.4627,1,100,101,101,True
874,2011-02-08,1,0,2,20,0,2,1,1,0.16,0.1364,0.4,0.3284,3,53,56,56,True
875,2011-02-08,1,0,2,21,0,2,1,1,0.14,0.1061,0.33,0.4627,8,46,54,54,True
876,2011-02-08,1,0,2,22,0,2,1,1,0.12,0.1061,0.33,0.3582,0,29,29,29,True
877,2011-02-08,1,0,2,23,0,2,1,1,0.12,0.1061,0.33,0.3284,3,9,12,12,True
878,2011-02-09,1,0,2,0,0,3,1,1,0.1,0.0758,0.36,0.3582,0,17,17,17,True
879,2011-02-09,1,0,2,1,0,3,1,1,0.1,0.1061,0.36,0.2239,0,7,7,7,True
880,2011-02-09,1,0,2,2,0,3,1,1,0.08,0.0758,0.38,0.2836,1,2,3,3,True
881,2011-02-09,1,0,2,3,0,3,1,1,0.06,0.0758,0.45,0.1343,0,2,2,2,True
882,2011-02-09,1,0,2,5,0,3,1,1,0.06,0.1061,0.45,0.1045,0,7,7,7,True
883,2011-02-09,1,0,2,6,0,3,1,1,0.06,0.1515,0.45,0.0,0,43,43,43,True
884,2011-02-09,1,0,2,7,0,3,1,1,0.06,0.1061,0.49,0.1045,4,95,99,99,True
885,2011-02-09,1,0,2,8,0,3,1,1,0.1,0.1364,0.42,0.0,1,198,199,199,True
886,2011-02-09,1,0,2,9,0,3,1,1,0.12,0.1364,0.39,0.1642,4,119,123,123,True
887,2011-02-09,1,0,2,10,0,3,1,1,0.14,0.1818,0.36,0.0,8,51,59,59,True
888,2011-02-09,1,0,2,11,0,3,1,2,0.14,0.1515,0.43,0.1642,1,40,41,41,True
889,2011-02-09,1,0,2,12,0,3,1,2,0.18,0.1818,0.4,0.2239,4,57,61,61,True
890,2011-02-09,1,0,2,13,0,3,1,1,0.18,0.1667,0.4,0.2537,2,67,69,69,True
891,2011-02-09,1,0,2,14,0,3,1,1,0.2,0.1818,0.34,0.2985,2,56,58,58,True
892,2011-02-09,1,0,2,15,0,3,1,2,0.2,0.1818,0.34,0.2836,3,61,64,64,True
893,2011-02-09,1,0,2,16,0,3,1,2,0.2,0.197,0.37,0.2537,7,72,79,79,True
894,2011-02-09,1,0,2,17,0,3,1,2,0.2,0.197,0.34,0.2537,9,157,166,166,True
895,2011-02-09,1,0,2,18,0,3,1,2,0.18,0.1667,0.47,0.2985,2,168,170,170,True
896,2011-02-09,1,0,2,19,0,3,1,3,0.14,0.1212,0.86,0.2537,1,87,88,88,True
897,2011-02-09,1,0,2,20,0,3,1,3,0.14,0.1515,0.86,0.1642,0,84,84,84,True
898,2011-02-09,1,0,2,21,0,3,1,2,0.14,0.1515,0.86,0.1642,0,83,83,83,True
899,2011-02-09,1,0,2,22,0,3,1,3,0.16,0.1667,0.8,0.1642,4,42,46,46,True
900,2011-02-09,1,0,2,23,0,3,1,3,0.16,0.1515,0.8,0.194,0,37,37,37,True
901,2011-02-10,1,0,2,0,0,4,1,3,0.14,0.1364,0.86,0.194,0,16,16,16,True
902,2011-02-10,1,0,2,1,0,4,1,3,0.14,0.1515,0.8,0.1343,0,7,7,7,True
903,2011-02-10,1,0,2,2,0,4,1,3,0.14,0.1515,0.8,0.1343,0,3,3,3,True
904,2011-02-10,1,0,2,4,0,4,1,2,0.14,0.1364,0.59,0.2239,0,1,1,1,True
905,2011-02-10,1,0,2,5,0,4,1,2,0.12,0.1212,0.5,0.2239,0,6,6,6,True
906,2011-02-10,1,0,2,6,0,4,1,2,0.12,0.1212,0.54,0.2836,0,26,26,26,True
907,2011-02-10,1,0,2,7,0,4,1,1,0.1,0.0758,0.5,0.4179,0,99,99,99,True
908,2011-02-10,1,0,2,8,0,4,1,1,0.1,0.0758,0.49,0.3284,5,173,178,178,True
909,2011-02-10,1,0,2,9,0,4,1,1,0.12,0.1061,0.42,0.3582,1,121,122,122,True
910,2011-02-10,1,0,2,10,0,4,1,1,0.12,0.1061,0.42,0.2985,1,34,35,35,True
911,2011-02-10,1,0,2,11,0,4,1,1,0.14,0.1212,0.39,0.3582,1,44,45,45,True
912,2011-02-10,1,0,2,12,0,4,1,1,0.16,0.1364,0.34,0.3881,4,65,69,69,True
913,2011-02-10,1,0,2,13,0,4,1,1,0.18,0.1667,0.29,0.2985,3,59,62,62,True
914,2011-02-10,1,0,2,14,0,4,1,1,0.2,0.1818,0.27,0.2836,6,42,48,48,True
915,2011-02-10,1,0,2,15,0,4,1,1,0.2,0.197,0.25,0.2537,0,50,50,50,True
916,2011-02-10,1,0,2,16,0,4,1,1,0.2,0.1818,0.27,0.2985,4,76,80,80,True
917,2011-02-10,1,0,2,17,0,4,1,1,0.18,0.1818,0.26,0.194,6,159,165,165,True
918,2011-02-10,1,0,2,18,0,4,1,1,0.16,0.1818,0.28,0.1343,3,157,160,160,True
919,2011-02-10,1,0,2,19,0,4,1,1,0.14,0.1667,0.28,0.1045,2,110,112,112,True
920,2011-02-10,1,0,2,20,0,4,1,1,0.14,0.1818,0.31,0.0896,4,93,97,97,True
921,2011-02-10,1,0,2,21,0,4,1,1,0.14,0.2121,0.39,0.0,2,70,72,72,True
922,2011-02-10,1,0,2,22,0,4,1,1,0.12,0.197,0.39,0.0,4,47,51,51,True
923,2011-02-10,1,0,2,23,0,4,1,1,0.12,0.1515,0.42,0.1045,1,33,34,34,True
924,2011-02-11,1,0,2,0,0,5,1,1,0.1,0.1364,0.49,0.1045,2,12,14,14,True
925,2011-02-11,1,0,2,1,0,5,1,1,0.1,0.1364,0.54,0.0896,1,6,7,7,True
926,2011-02-11,1,0,2,2,0,5,1,1,0.1,0.1364,0.54,0.0896,0,3,3,3,True
927,2011-02-11,1,0,2,5,0,5,1,1,0.08,0.1212,0.63,0.0896,0,4,4,4,True
928,2011-02-11,1,0,2,6,0,5,1,1,0.1,0.1818,0.68,0.0,1,23,24,24,True
929,2011-02-11,1,0,2,7,0,5,1,1,0.08,0.1667,0.73,0.0,1,73,74,74,True
930,2011-02-11,1,0,2,8,0,5,1,1,0.1,0.1212,0.74,0.1642,4,212,216,216,True
931,2011-02-11,1,0,2,9,0,5,1,1,0.12,0.1212,0.74,0.2239,8,132,140,140,True
932,2011-02-11,1,0,2,10,0,5,1,1,0.14,0.1364,0.69,0.194,5,39,44,44,True
933,2011-02-11,1,0,2,11,0,5,1,1,0.22,0.2273,0.47,0.1343,12,52,64,64,True
934,2011-02-11,1,0,2,12,0,5,1,1,0.22,0.2273,0.47,0.1343,7,64,71,71,True
935,2011-02-11,1,0,2,13,0,5,1,1,0.24,0.2273,0.35,0.194,21,89,110,110,True
936,2011-02-11,1,0,2,14,0,5,1,1,0.3,0.2879,0.26,0.2537,17,67,84,84,True
937,2011-02-11,1,0,2,15,0,5,1,1,0.32,0.3182,0.21,0.1642,12,62,74,74,True
938,2011-02-11,1,0,2,16,0,5,1,1,0.3,0.2879,0.28,0.194,14,111,125,125,True
939,2011-02-11,1,0,2,17,0,5,1,1,0.3,0.3333,0.24,0.0,18,193,211,211,True
940,2011-02-11,1,0,2,18,0,5,1,1,0.28,0.3182,0.28,0.0,9,165,174,174,True
941,2011-02-11,1,0,2,19,0,5,1,1,0.26,0.303,0.33,0.0,7,94,101,101,True
942,2011-02-11,1,0,2,20,0,5,1,1,0.22,0.2273,0.55,0.1343,2,61,63,63,True
943,2011-02-11,1,0,2,21,0,5,1,1,0.2,0.2121,0.59,0.1343,1,46,47,47,True
944,2011-02-11,1,0,2,22,0,5,1,1,0.2,0.2273,0.64,0.0896,2,41,43,43,True
945,2011-02-11,1,0,2,23,0,5,1,1,0.18,0.2424,0.69,0.0,5,48,53,53,True
946,2011-02-12,1,0,2,0,0,6,0,1,0.16,0.197,0.69,0.0896,3,27,30,30,True
947,2011-02-12,1,0,2,1,0,6,0,1,0.14,0.2121,0.86,0.0,2,22,24,24,True
948,2011-02-12,1,0,2,2,0,6,0,1,0.14,0.2121,0.8,0.0,2,13,15,15,True
949,2011-02-12,1,0,2,3,0,6,0,1,0.12,0.197,0.8,0.0,3,7,10,10,True
950,2011-02-12,1,0,2,4,0,6,0,1,0.12,0.1667,0.74,0.0896,0,4,4,4,True
951,2011-02-12,1,0,2,5,0,6,0,1,0.12,0.1667,0.74,0.0896,0,1,1,1,True
952,2011-02-12,1,0,2,6,0,6,0,1,0.12,0.1364,0.93,0.194,1,1,2,2,True
953,2011-02-12,1,0,2,7,0,6,0,1,0.12,0.1515,0.8,0.1045,2,9,11,11,True
954,2011-02-12,1,0,2,8,0,6,0,1,0.14,0.1515,0.86,0.1343,2,28,30,30,True
955,2011-02-12,1,0,2,9,0,6,0,1,0.16,0.1818,0.64,0.1343,5,38,43,43,True
956,2011-02-12,1,0,2,10,0,6,0,1,0.22,0.2121,0.41,0.2537,13,71,84,84,True
957,2011-02-12,1,0,2,11,0,6,0,1,0.3,0.2727,0.28,0.3284,30,84,114,114,True
958,2011-02-12,1,0,2,12,0,6,0,1,0.3,0.2727,0.39,0.4627,27,93,120,120,True
959,2011-02-12,1,0,2,13,0,6,0,1,0.3,0.2727,0.39,0.4179,32,103,135,135,True
960,2011-02-12,1,0,2,14,0,6,0,1,0.34,0.3182,0.31,0.2836,30,90,120,120,True
961,2011-02-12,1,0,2,15,0,6,0,1,0.34,0.303,0.29,0.4179,47,127,174,174,True
962,2011-02-12,1,0,2,16,0,6,0,1,0.34,0.303,0.29,0.4179,42,103,145,145,True
963,2011-02-12,1,0,2,17,0,6,0,1,0.32,0.2879,0.31,0.4775,24,113,137,137,True
964,2011-02-12,1,0,2,18,0,6,0,1,0.28,0.2576,0.38,0.3284,4,60,64,64,True
965,2011-02-12,1,0,2,19,0,6,0,1,0.28,0.2727,0.38,0.1642,2,39,41,41,True
966,2011-02-12,1,0,2,20,0,6,0,1,0.26,0.2576,0.41,0.2239,1,39,40,40,True
967,2011-02-12,1,0,2,21,0,6,0,1,0.26,0.303,0.41,0.0,9,42,51,51,True
968,2011-02-12,1,0,2,22,0,6,0,1,0.24,0.2576,0.44,0.0896,6,39,45,45,True
969,2011-02-12,1,0,2,23,0,6,0,1,0.22,0.2273,0.51,0.1343,1,31,32,32,True
970,2011-02-13,1,0,2,0,0,0,0,1,0.2,0.2273,0.64,0.1045,5,34,39,39,True
971,2011-02-13,1,0,2,1,0,0,0,1,0.2,0.2273,0.59,0.0896,1,23,24,24,True
972,2011-02-13,1,0,2,2,0,0,0,2,0.2,0.2273,0.75,0.0896,1,19,20,20,True
973,2011-02-13,1,0,2,3,0,0,0,2,0.2,0.2273,0.69,0.1045,4,8,12,12,True
974,2011-02-13,1,0,2,4,0,0,0,2,0.2,0.2121,0.69,0.1642,0,2,2,2,True
975,2011-02-13,1,0,2,6,0,0,0,2,0.2,0.2121,0.69,0.1343,2,3,5,5,True
976,2011-02-13,1,0,2,7,0,0,0,2,0.22,0.2727,0.55,0.0,0,3,3,3,True
977,2011-02-13,1,0,2,8,0,0,0,2,0.22,0.2273,0.64,0.194,1,11,12,12,True
978,2011-02-13,1,0,2,9,0,0,0,2,0.24,0.2273,0.6,0.2239,12,35,47,47,True
979,2011-02-13,1,0,2,10,0,0,0,1,0.3,0.2727,0.45,0.3284,19,86,105,105,True
980,2011-02-13,1,0,2,11,0,0,0,1,0.32,0.2879,0.39,0.4478,26,86,112,112,True
981,2011-02-13,1,0,2,12,0,0,0,1,0.36,0.3182,0.32,0.4627,58,94,152,152,True
982,2011-02-13,1,0,2,13,0,0,0,1,0.38,0.3939,0.29,0.3582,62,92,154,154,True
983,2011-02-13,1,0,2,14,0,0,0,2,0.4,0.4091,0.3,0.4179,51,110,161,161,True
984,2011-02-13,1,0,2,15,0,0,0,2,0.4,0.4091,0.3,0.2985,40,122,162,162,True
985,2011-02-13,1,0,2,16,0,0,0,2,0.42,0.4242,0.28,0.3284,28,106,134,134,True
986,2011-02-13,1,0,2,17,0,0,0,1,0.42,0.4242,0.28,0.3284,30,95,125,125,True
987,2011-02-13,1,0,2,18,0,0,0,1,0.4,0.4091,0.32,0.2985,17,78,95,95,True
988,2011-02-13,1,0,2,19,0,0,0,1,0.4,0.4091,0.35,0.2836,11,50,61,61,True
989,2011-02-13,1,0,2,20,0,0,0,1,0.4,0.4091,0.35,0.3284,15,32,47,47,True
990,2011-02-13,1,0,2,21,0,0,0,1,0.4,0.4091,0.35,0.3582,6,45,51,51,True
991,2011-02-13,1,0,2,22,0,0,0,1,0.4,0.4091,0.35,0.2985,5,31,36,36,True
992,2011-02-13,1,0,2,23,0,0,0,1,0.4,0.4091,0.35,0.3582,3,27,30,30,True
993,2011-02-14,1,0,2,0,0,1,1,1,0.38,0.3939,0.37,0.3582,3,8,11,11,True
994,2011-02-14,1,0,2,1,0,1,1,1,0.38,0.3939,0.37,0.3582,1,6,7,7,True
995,2011-02-14,1,0,2,2,0,1,1,1,0.36,0.3333,0.4,0.2985,0,2,2,2,True
996,2011-02-14,1,0,2,3,0,1,1,1,0.34,0.3182,0.46,0.2239,1,1,2,2,True
997,2011-02-14,1,0,2,4,0,1,1,1,0.32,0.303,0.53,0.2836,0,2,2,2,True
998,2011-02-14,1,0,2,5,0,1,1,1,0.32,0.303,0.53,0.2836,0,3,3,3,True
999,2011-02-14,1,0,2,6,0,1,1,1,0.34,0.303,0.46,0.2985,1,25,26,26,True
1000,2011-02-14,1,0,2,7,0,1,1,1,0.34,0.303,0.46,0.2985,2,96,98,98,True
1001,2011-02-14,1,0,2,8,0,1,1,1,0.38,0.3939,0.4,0.4627,7,249,256,256,True
1002,2011-02-14,1,0,2,9,0,1,1,1,0.4,0.4091,0.37,0.3881,8,122,130,130,True
1003,2011-02-14,1,0,2,10,0,1,1,1,0.44,0.4394,0.33,0.2239,9,46,55,55,True
1004,2011-02-14,1,0,2,11,0,1,1,1,0.52,0.5,0.23,0.2537,10,43,53,53,True
1005,2011-02-14,1,0,2,12,0,1,1,1,0.56,0.5303,0.22,0.4478,27,99,126,126,True
1006,2011-02-14,1,0,2,13,0,1,1,1,0.58,0.5455,0.19,0.3881,27,93,120,120,True
1007,2011-02-14,1,0,2,14,0,1,1,1,0.6,0.5909,0.15,0.4775,14,76,90,90,True
1008,2011-02-14,1,0,2,15,0,1,1,1,0.56,0.5303,0.21,0.4775,19,71,90,90,True
1009,2011-02-14,1,0,2,16,0,1,1,1,0.52,0.5,0.27,0.4627,16,102,118,118,True
1010,2011-02-14,1,0,2,17,0,1,1,1,0.46,0.4545,0.33,0.4775,25,218,243,243,True
1011,2011-02-14,1,0,2,18,0,1,1,1,0.4,0.4091,0.4,0.4775,11,194,205,205,True
1012,2011-02-14,1,0,2,19,0,1,1,1,0.38,0.3939,0.43,0.4775,12,86,98,98,True
1013,2011-02-14,1,0,2,20,0,1,1,1,0.36,0.3182,0.46,0.4627,5,65,70,70,True
1014,2011-02-14,1,0,2,21,0,1,1,1,0.36,0.3182,0.5,0.4775,8,35,43,43,True
1015,2011-02-14,1,0,2,22,0,1,1,1,0.34,0.2879,0.46,0.4775,1,44,45,45,True
1016,2011-02-14,1,0,2,23,0,1,1,1,0.32,0.2879,0.49,0.4775,1,19,20,20,True
1017,2011-02-15,1,0,2,0,0,2,1,1,0.3,0.2727,0.49,0.4179,7,12,19,19,True
1018,2011-02-15,1,0,2,1,0,2,1,1,0.3,0.2424,0.42,0.4775,0,5,5,5,True
1019,2011-02-15,1,0,2,2,0,2,1,1,0.28,0.2273,0.41,0.4775,1,2,3,3,True
1020,2011-02-15,1,0,2,4,0,2,1,1,0.22,0.1818,0.37,0.4775,0,1,1,1,True
1021,2011-02-15,1,0,2,5,0,2,1,1,0.22,0.1818,0.32,0.4627,0,4,4,4,True
1022,2011-02-15,1,0,2,6,0,2,1,1,0.2,0.1818,0.32,0.3284,0,30,30,30,True
1023,2011-02-15,1,0,2,7,0,2,1,1,0.2,0.1818,0.32,0.3582,2,103,105,105,True
1024,2011-02-15,1,0,2,8,0,2,1,1,0.2,0.1818,0.32,0.3582,10,213,223,223,True
1025,2011-02-15,1,0,2,9,0,2,1,1,0.22,0.197,0.29,0.4478,2,108,110,110,True
1026,2011-02-15,1,0,2,10,0,2,1,1,0.24,0.2121,0.27,0.2836,5,47,52,52,True
1027,2011-02-15,1,0,2,11,0,2,1,1,0.26,0.2424,0.25,0.2537,11,46,57,57,True
1028,2011-02-15,1,0,2,12,0,2,1,1,0.28,0.2727,0.24,0.2537,6,65,71,71,True
1029,2011-02-15,1,0,2,13,0,2,1,1,0.32,0.303,0.21,0.2239,14,68,82,82,True
1030,2011-02-15,1,0,2,14,0,2,1,1,0.34,0.3182,0.19,0.2239,10,69,79,79,True
1031,2011-02-15,1,0,2,15,0,2,1,1,0.34,0.3333,0.19,0.1642,11,74,85,85,True
1032,2011-02-15,1,0,2,16,0,2,1,1,0.34,0.3182,0.19,0.2537,21,77,98,98,True
1033,2011-02-15,1,0,2,17,0,2,1,1,0.32,0.303,0.22,0.2239,15,191,206,206,True
1034,2011-02-15,1,0,2,18,0,2,1,1,0.3,0.303,0.22,0.1343,14,198,212,212,True
1035,2011-02-15,1,0,2,19,0,2,1,1,0.28,0.2879,0.26,0.1343,3,142,145,145,True
1036,2011-02-15,1,0,2,20,0,2,1,1,0.26,0.2727,0.33,0.1045,3,98,101,101,True
1037,2011-02-15,1,0,2,21,0,2,1,1,0.24,0.2879,0.52,0.0,5,61,66,66,True
1038,2011-02-15,1,0,2,22,0,2,1,1,0.24,0.2879,0.44,0.0,0,41,41,41,True
1039,2011-02-15,1,0,2,23,0,2,1,2,0.22,0.2576,0.44,0.0896,0,20,20,20,True
1040,2011-02-16,1,0,2,0,0,3,1,1,0.22,0.2576,0.41,0.0896,0,15,15,15,True
1041,2011-02-16,1,0,2,1,0,3,1,1,0.2,0.2273,0.44,0.0896,0,9,9,9,True
1042,2011-02-16,1,0,2,3,0,3,1,2,0.2,0.197,0.47,0.194,0,1,1,1,True
1043,2011-02-16,1,0,2,4,0,3,1,1,0.2,0.197,0.51,0.194,0,1,1,1,True
1044,2011-02-16,1,0,2,5,0,3,1,1,0.2,0.197,0.47,0.194,0,5,5,5,True
1045,2011-02-16,1,0,2,6,0,3,1,1,0.2,0.197,0.55,0.2239,1,32,33,33,True
1046,2011-02-16,1,0,2,7,0,3,1,2,0.2,0.197,0.55,0.2239,5,103,108,108,True
1047,2011-02-16,1,0,2,8,0,3,1,2,0.22,0.2273,0.55,0.1642,6,224,230,230,True
1048,2011-02-16,1,0,2,9,0,3,1,1,0.24,0.2121,0.52,0.2836,2,122,124,124,True
1049,2011-02-16,1,0,2,10,0,3,1,1,0.26,0.2273,0.41,0.3881,14,55,69,69,True
1050,2011-02-16,1,0,2,11,0,3,1,1,0.34,0.303,0.34,0.2985,7,59,66,66,True
1051,2011-02-16,1,0,2,12,0,3,1,1,0.38,0.3939,0.32,0.3284,14,72,86,86,True
1052,2011-02-16,1,0,2,13,0,3,1,1,0.42,0.4242,0.3,0.3582,13,80,93,93,True
1053,2011-02-16,1,0,2,14,0,3,1,1,0.46,0.4545,0.28,0.4179,17,65,82,82,True
1054,2011-02-16,1,0,2,15,0,3,1,1,0.46,0.4545,0.28,0.4179,35,82,117,117,True
1055,2011-02-16,1,0,2,16,0,3,1,1,0.46,0.4545,0.31,0.3881,26,96,122,122,True
1056,2011-02-16,1,0,2,17,0,3,1,1,0.46,0.4545,0.28,0.2836,11,244,255,255,True
1057,2011-02-16,1,0,2,18,0,3,1,1,0.4,0.4091,0.4,0.2239,20,202,222,222,True
1058,2011-02-16,1,0,2,19,0,3,1,1,0.34,0.3182,0.53,0.2239,18,143,161,161,True
1059,2011-02-16,1,0,2,20,0,3,1,1,0.38,0.3939,0.43,0.194,10,108,118,118,True
1060,2011-02-16,1,0,2,21,0,3,1,1,0.36,0.3485,0.46,0.194,5,87,92,92,True
1061,2011-02-16,1,0,2,22,0,3,1,1,0.34,0.3333,0.53,0.194,12,61,73,73,True
1062,2011-02-16,1,0,2,23,0,3,1,1,0.38,0.3939,0.4,0.2239,2,31,33,33,True
1063,2011-02-17,1,0,2,0,0,4,1,1,0.34,0.3333,0.53,0.194,1,16,17,17,True
1064,2011-02-17,1,0,2,1,0,4,1,1,0.34,0.3182,0.53,0.2239,0,6,6,6,True
1065,2011-02-17,1,0,2,2,0,4,1,2,0.34,0.3182,0.53,0.2239,2,4,6,6,True
1066,2011-02-17,1,0,2,3,0,4,1,1,0.34,0.3333,0.53,0.194,3,1,4,4,True
1067,2011-02-17,1,0,2,4,0,4,1,1,0.32,0.3182,0.57,0.194,3,1,4,4,True
1068,2011-02-17,1,0,2,5,0,4,1,1,0.32,0.3333,0.66,0.0896,1,11,12,12,True
1069,2011-02-17,1,0,2,6,0,4,1,1,0.3,0.303,0.7,0.1343,3,44,47,47,True
1070,2011-02-17,1,0,2,7,0,4,1,1,0.32,0.3333,0.57,0.1045,7,119,126,126,True
1071,2011-02-17,1,0,2,8,0,4,1,1,0.32,0.3333,0.57,0.0896,18,267,285,285,True
1072,2011-02-17,1,0,2,9,0,4,1,1,0.36,0.3485,0.57,0.194,16,163,179,179,True
1073,2011-02-17,1,0,2,10,0,4,1,1,0.38,0.3939,0.54,0.194,18,70,88,88,True
1074,2011-02-17,1,0,2,11,0,4,1,2,0.44,0.4394,0.44,0.2537,19,71,90,90,True
1075,2011-02-17,1,0,2,12,0,4,1,1,0.48,0.4697,0.41,0.2239,15,86,101,101,True
1076,2011-02-17,1,0,2,13,0,4,1,1,0.54,0.5152,0.34,0.2239,15,108,123,123,True
1077,2011-02-17,1,0,2,14,0,4,1,1,0.6,0.6212,0.31,0.2239,26,55,81,81,True
1078,2011-02-17,1,0,2,15,0,4,1,1,0.6,0.6061,0.28,0.2537,15,91,106,106,True
1079,2011-02-17,1,0,2,16,0,4,1,2,0.56,0.5303,0.35,0.2985,29,117,146,146,True
1080,2011-02-17,1,0,2,17,0,4,1,2,0.58,0.5455,0.32,0.2985,18,256,274,274,True
1081,2011-02-17,1,0,2,18,0,4,1,2,0.54,0.5152,0.42,0.2836,11,211,222,222,True
1082,2011-02-17,1,0,2,19,0,4,1,1,0.48,0.4697,0.55,0.3284,14,161,175,175,True
1083,2011-02-17,1,0,2,20,0,4,1,1,0.48,0.4697,0.59,0.3284,8,131,139,139,True
1084,2011-02-17,1,0,2,21,0,4,1,1,0.52,0.5,0.55,0.3881,5,119,124,124,True
1085,2011-02-17,1,0,2,22,0,4,1,1,0.5,0.4848,0.59,0.2836,8,68,76,76,True
1086,2011-02-17,1,0,2,23,0,4,1,1,0.46,0.4545,0.67,0.2985,4,40,44,44,True
1087,2011-02-18,1,0,2,0,0,5,1,1,0.44,0.4394,0.72,0.2836,12,20,32,32,True
1088,2011-02-18,1,0,2,1,0,5,1,1,0.44,0.4394,0.72,0.2239,1,7,8,8,True
1089,2011-02-18,1,0,2,2,0,5,1,1,0.44,0.4394,0.72,0.2836,2,5,7,7,True
1090,2011-02-18,1,0,2,3,0,5,1,1,0.46,0.4545,0.67,0.2537,2,6,8,8,True
1091,2011-02-18,1,0,2,4,0,5,1,1,0.46,0.4545,0.67,0.2537,0,1,1,1,True
1092,2011-02-18,1,0,2,5,0,5,1,2,0.46,0.4545,0.67,0.1045,1,6,7,7,True
1093,2011-02-18,1,0,2,6,0,5,1,2,0.44,0.4394,0.72,0.1642,2,48,50,50,True
1094,2011-02-18,1,0,2,7,0,5,1,2,0.42,0.4242,0.77,0.2239,8,108,116,116,True
1095,2011-02-18,1,0,2,8,0,5,1,2,0.42,0.4242,0.77,0.194,26,246,272,272,True
1096,2011-02-18,1,0,2,9,0,5,1,2,0.42,0.4242,0.77,0.194,15,154,169,169,True
1097,2011-02-18,1,0,2,10,0,5,1,2,0.44,0.4394,0.72,0.2239,17,78,95,95,True
1098,2011-02-18,1,0,2,11,0,5,1,1,0.44,0.4394,0.72,0.1642,31,82,113,113,True
1099,2011-02-18,1,0,2,12,0,5,1,1,0.5,0.4848,0.59,0.194,59,126,185,185,True
1100,2011-02-18,1,0,2,13,0,5,1,1,0.6,0.6212,0.43,0.194,45,131,176,176,True
1101,2011-02-18,1,0,2,14,0,5,1,1,0.66,0.6212,0.36,0.2985,73,118,191,191,True
1102,2011-02-18,1,0,2,15,0,5,1,1,0.66,0.6212,0.36,0.3284,55,117,172,172,True
1103,2011-02-18,1,0,2,16,0,5,1,1,0.66,0.6212,0.36,0.2836,68,164,232,232,True
1104,2011-02-18,1,0,2,17,0,5,1,1,0.66,0.6212,0.34,0.3582,52,275,327,327,True
1105,2011-02-18,1,0,2,18,0,5,1,1,0.64,0.6212,0.33,0.3284,29,195,224,224,True
1106,2011-02-18,1,0,2,19,0,5,1,1,0.62,0.6212,0.29,0.4775,16,146,162,162,True
1107,2011-02-18,1,0,2,20,0,5,1,1,0.6,0.6212,0.31,0.194,19,105,124,124,True
1108,2011-02-18,1,0,2,21,0,5,1,1,0.58,0.5455,0.21,0.4775,11,61,72,72,True
1109,2011-02-18,1,0,2,22,0,5,1,1,0.54,0.5152,0.1,0.2537,19,88,107,107,True
1110,2011-02-18,1,0,2,23,0,5,1,1,0.52,0.5,0.08,0.2836,16,61,77,77,True
1111,2011-02-19,1,0,2,0,0,6,0,1,0.48,0.4697,0.12,0.4775,6,23,29,29,True
1112,2011-02-19,1,0,2,1,0,6,0,1,0.46,0.4545,0.14,0.4179,10,21,31,31,True
1113,2011-02-19,1,0,2,2,0,6,0,1,0.44,0.4394,0.13,0.3881,3,14,17,17,True
1114,2011-02-19,1,0,2,3,0,6,0,1,0.42,0.4242,0.14,0.2985,0,7,7,7,True
1115,2011-02-19,1,0,2,4,0,6,0,1,0.4,0.4091,0.15,0.3284,0,3,3,3,True
1116,2011-02-19,1,0,2,5,0,6,0,1,0.4,0.4091,0.15,0.3284,0,3,3,3,True
1117,2011-02-19,1,0,2,6,0,6,0,1,0.4,0.4091,0.17,0.4179,3,3,6,6,True
1118,2011-02-19,1,0,2,7,0,6,0,1,0.38,0.3939,0.17,0.4775,6,16,22,22,True
1119,2011-02-19,1,0,2,8,0,6,0,1,0.38,0.3939,0.17,0.4775,9,36,45,45,True
1120,2011-02-19,1,0,2,9,0,6,0,1,0.4,0.4091,0.16,0.4775,18,37,55,55,True
1121,2011-02-19,1,0,2,10,0,6,0,1,0.42,0.4242,0.16,0.4775,34,72,106,106,True
1122,2011-02-19,1,0,2,11,0,6,0,1,0.44,0.4394,0.16,0.4775,47,76,123,123,True
1123,2011-02-19,1,0,2,12,0,6,0,1,0.44,0.4394,0.18,0.4775,38,81,119,119,True
1124,2011-02-19,1,0,2,13,0,6,0,1,0.44,0.4394,0.16,0.4775,52,103,155,155,True
1125,2011-02-19,1,0,2,14,0,6,0,1,0.46,0.4545,0.15,0.4775,102,94,196,196,True
1126,2011-02-19,1,0,2,15,0,6,0,1,0.44,0.4394,0.16,0.4775,84,87,171,171,True
1127,2011-02-19,1,0,2,16,0,6,0,1,0.44,0.4394,0.16,0.4775,39,81,120,120,True
1128,2011-02-19,1,0,2,17,0,6,0,1,0.42,0.4242,0.19,0.4775,36,91,127,127,True
1129,2011-02-19,1,0,2,18,0,6,0,1,0.36,0.3182,0.25,0.4478,21,67,88,88,True
1130,2011-02-19,1,0,2,19,0,6,0,1,0.34,0.303,0.29,0.3582,5,54,59,59,True
1131,2011-02-19,1,0,2,20,0,6,0,1,0.32,0.2879,0.28,0.4775,9,38,47,47,True
1132,2011-02-19,1,0,2,21,0,6,0,1,0.32,0.2727,0.26,0.4775,4,29,33,33,True
1133,2011-02-19,1,0,2,22,0,6,0,1,0.3,0.2576,0.28,0.4775,2,42,44,44,True
1134,2011-02-19,1,0,2,23,0,6,0,1,0.28,0.2424,0.33,0.4478,4,25,29,29,True
1135,2011-02-20,1,0,2,0,0,0,0,1,0.26,0.2121,0.35,0.4478,3,14,17,17,True
1136,2011-02-20,1,0,2,1,0,0,0,1,0.24,0.197,0.41,0.4627,5,11,16,16,True
1137,2011-02-20,1,0,2,2,0,0,0,1,0.24,0.197,0.41,0.4775,0,17,17,17,True
1138,2011-02-20,1,0,2,3,0,0,0,1,0.22,0.1818,0.44,0.4775,9,9,18,18,True
1139,2011-02-20,1,0,2,4,0,0,0,1,0.22,0.1818,0.44,0.4775,0,1,1,1,True
1140,2011-02-20,1,0,2,6,0,0,0,1,0.2,0.1818,0.47,0.2985,1,1,2,2,True
1141,2011-02-20,1,0,2,7,0,0,0,1,0.18,0.1667,0.51,0.2537,0,2,2,2,True
1142,2011-02-20,1,0,2,8,0,0,0,1,0.2,0.2273,0.51,0.1045,2,22,24,24,True
1143,2011-02-20,1,0,2,9,0,0,0,1,0.22,0.2121,0.47,0.2836,7,48,55,55,True
1144,2011-02-20,1,0,2,10,0,0,0,2,0.26,0.2576,0.41,0.194,34,70,104,104,True
1145,2011-02-20,1,0,2,11,0,0,0,2,0.3,0.303,0.33,0.1642,72,89,161,161,True
1146,2011-02-20,1,0,2,12,0,0,0,1,0.3,0.3182,0.33,0.1045,62,120,182,182,True
1147,2011-02-20,1,0,2,13,0,0,0,1,0.34,0.3333,0.29,0.0,76,122,198,198,True
1148,2011-02-20,1,0,2,14,0,0,0,1,0.36,0.3485,0.27,0.1642,108,104,212,212,True
1149,2011-02-20,1,0,2,15,0,0,0,1,0.36,0.3636,0.27,0.0896,66,102,168,168,True
1150,2011-02-20,1,0,2,16,0,0,0,1,0.36,0.3636,0.29,0.0896,59,88,147,147,True
1151,2011-02-20,1,0,2,17,0,0,0,1,0.34,0.3485,0.33,0.1642,60,86,146,146,True
1152,2011-02-20,1,0,2,18,0,0,0,2,0.34,0.3333,0.36,0.1343,30,71,101,101,True
1153,2011-02-20,1,0,2,19,0,0,0,2,0.34,0.3333,0.36,0.1343,3,39,42,42,True
1154,2011-02-20,1,0,2,20,0,0,0,2,0.34,0.3636,0.42,0.0,12,30,42,42,True
1155,2011-02-20,1,0,2,21,0,0,0,2,0.32,0.3485,0.53,0.0,17,39,56,56,True
1156,2011-02-20,1,0,2,22,0,0,0,2,0.32,0.303,0.57,0.2239,4,43,47,47,True
1157,2011-02-20,1,0,2,23,0,0,0,2,0.3,0.303,0.61,0.1642,9,45,54,54,True
1158,2011-02-21,1,0,2,0,1,1,0,2,0.34,0.303,0.42,0.3284,7,30,37,37,True
1159,2011-02-21,1,0,2,1,1,1,0,2,0.34,0.303,0.42,0.3284,2,11,13,13,True
1160,2011-02-21,1,0,2,2,1,1,0,2,0.34,0.303,0.42,0.3284,1,3,4,4,True
1161,2011-02-21,1,0,2,3,1,1,0,2,0.34,0.303,0.42,0.2985,2,3,5,5,True
1162,2011-02-21,1,0,2,4,1,1,0,1,0.32,0.3182,0.45,0.1642,1,0,1,1,True
1163,2011-02-21,1,0,2,5,1,1,0,2,0.34,0.3636,0.36,0.0,1,2,3,3,True
1164,2011-02-21,1,0,2,6,1,1,0,2,0.42,0.4242,0.26,0.2985,2,6,8,8,True
1165,2011-02-21,1,0,2,7,1,1,0,2,0.42,0.4242,0.26,0.2836,3,16,19,19,True
1166,2011-02-21,1,0,2,8,1,1,0,2,0.32,0.303,0.57,0.2985,7,56,63,63,True
1167,2011-02-21,1,0,2,9,1,1,0,2,0.32,0.303,0.57,0.2836,11,46,57,57,True
1168,2011-02-21,1,0,2,10,1,1,0,2,0.32,0.303,0.57,0.2537,29,52,81,81,True
1169,2011-02-21,1,0,2,11,1,1,0,2,0.32,0.3333,0.57,0.1045,20,70,90,90,True
1170,2011-02-21,1,0,2,12,1,1,0,2,0.32,0.3182,0.66,0.194,26,67,93,93,True
1171,2011-02-21,1,0,2,13,1,1,0,3,0.3,0.2727,0.81,0.3284,28,75,103,103,True
1172,2011-02-21,1,0,2,14,1,1,0,2,0.32,0.303,0.76,0.2537,15,101,116,116,True
1173,2011-02-21,1,0,2,15,1,1,0,2,0.3,0.2727,0.7,0.4478,11,76,87,87,True
1174,2011-02-21,1,0,2,16,1,1,0,3,0.28,0.2424,0.75,0.4179,8,48,56,56,True
1175,2011-02-21,1,0,2,17,1,1,0,2,0.28,0.2576,0.75,0.3881,18,62,80,80,True
1176,2011-02-21,1,0,2,18,1,1,0,2,0.24,0.2121,0.87,0.3582,2,64,66,66,True
1177,2011-02-21,1,0,2,19,1,1,0,2,0.24,0.2121,0.87,0.3582,0,49,49,49,True
1178,2011-02-21,1,0,2,20,1,1,0,3,0.24,0.2121,0.81,0.3881,0,29,29,29,True
1179,2011-02-21,1,0,2,21,1,1,0,3,0.22,0.197,0.75,0.4478,1,33,34,34,True
1180,2011-02-21,1,0,2,22,1,1,0,3,0.2,0.1667,0.75,0.4179,0,11,11,11,True
1181,2011-02-21,1,0,2,23,1,1,0,3,0.2,0.1667,0.75,0.4179,0,2,2,2,True
1182,2011-02-22,1,0,2,6,0,2,1,2,0.12,0.1212,0.8,0.2836,0,7,7,7,True
1183,2011-02-22,1,0,2,7,0,2,1,2,0.12,0.1212,0.8,0.2836,0,40,40,40,True
1184,2011-02-22,1,0,2,8,0,2,1,2,0.12,0.1212,0.8,0.2537,7,107,114,114,True
1185,2011-02-22,1,0,2,9,0,2,1,2,0.14,0.1212,0.74,0.2537,5,101,106,106,True
1186,2011-02-22,1,0,2,10,0,2,1,1,0.16,0.1818,0.69,0.0,0,44,44,44,True
1187,2011-02-22,1,0,2,11,0,2,1,1,0.16,0.2273,0.64,0.0,7,43,50,50,True
1188,2011-02-22,1,0,2,12,0,2,1,1,0.2,0.2273,0.59,0.1045,7,48,55,55,True
1189,2011-02-22,1,0,2,13,0,2,1,1,0.22,0.2273,0.55,0.1642,3,52,55,55,True
1190,2011-02-22,1,0,2,14,0,2,1,1,0.22,0.2273,0.55,0.194,9,49,58,58,True
1191,2011-02-22,1,0,2,15,0,2,1,1,0.24,0.2273,0.48,0.194,2,67,69,69,True
1192,2011-02-22,1,0,2,16,0,2,1,1,0.22,0.2273,0.51,0.1642,7,79,86,86,True
1193,2011-02-22,1,0,2,17,0,2,1,1,0.22,0.2121,0.51,0.2239,8,188,196,196,True
1194,2011-02-22,1,0,2,18,0,2,1,1,0.22,0.2273,0.47,0.1343,6,161,167,167,True
1195,2011-02-22,1,0,2,19,0,2,1,1,0.2,0.1818,0.47,0.2836,4,114,118,118,True
1196,2011-02-22,1,0,2,20,0,2,1,1,0.2,0.197,0.47,0.2239,3,102,105,105,True
1197,2011-02-22,1,0,2,21,0,2,1,1,0.2,0.197,0.47,0.2537,2,80,82,82,True
1198,2011-02-22,1,0,2,22,0,2,1,1,0.16,0.1515,0.43,0.2537,1,76,77,77,True
1199,2011-02-22,1,0,2,23,0,2,1,1,0.16,0.1515,0.43,0.2537,3,18,21,21,True
1200,2011-02-23,1,0,2,0,0,3,1,1,0.14,0.1364,0.5,0.194,0,6,6,6,True
1201,2011-02-23,1,0,2,1,0,3,1,1,0.14,0.1515,0.46,0.1642,0,4,4,4,True
1202,2011-02-23,1,0,2,2,0,3,1,1,0.12,0.1515,0.5,0.1343,0,1,1,1,True
1203,2011-02-23,1,0,2,3,0,3,1,1,0.12,0.1364,0.5,0.1642,0,2,2,2,True
1204,2011-02-23,1,0,2,5,0,3,1,1,0.12,0.1515,0.5,0.1045,0,8,8,8,True
1205,2011-02-23,1,0,2,6,0,3,1,1,0.12,0.1515,0.5,0.1045,0,36,36,36,True
1206,2011-02-23,1,0,2,7,0,3,1,1,0.12,0.1515,0.54,0.1343,2,94,96,96,True
1207,2011-02-23,1,0,2,8,0,3,1,1,0.14,0.1515,0.54,0.1642,8,227,235,235,True
1208,2011-02-23,1,0,2,9,0,3,1,1,0.18,0.2121,0.51,0.0896,9,130,139,139,True
1209,2011-02-23,1,0,2,10,0,3,1,1,0.2,0.2576,0.4,0.0,4,47,51,51,True
1210,2011-02-23,1,0,2,11,0,3,1,1,0.24,0.2576,0.41,0.1045,16,53,69,69,True
1211,2011-02-23,1,0,2,12,0,3,1,1,0.26,0.2879,0.35,0.0896,11,56,67,67,True
1212,2011-02-23,1,0,2,13,0,3,1,1,0.3,0.3182,0.28,0.0896,9,78,87,87,True
1213,2011-02-23,1,0,2,14,0,3,1,1,0.32,0.3333,0.29,0.1045,17,61,78,78,True
1214,2011-02-23,1,0,2,15,0,3,1,1,0.34,0.3485,0.25,0.0896,18,54,72,72,True
1215,2011-02-23,1,0,2,16,0,3,1,1,0.34,0.3636,0.25,0.0,15,79,94,94,True
1216,2011-02-23,1,0,2,17,0,3,1,1,0.34,0.3485,0.25,0.0896,15,207,222,222,True
1217,2011-02-23,1,0,2,18,0,3,1,1,0.32,0.3333,0.26,0.0896,3,206,209,209,True
1218,2011-02-23,1,0,2,19,0,3,1,1,0.3,0.3333,0.33,0.0,6,135,141,141,True
1219,2011-02-23,1,0,2,20,0,3,1,1,0.24,0.2424,0.6,0.1642,2,107,109,109,True
1220,2011-02-23,1,0,2,21,0,3,1,1,0.24,0.2879,0.48,0.0,2,89,91,91,True
1221,2011-02-23,1,0,2,22,0,3,1,1,0.24,0.2879,0.48,0.0,1,60,61,61,True
1222,2011-02-23,1,0,2,23,0,3,1,1,0.22,0.2576,0.55,0.0896,1,38,39,39,True
1223,2011-02-24,1,0,2,0,0,4,1,1,0.22,0.2576,0.55,0.0896,0,11,11,11,True
1224,2011-02-24,1,0,2,1,0,4,1,1,0.22,0.2576,0.6,0.0896,0,7,7,7,True
1225,2011-02-24,1,0,2,2,0,4,1,1,0.2,0.2273,0.64,0.0896,0,4,4,4,True
1226,2011-02-24,1,0,2,3,0,4,1,1,0.2,0.2121,0.64,0.1343,0,2,2,2,True
1227,2011-02-24,1,0,2,5,0,4,1,1,0.2,0.2121,0.69,0.1343,1,3,4,4,True
1228,2011-02-24,1,0,2,6,0,4,1,1,0.2,0.197,0.69,0.194,0,58,58,58,True
1229,2011-02-24,1,0,2,7,0,4,1,1,0.2,0.197,0.72,0.194,0,104,104,104,True
1230,2011-02-24,1,0,2,8,0,4,1,1,0.24,0.2273,0.7,0.2239,8,244,252,252,True
1231,2011-02-24,1,0,2,9,0,4,1,2,0.24,0.2121,0.75,0.2985,4,133,137,137,True
1232,2011-02-24,1,0,2,10,0,4,1,2,0.26,0.2424,0.7,0.2836,8,49,57,57,True
1233,2011-02-24,1,0,2,11,0,4,1,2,0.32,0.2879,0.57,0.3881,8,71,79,79,True
1234,2011-02-24,1,0,2,12,0,4,1,2,0.36,0.3333,0.53,0.3582,10,85,95,95,True
1235,2011-02-24,1,0,2,13,0,4,1,2,0.38,0.3939,0.54,0.2985,16,72,88,88,True
1236,2011-02-24,1,0,2,14,0,4,1,2,0.4,0.4091,0.5,0.2985,2,67,69,69,True
1237,2011-02-24,1,0,2,15,0,4,1,3,0.4,0.4091,0.54,0.3881,5,58,63,63,True
1238,2011-02-24,1,0,2,16,0,4,1,3,0.38,0.3939,0.62,0.2836,4,67,71,71,True
1239,2011-02-24,1,0,2,17,0,4,1,3,0.36,0.3485,0.66,0.194,9,168,177,177,True
1240,2011-02-24,1,0,2,18,0,4,1,2,0.34,0.303,0.87,0.3284,5,132,137,137,True
1241,2011-02-24,1,0,2,19,0,4,1,3,0.34,0.303,0.93,0.2985,3,112,115,115,True
1242,2011-02-24,1,0,2,20,0,4,1,2,0.34,0.303,0.93,0.3582,2,87,89,89,True
1243,2011-02-24,1,0,2,21,0,4,1,2,0.34,0.303,0.87,0.3284,7,76,83,83,True
1244,2011-02-24,1,0,2,22,0,4,1,3,0.34,0.3182,0.87,0.2836,5,50,55,55,True
1245,2011-02-24,1,0,2,23,0,4,1,2,0.32,0.303,0.93,0.2239,3,47,50,50,True
1246,2011-02-25,1,0,2,0,0,5,1,3,0.32,0.3485,0.93,0.0,1,8,9,9,True
1247,2011-02-25,1,0,2,1,0,5,1,2,0.32,0.3485,1.0,0.0,1,9,10,10,True
1248,2011-02-25,1,0,2,2,0,5,1,2,0.32,0.3485,1.0,0.0,0,3,3,3,True
1249,2011-02-25,1,0,2,3,0,5,1,2,0.32,0.3333,0.93,0.1045,1,1,2,2,True
1250,2011-02-25,1,0,2,5,0,5,1,2,0.32,0.3333,0.93,0.1045,1,5,6,6,True
1251,2011-02-25,1,0,2,6,0,5,1,3,0.34,0.3485,0.93,0.0896,0,11,11,11,True
1252,2011-02-25,1,0,2,7,0,5,1,3,0.34,0.3333,1.0,0.1343,1,34,35,35,True
1253,2011-02-25,1,0,2,8,0,5,1,3,0.36,0.3485,0.93,0.1343,3,70,73,73,True
1254,2011-02-25,1,0,2,9,0,5,1,3,0.34,0.303,0.93,0.3582,3,111,114,114,True
1255,2011-02-25,1,0,2,10,0,5,1,3,0.42,0.4242,0.94,0.3284,7,42,49,49,True
1256,2011-02-25,1,0,2,11,0,5,1,1,0.52,0.5,0.77,0.4478,9,50,59,59,True
1257,2011-02-25,1,0,2,12,0,5,1,3,0.54,0.5152,0.6,0.4627,20,95,115,115,True
1258,2011-02-25,1,0,2,13,0,5,1,3,0.54,0.5152,0.6,0.4627,6,77,83,83,True
1259,2011-02-25,1,0,2,14,0,5,1,3,0.56,0.5303,0.56,0.4775,14,71,85,85,True
1260,2011-02-25,1,0,2,15,0,5,1,1,0.46,0.4545,0.41,0.4775,5,50,55,55,True
1261,2011-02-25,1,0,2,16,0,5,1,1,0.32,0.2879,0.49,0.4627,11,91,102,102,True
1262,2011-02-25,1,0,2,17,0,5,1,1,0.32,0.2727,0.49,0.4775,8,181,189,189,True
1263,2011-02-25,1,0,2,18,0,5,1,1,0.32,0.2879,0.49,0.4775,7,150,157,157,True
1264,2011-02-25,1,0,2,19,0,5,1,1,0.3,0.2727,0.52,0.4478,4,86,90,90,True
1265,2011-02-25,1,0,2,20,0,5,1,1,0.3,0.2576,0.49,0.4775,2,60,62,62,True
1266,2011-02-25,1,0,2,21,0,5,1,1,0.28,0.2576,0.48,0.3881,7,56,63,63,True
1267,2011-02-25,1,0,2,22,0,5,1,1,0.26,0.2121,0.48,0.4478,7,43,50,50,True
1268,2011-02-25,1,0,2,23,0,5,1,1,0.26,0.2273,0.48,0.3284,2,37,39,39,True
1269,2011-02-26,1,0,2,0,0,6,0,1,0.24,0.2273,0.52,0.194,3,25,28,28,True
1270,2011-02-26,1,0,2,1,0,6,0,1,0.24,0.2121,0.52,0.2985,2,25,27,27,True
1271,2011-02-26,1,0,2,2,0,6,0,1,0.22,0.197,0.6,0.3582,3,9,12,12,True
1272,2011-02-26,1,0,2,3,0,6,0,1,0.22,0.2273,0.55,0.1343,1,7,8,8,True
1273,2011-02-26,1,0,2,4,0,6,0,2,0.22,0.2576,0.6,0.0896,1,1,2,2,True
1274,2011-02-26,1,0,2,5,0,6,0,2,0.22,0.2424,0.64,0.1045,1,9,10,10,True
1275,2011-02-26,1,0,2,6,0,6,0,1,0.22,0.2727,0.6,0.0,1,6,7,7,True
1276,2011-02-26,1,0,2,7,0,6,0,1,0.22,0.2576,0.6,0.0896,1,21,22,22,True
1277,2011-02-26,1,0,2,8,0,6,0,2,0.24,0.2879,0.6,0.0,2,55,57,57,True
1278,2011-02-26,1,0,2,9,0,6,0,2,0.26,0.2576,0.56,0.1642,9,65,74,74,True
1279,2011-02-26,1,0,2,10,0,6,0,2,0.3,0.303,0.49,0.1343,14,71,85,85,True
1280,2011-02-26,1,0,2,11,0,6,0,1,0.3,0.3333,0.45,0.0,26,100,126,126,True
1281,2011-02-26,1,0,2,12,0,6,0,2,0.32,0.3182,0.45,0.1642,45,115,160,160,True
1282,2011-02-26,1,0,2,13,0,6,0,2,0.34,0.3182,0.42,0.2537,38,136,174,174,True
1283,2011-02-26,1,0,2,14,0,6,0,2,0.34,0.303,0.36,0.3284,57,154,211,211,True
1284,2011-02-26,1,0,2,15,0,6,0,2,0.36,0.3333,0.4,0.2836,40,125,165,165,True
1285,2011-02-26,1,0,2,16,0,6,0,1,0.36,0.3333,0.46,0.2836,41,130,171,171,True
1286,2011-02-26,1,0,2,17,0,6,0,1,0.36,0.3485,0.43,0.2239,53,130,183,183,True
1287,2011-02-26,1,0,2,18,0,6,0,1,0.34,0.3333,0.46,0.194,26,111,137,137,True
1288,2011-02-26,1,0,2,19,0,6,0,1,0.32,0.303,0.49,0.2537,30,64,94,94,True
1289,2011-02-26,1,0,2,20,0,6,0,1,0.3,0.303,0.56,0.1642,8,60,68,68,True
1290,2011-02-26,1,0,2,21,0,6,0,1,0.28,0.2727,0.65,0.2537,9,59,68,68,True
1291,2011-02-26,1,0,2,22,0,6,0,1,0.28,0.2727,0.75,0.2239,8,38,46,46,True
1292,2011-02-26,1,0,2,23,0,6,0,1,0.28,0.2576,0.75,0.2836,5,29,34,34,True
1293,2011-02-27,1,0,2,0,0,0,0,1,0.26,0.2424,0.87,0.2836,8,26,34,34,True
1294,2011-02-27,1,0,2,1,0,0,0,1,0.26,0.2576,0.87,0.194,7,30,37,37,True
1295,2011-02-27,1,0,2,2,0,0,0,1,0.26,0.2727,0.87,0.1343,2,20,22,22,True
1296,2011-02-27,1,0,2,3,0,0,0,1,0.26,0.2879,0.87,0.0896,3,8,11,11,True
1297,2011-02-27,1,0,2,4,0,0,0,1,0.24,0.2424,0.87,0.1343,0,2,2,2,True
1298,2011-02-27,1,0,2,6,0,0,0,1,0.24,0.2879,0.87,0.0,2,1,3,3,True
1299,2011-02-27,1,0,2,7,0,0,0,1,0.24,0.2424,0.87,0.1343,6,8,14,14,True
1300,2011-02-27,1,0,2,8,0,0,0,1,0.26,0.303,0.87,0.0,9,26,35,35,True
1301,2011-02-27,1,0,2,9,0,0,0,1,0.28,0.303,0.87,0.0896,17,42,59,59,True
1302,2011-02-27,1,0,2,10,0,0,0,1,0.3,0.303,0.81,0.1642,24,79,103,103,True
1303,2011-02-27,1,0,2,11,0,0,0,1,0.36,0.3485,0.62,0.1343,33,92,125,125,True
1304,2011-02-27,1,0,2,12,0,0,0,1,0.4,0.4091,0.54,0.0896,61,132,193,193,True
1305,2011-02-27,1,0,2,13,0,0,0,1,0.42,0.4242,0.47,0.0,90,169,259,259,True
1306,2011-02-27,1,0,2,14,0,0,0,1,0.44,0.4394,0.47,0.0896,105,177,282,282,True
1307,2011-02-27,1,0,2,15,0,0,0,1,0.46,0.4545,0.44,0.1343,98,163,261,261,True
1308,2011-02-27,1,0,2,16,0,0,0,1,0.48,0.4697,0.44,0.1642,98,170,268,268,True
1309,2011-02-27,1,0,2,17,0,0,0,1,0.42,0.4242,0.54,0.194,66,121,187,187,True
1310,2011-02-27,1,0,2,18,0,0,0,1,0.4,0.4091,0.54,0.194,24,103,127,127,True
1311,2011-02-27,1,0,2,19,0,0,0,1,0.4,0.4091,0.54,0.1343,16,86,102,102,True
1312,2011-02-27,1,0,2,20,0,0,0,1,0.4,0.4091,0.54,0.0896,9,72,81,81,True
1313,2011-02-27,1,0,2,21,0,0,0,1,0.38,0.3939,0.62,0.1642,8,61,69,69,True
1314,2011-02-27,1,0,2,22,0,0,0,2,0.38,0.3939,0.62,0.1045,2,67,69,69,True
1315,2011-02-27,1,0,2,23,0,0,0,2,0.36,0.3485,0.62,0.1642,6,53,59,59,True
1316,2011-02-28,1,0,2,0,0,1,1,2,0.36,0.3636,0.66,0.1045,5,25,30,30,True
1317,2011-02-28,1,0,2,1,0,1,1,3,0.34,0.303,0.87,0.3582,1,7,8,8,True
1318,2011-02-28,1,0,2,3,0,1,1,3,0.32,0.3182,0.93,0.1642,0,1,1,1,True
1319,2011-02-28,1,0,2,5,0,1,1,2,0.34,0.3636,0.93,0.0,1,4,5,5,True
1320,2011-02-28,1,0,2,6,0,1,1,2,0.34,0.3485,0.96,0.1045,1,27,28,28,True
1321,2011-02-28,1,0,2,7,0,1,1,2,0.36,0.3636,0.93,0.1045,2,90,92,92,True
1322,2011-02-28,1,0,2,8,0,1,1,2,0.34,0.303,0.93,0.2985,13,242,255,255,True
1323,2011-02-28,1,0,2,9,0,1,1,1,0.42,0.4242,0.82,0.2836,15,127,142,142,True
1324,2011-02-28,1,0,2,10,0,1,1,2,0.52,0.5,0.72,0.4775,13,79,92,92,True
1325,2011-02-28,1,0,2,11,0,1,1,2,0.56,0.5303,0.64,0.2985,13,74,87,87,True
1326,2011-02-28,1,0,2,12,0,1,1,2,0.56,0.5303,0.64,0.2985,0,36,36,36,True
1327,2011-02-28,1,0,2,13,0,1,1,3,0.46,0.4545,0.94,0.2239,1,31,32,32,True
1328,2011-02-28,1,0,2,14,0,1,1,3,0.42,0.4242,1.0,0.2985,1,24,25,25,True
1329,2011-02-28,1,0,2,15,0,1,1,3,0.42,0.4242,1.0,0.2985,0,35,35,35,True
1330,2011-02-28,1,0,2,16,0,1,1,3,0.42,0.4242,1.0,0.1343,2,40,42,42,True
1331,2011-02-28,1,0,2,17,0,1,1,3,0.4,0.4091,1.0,0.2985,2,77,79,79,True
1332,2011-02-28,1,0,2,18,0,1,1,3,0.46,0.4545,0.94,0.194,4,127,131,131,True
1333,2011-02-28,1,0,2,19,0,1,1,3,0.44,0.4394,0.88,0.4775,1,79,80,80,True
1334,2011-02-28,1,0,2,20,0,1,1,3,0.44,0.4394,0.88,0.4775,0,45,45,45,True
1335,2011-02-28,1,0,2,21,0,1,1,2,0.38,0.3939,0.87,0.3881,2,78,80,80,True
1336,2011-02-28,1,0,2,22,0,1,1,3,0.34,0.303,0.93,0.4179,4,72,76,76,True
1337,2011-02-28,1,0,2,23,0,1,1,2,0.32,0.2879,0.81,0.3881,0,45,45,45,True
1338,2011-03-01,1,0,3,0,0,2,1,1,0.3,0.2727,0.7,0.4627,0,7,7,7,True
1339,2011-03-01,1,0,3,1,0,2,1,1,0.26,0.2273,0.7,0.3582,0,3,3,3,True
1340,2011-03-01,1,0,3,2,0,2,1,1,0.24,0.2121,0.65,0.3881,0,4,4,4,True
1341,2011-03-01,1,0,3,3,0,2,1,1,0.22,0.2121,0.69,0.2836,0,2,2,2,True
1342,2011-03-01,1,0,3,4,0,2,1,1,0.22,0.2121,0.69,0.2537,0,1,1,1,True
1343,2011-03-01,1,0,3,5,0,2,1,1,0.2,0.1818,0.64,0.2836,1,1,2,2,True
1344,2011-03-01,1,0,3,6,0,2,1,1,0.2,0.1818,0.59,0.2985,0,46,46,46,True
1345,2011-03-01,1,0,3,7,0,2,1,1,0.2,0.1818,0.59,0.3284,2,105,107,107,True
1346,2011-03-01,1,0,3,8,0,2,1,1,0.2,0.1818,0.59,0.3881,10,204,214,214,True
1347,2011-03-01,1,0,3,9,0,2,1,1,0.22,0.197,0.55,0.4179,8,116,124,124,True
1348,2011-03-01,1,0,3,10,0,2,1,1,0.24,0.2121,0.52,0.2836,13,55,68,68,True
1349,2011-03-01,1,0,3,11,0,2,1,1,0.28,0.2727,0.45,0.2537,8,48,56,56,True
1350,2011-03-01,1,0,3,12,0,2,1,1,0.3,0.303,0.39,0.1343,6,80,86,86,True
1351,2011-03-01,1,0,3,13,0,2,1,1,0.32,0.3485,0.39,0.0,13,65,78,78,True
1352,2011-03-01,1,0,3,14,0,2,1,1,0.32,0.3333,0.36,0.1343,18,61,79,79,True
1353,2011-03-01,1,0,3,15,0,2,1,1,0.34,0.3636,0.34,0.0,7,57,64,64,True
1354,2011-03-01,1,0,3,16,0,2,1,1,0.34,0.3485,0.34,0.0896,10,92,102,102,True
1355,2011-03-01,1,0,3,17,0,2,1,1,0.34,0.3485,0.34,0.0896,12,230,242,242,True
1356,2011-03-01,1,0,3,18,0,2,1,1,0.32,0.3182,0.39,0.194,10,214,224,224,True
1357,2011-03-01,1,0,3,19,0,2,1,1,0.3,0.303,0.49,0.1343,4,115,119,119,True
1358,2011-03-01,1,0,3,20,0,2,1,1,0.3,0.3182,0.61,0.0896,2,86,88,88,True
1359,2011-03-01,1,0,3,21,0,2,1,1,0.26,0.303,0.56,0.0,8,55,63,63,True
1360,2011-03-01,1,0,3,22,0,2,1,1,0.24,0.2727,0.62,0.1045,3,44,47,47,True
1361,2011-03-01,1,0,3,23,0,2,1,1,0.24,0.2273,0.65,0.2239,2,23,25,25,True
1362,2011-03-02,1,0,3,0,0,3,1,1,0.22,0.2273,0.69,0.1642,3,5,8,8,True
1363,2011-03-02,1,0,3,1,0,3,1,1,0.22,0.2273,0.69,0.194,0,4,4,4,True
1364,2011-03-02,1,0,3,2,0,3,1,1,0.22,0.2273,0.69,0.194,0,2,2,2,True
1365,2011-03-02,1,0,3,3,0,3,1,1,0.22,0.2121,0.69,0.2836,3,1,4,4,True
1366,2011-03-02,1,0,3,4,0,3,1,1,0.2,0.2121,0.75,0.1343,1,0,1,1,True
1367,2011-03-02,1,0,3,5,0,3,1,1,0.22,0.2121,0.69,0.2239,0,5,5,5,True
1368,2011-03-02,1,0,3,6,0,3,1,1,0.22,0.2121,0.55,0.2537,1,39,40,40,True
1369,2011-03-02,1,0,3,7,0,3,1,1,0.22,0.2121,0.64,0.2537,2,108,110,110,True
1370,2011-03-02,1,0,3,8,0,3,1,1,0.24,0.2121,0.65,0.2836,13,243,256,256,True
1371,2011-03-02,1,0,3,9,0,3,1,1,0.28,0.2576,0.56,0.2985,7,141,148,148,True
1372,2011-03-02,1,0,3,10,0,3,1,1,0.32,0.303,0.49,0.2836,11,65,76,76,True
1373,2011-03-02,1,0,3,11,0,3,1,1,0.34,0.303,0.53,0.3284,8,65,73,73,True
1374,2011-03-02,1,0,3,12,0,3,1,1,0.4,0.4091,0.43,0.194,20,62,82,82,True
1375,2011-03-02,1,0,3,13,0,3,1,1,0.5,0.4848,0.25,0.0,35,90,125,125,True
1376,2011-03-02,1,0,3,14,0,3,1,1,0.52,0.5,0.23,0.2985,21,75,96,96,True
1377,2011-03-02,1,0,3,15,0,3,1,1,0.54,0.5152,0.19,0.4179,19,91,110,110,True
1378,2011-03-02,1,0,3,16,0,3,1,1,0.54,0.5152,0.19,0.3284,27,112,139,139,True
1379,2011-03-02,1,0,3,17,0,3,1,1,0.5,0.4848,0.23,0.2836,30,238,268,268,True
1380,2011-03-02,1,0,3,18,0,3,1,1,0.46,0.4545,0.23,0.4775,8,193,201,201,True
1381,2011-03-02,1,0,3,19,0,3,1,1,0.4,0.4091,0.28,0.4775,6,144,150,150,True
1382,2011-03-02,1,0,3,20,0,3,1,1,0.36,0.3333,0.29,0.4179,9,86,95,95,True
1383,2011-03-02,1,0,3,21,0,3,1,1,0.34,0.2879,0.29,0.4627,3,68,71,71,True
1384,2011-03-02,1,0,3,22,0,3,1,1,0.3,0.2576,0.26,0.4775,4,44,48,48,True
1385,2011-03-02,1,0,3,23,0,3,1,1,0.26,0.2121,0.3,0.4775,0,22,22,22,True
1386,2011-03-03,1,0,3,0,0,4,1,1,0.24,0.197,0.3,0.4627,3,10,13,13,True
1387,2011-03-03,1,0,3,1,0,4,1,1,0.24,0.197,0.3,0.4627,0,1,1,1,True
1388,2011-03-03,1,0,3,2,0,4,1,1,0.2,0.1667,0.27,0.4627,1,2,3,3,True
1389,2011-03-03,1,0,3,3,0,4,1,1,0.2,0.1667,0.27,0.4627,0,1,1,1,True
1390,2011-03-03,1,0,3,4,0,4,1,1,0.16,0.1212,0.31,0.4775,0,1,1,1,True
1391,2011-03-03,1,0,3,5,0,4,1,1,0.14,0.1212,0.33,0.2985,1,7,8,8,True
1392,2011-03-03,1,0,3,6,0,4,1,1,0.14,0.1212,0.33,0.2985,1,34,35,35,True
1393,2011-03-03,1,0,3,7,0,4,1,1,0.12,0.0909,0.42,0.4179,1,110,111,111,True
1394,2011-03-03,1,0,3,8,0,4,1,1,0.14,0.1212,0.39,0.2985,4,216,220,220,True
1395,2011-03-03,1,0,3,9,0,4,1,1,0.16,0.1364,0.37,0.2836,10,135,145,145,True
1396,2011-03-03,1,0,3,10,0,4,1,1,0.18,0.1818,0.29,0.194,7,49,56,56,True
1397,2011-03-03,1,0,3,11,0,4,1,1,0.2,0.2273,0.29,0.0896,10,40,50,50,True
1398,2011-03-03,1,0,3,12,0,4,1,1,0.22,0.2273,0.25,0.1343,7,65,72,72,True
1399,2011-03-03,1,0,3,13,0,4,1,1,0.22,0.2576,0.25,0.0896,13,67,80,80,True
1400,2011-03-03,1,0,3,14,0,4,1,1,0.24,0.2576,0.21,0.1045,18,60,78,78,True
1401,2011-03-03,1,0,3,15,0,4,1,1,0.24,0.2879,0.23,0.0,6,62,68,68,True
1402,2011-03-03,1,0,3,16,0,4,1,1,0.26,0.303,0.23,0.0,6,65,71,71,True
1403,2011-03-03,1,0,3,17,0,4,1,1,0.26,0.303,0.22,0.0,17,185,202,202,True
1404,2011-03-03,1,0,3,18,0,4,1,1,0.24,0.2121,0.35,0.3284,6,161,167,167,True
1405,2011-03-03,1,0,3,19,0,4,1,1,0.2,0.197,0.4,0.2537,5,101,106,106,True
1406,2011-03-03,1,0,3,20,0,4,1,1,0.2,0.2273,0.4,0.0896,1,69,70,70,True
1407,2011-03-03,1,0,3,21,0,4,1,1,0.18,0.2121,0.4,0.1045,3,48,51,51,True
1408,2011-03-03,1,0,3,22,0,4,1,1,0.2,0.2576,0.4,0.0,3,50,53,53,True
1409,2011-03-03,1,0,3,23,0,4,1,2,0.18,0.2121,0.43,0.0896,0,23,23,23,True
1410,2011-03-04,1,0,3,0,0,5,1,2,0.2,0.197,0.55,0.194,0,12,12,12,True
1411,2011-03-04,1,0,3,1,0,5,1,2,0.18,0.1818,0.64,0.194,0,4,4,4,True
1412,2011-03-04,1,0,3,2,0,5,1,2,0.18,0.1818,0.64,0.194,0,2,2,2,True
1413,2011-03-04,1,0,3,3,0,5,1,2,0.18,0.1667,0.74,0.2537,0,1,1,1,True
1414,2011-03-04,1,0,3,4,0,5,1,2,0.18,0.1818,0.74,0.194,1,0,1,1,True
1415,2011-03-04,1,0,3,5,0,5,1,2,0.16,0.1818,0.74,0.1343,0,7,7,7,True
1416,2011-03-04,1,0,3,6,0,5,1,2,0.16,0.197,0.74,0.0896,1,28,29,29,True
1417,2011-03-04,1,0,3,7,0,5,1,1,0.16,0.1818,0.8,0.1343,0,83,83,83,True
1418,2011-03-04,1,0,3,8,0,5,1,1,0.18,0.197,0.74,0.1343,6,222,228,228,True
1419,2011-03-04,1,0,3,9,0,5,1,1,0.22,0.2273,0.6,0.1343,12,138,150,150,True
1420,2011-03-04,1,0,3,10,0,5,1,1,0.24,0.2273,0.6,0.2537,10,56,66,66,True
1421,2011-03-04,1,0,3,11,0,5,1,1,0.28,0.2727,0.52,0.2239,16,73,89,89,True
1422,2011-03-04,1,0,3,12,0,5,1,1,0.32,0.303,0.43,0.1642,10,87,97,97,True
1423,2011-03-04,1,0,3,13,0,5,1,1,0.34,0.3182,0.42,0.2239,13,74,87,87,True
1424,2011-03-04,1,0,3,14,0,5,1,1,0.36,0.3333,0.4,0.2836,30,65,95,95,True
1425,2011-03-04,1,0,3,15,0,5,1,1,0.36,0.3333,0.4,0.2985,31,75,106,106,True
1426,2011-03-04,1,0,3,16,0,5,1,1,0.36,0.3485,0.46,0.194,17,101,118,118,True
1427,2011-03-04,1,0,3,17,0,5,1,2,0.36,0.3333,0.5,0.2537,22,206,228,228,True
1428,2011-03-04,1,0,3,18,0,5,1,2,0.34,0.303,0.53,0.2985,15,172,187,187,True
1429,2011-03-04,1,0,3,19,0,5,1,1,0.32,0.303,0.61,0.2537,5,102,107,107,True
1430,2011-03-04,1,0,3,20,0,5,1,2,0.3,0.2879,0.7,0.194,9,78,87,87,True
1431,2011-03-04,1,0,3,21,0,5,1,2,0.3,0.2879,0.7,0.2239,6,64,70,70,True
1432,2011-03-04,1,0,3,22,0,5,1,1,0.3,0.2879,0.7,0.194,4,40,44,44,True
1433,2011-03-04,1,0,3,23,0,5,1,2,0.3,0.303,0.75,0.1642,6,40,46,46,True
1434,2011-03-05,1,0,3,0,0,6,0,2,0.28,0.2879,0.81,0.1045,4,15,19,19,True
1435,2011-03-05,1,0,3,1,0,6,0,2,0.3,0.3182,0.81,0.1045,5,20,25,25,True
1436,2011-03-05,1,0,3,2,0,6,0,2,0.3,0.2879,0.87,0.194,5,15,20,20,True
1437,2011-03-05,1,0,3,3,0,6,0,2,0.3,0.2879,0.87,0.194,0,2,2,2,True
1438,2011-03-05,1,0,3,4,0,6,0,2,0.3,0.303,0.93,0.1642,0,1,1,1,True
1439,2011-03-05,1,0,3,5,0,6,0,2,0.3,0.303,1.0,0.1343,0,3,3,3,True
1440,2011-03-05,1,0,3,6,0,6,0,2,0.3,0.2879,1.0,0.2239,1,3,4,4,True
1441,2011-03-05,1,0,3,7,0,6,0,2,0.3,0.2727,1.0,0.2985,5,10,15,15,True
1442,2011-03-05,1,0,3,8,0,6,0,2,0.3,0.2727,1.0,0.2985,11,34,45,45,True
1443,2011-03-05,1,0,3,9,0,6,0,2,0.32,0.303,0.93,0.2239,15,48,63,63,True
1444,2011-03-05,1,0,3,10,0,6,0,2,0.34,0.3333,0.93,0.194,34,69,103,103,True
1445,2011-03-05,1,0,3,11,0,6,0,2,0.4,0.4091,0.76,0.2239,43,116,159,159,True
1446,2011-03-05,1,0,3,12,0,6,0,2,0.44,0.4394,0.67,0.2537,46,121,167,167,True
1447,2011-03-05,1,0,3,13,0,6,0,2,0.46,0.4545,0.67,0.2836,60,130,190,190,True
1448,2011-03-05,1,0,3,14,0,6,0,2,0.48,0.4697,0.59,0.2836,80,118,198,198,True
1449,2011-03-05,1,0,3,15,0,6,0,2,0.46,0.4545,0.63,0.2985,83,122,205,205,True
1450,2011-03-05,1,0,3,16,0,6,0,2,0.48,0.4697,0.59,0.2985,74,130,204,204,True
1451,2011-03-05,1,0,3,17,0,6,0,2,0.48,0.4697,0.59,0.3582,60,104,164,164,True
1452,2011-03-05,1,0,3,18,0,6,0,2,0.48,0.4697,0.59,0.3284,37,115,152,152,True
1453,2011-03-05,1,0,3,19,0,6,0,2,0.46,0.4545,0.67,0.3284,27,62,89,89,True
1454,2011-03-05,1,0,3,20,0,6,0,2,0.44,0.4394,0.77,0.3284,12,58,70,70,True
1455,2011-03-05,1,0,3,21,0,6,0,2,0.44,0.4394,0.72,0.3284,12,60,72,72,True
1456,2011-03-05,1,0,3,22,0,6,0,2,0.42,0.4242,0.77,0.2985,16,47,63,63,True
1457,2011-03-05,1,0,3,23,0,6,0,2,0.44,0.4394,0.77,0.2985,10,34,44,44,True
1458,2011-03-06,1,0,3,0,0,0,0,2,0.42,0.4242,0.77,0.3582,11,41,52,52,True
1459,2011-03-06,1,0,3,1,0,0,0,2,0.42,0.4242,0.77,0.2836,12,27,39,39,True
1460,2011-03-06,1,0,3,2,0,0,0,2,0.4,0.4091,0.82,0.2836,5,27,32,32,True
1461,2011-03-06,1,0,3,3,0,0,0,2,0.42,0.4242,0.82,0.2985,2,9,11,11,True
1462,2011-03-06,1,0,3,4,0,0,0,2,0.42,0.4242,0.88,0.3582,0,3,3,3,True
1463,2011-03-06,1,0,3,6,0,0,0,2,0.42,0.4242,0.94,0.3582,1,1,2,2,True
1464,2011-03-06,1,0,3,7,0,0,0,3,0.42,0.4242,1.0,0.4478,0,5,5,5,True
1465,2011-03-06,1,0,3,8,0,0,0,2,0.4,0.4091,1.0,0.2985,1,8,9,9,True
1466,2011-03-06,1,0,3,9,0,0,0,2,0.42,0.4242,1.0,0.2836,4,18,22,22,True
1467,2011-03-06,1,0,3,10,0,0,0,2,0.42,0.4242,1.0,0.2985,4,27,31,31,True
1468,2011-03-06,1,0,3,11,0,0,0,2,0.42,0.4242,1.0,0.2239,18,44,62,62,True
1469,2011-03-06,1,0,3,12,0,0,0,2,0.46,0.4545,0.94,0.3284,10,69,79,79,True
1470,2011-03-06,1,0,3,13,0,0,0,2,0.46,0.4545,0.94,0.3582,22,83,105,105,True
1471,2011-03-06,1,0,3,14,0,0,0,3,0.44,0.4394,1.0,0.2239,12,27,39,39,True
1472,2011-03-06,1,0,3,15,0,0,0,3,0.44,0.4394,1.0,0.2239,3,4,7,7,True
1473,2011-03-06,1,0,3,16,0,0,0,3,0.36,0.3333,1.0,0.2836,3,8,11,11,True
1474,2011-03-06,1,0,3,17,0,0,0,3,0.34,0.303,1.0,0.2985,2,23,25,25,True
1475,2011-03-06,1,0,3,18,0,0,0,3,0.32,0.2879,1.0,0.3582,0,23,23,23,True
1476,2011-03-06,1,0,3,19,0,0,0,3,0.3,0.2576,1.0,0.4775,0,11,11,11,True
1477,2011-03-06,1,0,3,20,0,0,0,3,0.28,0.2424,1.0,0.4179,3,8,11,11,True
1478,2011-03-06,1,0,3,21,0,0,0,3,0.24,0.1818,0.93,0.4775,1,6,7,7,True
1479,2011-03-06,1,0,3,22,0,0,0,2,0.22,0.197,1.0,0.3881,0,10,10,10,True
1480,2011-03-06,1,0,3,23,0,0,0,2,0.22,0.197,1.0,0.4179,0,9,9,9,True
1481,2011-03-07,1,0,3,0,0,1,1,3,0.2,0.1818,1.0,0.3284,0,4,4,4,True
1482,2011-03-07,1,0,3,1,0,1,1,3,0.2,0.1818,1.0,0.3284,0,2,2,2,True
1483,2011-03-07,1,0,3,3,0,1,1,1,0.2,0.1515,0.8,0.4775,0,1,1,1,True
1484,2011-03-07,1,0,3,4,0,1,1,1,0.2,0.1515,0.8,0.4775,1,0,1,1,True
1485,2011-03-07,1,0,3,5,0,1,1,1,0.2,0.1818,0.75,0.3582,0,1,1,1,True
1486,2011-03-07,1,0,3,6,0,1,1,1,0.2,0.1818,0.75,0.3881,3,31,34,34,True
1487,2011-03-07,1,0,3,7,0,1,1,1,0.2,0.1667,0.75,0.4179,3,88,91,91,True
1488,2011-03-07,1,0,3,8,0,1,1,1,0.2,0.1818,0.75,0.3881,11,200,211,211,True
1489,2011-03-07,1,0,3,9,0,1,1,1,0.22,0.1818,0.64,0.4627,5,129,134,134,True
1490,2011-03-07,1,0,3,10,0,1,1,1,0.24,0.2121,0.6,0.2985,15,43,58,58,True
1491,2011-03-07,1,0,3,11,0,1,1,1,0.26,0.2121,0.48,0.4478,19,41,60,60,True
1492,2011-03-07,1,0,3,12,0,1,1,1,0.3,0.2727,0.42,0.4179,28,68,96,96,True
1493,2011-03-07,1,0,3,13,0,1,1,1,0.32,0.2879,0.36,0.3881,16,54,70,70,True
1494,2011-03-07,1,0,3,14,0,1,1,1,0.32,0.2879,0.36,0.4179,21,56,77,77,True
1495,2011-03-07,1,0,3,15,0,1,1,1,0.34,0.303,0.31,0.3881,32,64,96,96,True
1496,2011-03-07,1,0,3,16,0,1,1,1,0.34,0.303,0.31,0.3582,26,96,122,122,True
1497,2011-03-07,1,0,3,17,0,1,1,1,0.34,0.303,0.29,0.3582,27,206,233,233,True
1498,2011-03-07,1,0,3,18,0,1,1,1,0.32,0.303,0.31,0.2239,19,214,233,233,True
1499,2011-03-07,1,0,3,19,0,1,1,1,0.3,0.2879,0.33,0.2239,11,134,145,145,True
1500,2011-03-07,1,0,3,20,0,1,1,1,0.3,0.303,0.33,0.1642,5,87,92,92,True
1501,2011-03-07,1,0,3,21,0,1,1,1,0.28,0.2727,0.38,0.2239,1,53,54,54,True
1502,2011-03-07,1,0,3,22,0,1,1,1,0.26,0.2576,0.48,0.1642,1,34,35,35,True
1503,2011-03-07,1,0,3,23,0,1,1,1,0.28,0.3182,0.48,0.0,0,22,22,22,True
1504,2011-03-08,1,0,3,0,0,2,1,1,0.26,0.2879,0.48,0.0896,1,9,10,10,True
1505,2011-03-08,1,0,3,1,0,2,1,1,0.24,0.2424,0.52,0.1343,0,4,4,4,True
1506,2011-03-08,1,0,3,2,0,2,1,1,0.24,0.2424,0.52,0.1343,1,0,1,1,True
1507,2011-03-08,1,0,3,3,0,2,1,1,0.24,0.2576,0.52,0.0896,5,2,7,7,True
1508,2011-03-08,1,0,3,4,0,2,1,1,0.22,0.2727,0.64,0.0,0,2,2,2,True
1509,2011-03-08,1,0,3,5,0,2,1,1,0.2,0.2273,0.69,0.1045,2,8,10,10,True
1510,2011-03-08,1,0,3,6,0,2,1,1,0.2,0.2576,0.59,0.0,3,42,45,45,True
1511,2011-03-08,1,0,3,7,0,2,1,1,0.18,0.197,0.64,0.1343,9,119,128,128,True
1512,2011-03-08,1,0,3,8,0,2,1,1,0.22,0.2273,0.55,0.194,10,247,257,257,True
1513,2011-03-08,1,0,3,9,0,2,1,1,0.26,0.2576,0.41,0.1642,11,140,151,151,True
1514,2011-03-08,1,0,3,10,0,2,1,2,0.3,0.2879,0.33,0.194,25,46,71,71,True
1515,2011-03-08,1,0,3,11,0,2,1,2,0.36,0.3485,0.25,0.1642,26,52,78,78,True
1516,2011-03-08,1,0,3,12,0,2,1,2,0.36,0.3788,0.23,0.0,29,70,99,99,True
1517,2011-03-08,1,0,3,13,0,2,1,2,0.38,0.3939,0.25,0.1045,25,73,98,98,True
1518,2011-03-08,1,0,3,14,0,2,1,2,0.38,0.3939,0.2,0.0,16,56,72,72,True
1519,2011-03-08,1,0,3,15,0,2,1,2,0.36,0.3788,0.18,0.0,35,77,112,112,True
1520,2011-03-08,1,0,3,16,0,2,1,1,0.38,0.3939,0.27,0.1642,26,82,108,108,True
1521,2011-03-08,1,0,3,17,0,2,1,1,0.36,0.3485,0.27,0.2239,39,209,248,248,True
1522,2011-03-08,1,0,3,18,0,2,1,1,0.34,0.3333,0.27,0.194,21,214,235,235,True
1523,2011-03-08,1,0,3,19,0,2,1,1,0.34,0.3485,0.31,0.1045,9,141,150,150,True
1524,2011-03-08,1,0,3,20,0,2,1,1,0.32,0.3333,0.39,0.0896,2,74,76,76,True
1525,2011-03-08,1,0,3,21,0,2,1,1,0.3,0.2879,0.49,0.194,7,68,75,75,True
1526,2011-03-08,1,0,3,22,0,2,1,1,0.3,0.2879,0.49,0.2239,11,44,55,55,True
1527,2011-03-08,1,0,3,23,0,2,1,1,0.28,0.2727,0.61,0.194,3,38,41,41,True
1528,2011-03-09,1,0,3,0,0,3,1,1,0.26,0.2879,0.65,0.0896,0,9,9,9,True
1529,2011-03-09,1,0,3,1,0,3,1,1,0.26,0.2727,0.52,0.1343,0,4,4,4,True
1530,2011-03-09,1,0,3,2,0,3,1,1,0.26,0.2727,0.52,0.1343,1,1,2,2,True
1531,2011-03-09,1,0,3,3,0,3,1,1,0.24,0.2576,0.7,0.0896,1,2,3,3,True
1532,2011-03-09,1,0,3,4,0,3,1,1,0.24,0.2576,0.75,0.1045,0,2,2,2,True
1533,2011-03-09,1,0,3,5,0,3,1,2,0.24,0.2424,0.81,0.1343,1,7,8,8,True
1534,2011-03-09,1,0,3,6,0,3,1,2,0.24,0.2576,0.85,0.1045,5,44,49,49,True
1535,2011-03-09,1,0,3,7,0,3,1,2,0.24,0.2424,0.87,0.1642,18,123,141,141,True
1536,2011-03-09,1,0,3,8,0,3,1,2,0.24,0.2424,0.87,0.1343,11,238,249,249,True
1537,2011-03-09,1,0,3,9,0,3,1,2,0.26,0.2424,0.87,0.2537,5,136,141,141,True
1538,2011-03-09,1,0,3,10,0,3,1,2,0.3,0.2879,0.75,0.2537,8,49,57,57,True
1539,2011-03-09,1,0,3,11,0,3,1,2,0.32,0.2879,0.76,0.3881,15,44,59,59,True
1540,2011-03-09,1,0,3,12,0,3,1,2,0.32,0.303,0.76,0.2537,14,84,98,98,True
1541,2011-03-09,1,0,3,13,0,3,1,2,0.32,0.2879,0.76,0.3582,17,82,99,99,True
1542,2011-03-09,1,0,3,14,0,3,1,2,0.34,0.303,0.76,0.2985,10,61,71,71,True
1543,2011-03-09,1,0,3,15,0,3,1,2,0.36,0.3333,0.71,0.2985,15,64,79,79,True
1544,2011-03-09,1,0,3,16,0,3,1,2,0.34,0.303,0.76,0.3284,10,102,112,112,True
1545,2011-03-09,1,0,3,17,0,3,1,2,0.34,0.303,0.76,0.2985,18,176,194,194,True
1546,2011-03-09,1,0,3,18,0,3,1,2,0.34,0.3182,0.76,0.2537,12,176,188,188,True
1547,2011-03-09,1,0,3,19,0,3,1,2,0.34,0.303,0.76,0.3284,11,123,134,134,True
1548,2011-03-09,1,0,3,20,0,3,1,2,0.32,0.3182,0.87,0.194,4,87,91,91,True
1549,2011-03-09,1,0,3,21,0,3,1,2,0.32,0.303,0.93,0.3284,10,52,62,62,True
1550,2011-03-09,1,0,3,22,0,3,1,3,0.32,0.3182,0.93,0.1642,4,17,21,21,True
1551,2011-03-09,1,0,3,23,0,3,1,3,0.34,0.3333,0.93,0.194,1,17,18,18,True
1552,2011-03-10,1,0,3,0,0,4,1,3,0.34,0.3182,0.029999999999999916,0.2537,3,0,3,3,True
1553,2011-03-10,1,0,3,1,0,4,1,3,0.34,0.3182,0.029999999999999916,0.2537,0,2,2,2,True
1554,2011-03-10,1,0,3,2,0,4,1,3,0.34,0.3182,0.029999999999999916,0.2537,0,1,1,1,True
1555,2011-03-10,1,0,3,5,0,4,1,3,0.36,0.3485,0.029999999999999916,0.194,1,2,3,3,True
1556,2011-03-10,1,0,3,6,0,4,1,3,0.36,0.3333,0.029999999999999916,0.3284,0,12,12,12,True
1557,2011-03-10,1,0,3,7,0,4,1,3,0.38,0.3939,0.029999999999999916,0.2239,1,36,37,37,True
1558,2011-03-10,1,0,3,8,0,4,1,3,0.38,0.3939,0.029999999999999916,0.2836,1,43,44,44,True
1559,2011-03-10,1,0,3,9,0,4,1,3,0.4,0.4091,0.029999999999999916,0.2239,1,23,24,24,True
1560,2011-03-10,1,0,3,10,0,4,1,3,0.4,0.4091,0.029999999999999916,0.1642,0,17,17,17,True
1561,2011-03-10,1,0,3,11,0,4,1,3,0.4,0.4091,0.029999999999999916,0.2537,6,5,11,11,True
1562,2011-03-10,1,0,3,12,0,4,1,3,0.42,0.4242,0.029999999999999916,0.2239,4,30,34,34,True
1563,2011-03-10,1,0,3,13,0,4,1,3,0.42,0.4242,0.029999999999999916,0.2239,1,11,12,12,True
1564,2011-03-10,1,0,3,14,0,4,1,3,0.44,0.4394,0.029999999999999916,0.2985,0,12,12,12,True
1565,2011-03-10,1,0,3,15,0,4,1,3,0.44,0.4394,0.029999999999999916,0.2239,3,11,14,14,True
1566,2011-03-10,1,0,3,16,0,4,1,3,0.42,0.4242,0.029999999999999916,0.2537,1,20,21,21,True
1567,2011-03-10,1,0,3,17,0,4,1,2,0.44,0.4394,0.029999999999999916,0.3881,2,109,111,111,True
1568,2011-03-10,1,0,3,18,0,4,1,3,0.44,0.4394,0.029999999999999916,0.3582,2,80,82,82,True
1569,2011-03-10,1,0,3,19,0,4,1,3,0.44,0.4394,0.029999999999999916,0.4775,5,51,56,56,True
1570,2011-03-10,1,0,3,20,0,4,1,3,0.36,0.3333,0.029999999999999916,0.3284,9,29,38,38,True
1571,2011-03-10,1,0,3,21,0,4,1,3,0.36,0.3485,0.029999999999999916,0.2239,1,27,28,28,True
1572,2011-03-10,1,0,3,22,0,4,1,2,0.34,0.3333,0.029999999999999916,0.1343,4,30,34,34,True
1573,2011-03-10,1,0,3,23,0,4,1,3,0.34,0.3485,0.029999999999999916,0.0896,1,26,27,27,True
1574,2011-03-11,1,0,3,0,0,5,1,2,0.34,0.3485,1.0,0.0896,0,6,6,6,True
1575,2011-03-11,1,0,3,1,0,5,1,3,0.34,0.3485,1.0,0.1045,0,8,8,8,True
1576,2011-03-11,1,0,3,2,0,5,1,3,0.34,0.3485,1.0,0.1045,2,3,5,5,True
1577,2011-03-11,1,0,3,3,0,5,1,2,0.32,0.3333,0.93,0.0896,0,2,2,2,True
1578,2011-03-11,1,0,3,5,0,5,1,1,0.3,0.2879,0.81,0.2239,1,6,7,7,True
1579,2011-03-11,1,0,3,6,0,5,1,1,0.26,0.2424,0.81,0.2836,1,31,32,32,True
1580,2011-03-11,1,0,3,7,0,5,1,1,0.26,0.2576,0.7,0.194,10,104,114,114,True
1581,2011-03-11,1,0,3,8,0,5,1,1,0.28,0.2727,0.7,0.2537,15,244,259,259,True
1582,2011-03-11,1,0,3,9,0,5,1,2,0.3,0.2879,0.61,0.2836,13,143,156,156,True
1583,2011-03-11,1,0,3,10,0,5,1,2,0.32,0.303,0.57,0.2985,18,60,78,78,True
1584,2011-03-11,1,0,3,11,0,5,1,2,0.32,0.303,0.57,0.2985,14,67,81,81,True
1585,2011-03-11,1,0,3,12,0,5,1,2,0.34,0.3182,0.53,0.2537,15,96,111,111,True
1586,2011-03-11,1,0,3,13,0,5,1,1,0.36,0.3333,0.53,0.2537,15,92,107,107,True
1587,2011-03-11,1,0,3,14,0,5,1,2,0.36,0.3333,0.5,0.3582,25,64,89,89,True
1588,2011-03-11,1,0,3,15,0,5,1,2,0.34,0.3182,0.53,0.2537,21,64,85,85,True
1589,2011-03-11,1,0,3,16,0,5,1,2,0.34,0.303,0.49,0.2985,18,95,113,113,True
1590,2011-03-11,1,0,3,17,0,5,1,1,0.34,0.3182,0.49,0.2239,23,200,223,223,True
1591,2011-03-11,1,0,3,18,0,5,1,1,0.32,0.303,0.49,0.3284,19,134,153,153,True
1592,2011-03-11,1,0,3,19,0,5,1,1,0.3,0.2727,0.56,0.3284,7,111,118,118,True
1593,2011-03-11,1,0,3,20,0,5,1,1,0.3,0.303,0.56,0.1642,6,70,76,76,True
1594,2011-03-11,1,0,3,21,0,5,1,2,0.3,0.2879,0.52,0.2537,10,43,53,53,True
1595,2011-03-11,1,0,3,22,0,5,1,1,0.3,0.303,0.52,0.1642,11,53,64,64,True
1596,2011-03-11,1,0,3,23,0,5,1,1,0.3,0.2879,0.52,0.2537,3,34,37,37,True
1597,2011-03-12,1,0,3,0,0,6,0,1,0.26,0.2727,0.6,0.1343,4,30,34,34,True
1598,2011-03-12,1,0,3,1,0,6,0,1,0.24,0.2273,0.65,0.194,3,15,18,18,True
1599,2011-03-12,1,0,3,2,0,6,0,1,0.24,0.2273,0.65,0.194,0,14,14,14,True
1600,2011-03-12,1,0,3,3,0,6,0,1,0.24,0.2273,0.65,0.2537,1,6,7,7,True
1601,2011-03-12,1,0,3,4,0,6,0,1,0.24,0.2273,0.65,0.2537,0,1,1,1,True
1602,2011-03-12,1,0,3,5,0,6,0,1,0.22,0.2273,0.69,0.194,0,2,2,2,True
1603,2011-03-12,1,0,3,6,0,6,0,1,0.22,0.2121,0.75,0.2537,2,2,4,4,True
1604,2011-03-12,1,0,3,7,0,6,0,1,0.24,0.2273,0.7,0.194,4,19,23,23,True
1605,2011-03-12,1,0,3,8,0,6,0,1,0.26,0.2576,0.65,0.1642,9,44,53,53,True
1606,2011-03-12,1,0,3,9,0,6,0,1,0.28,0.2879,0.65,0.1045,25,76,101,101,True
1607,2011-03-12,1,0,3,10,0,6,0,1,0.32,0.303,0.66,0.2239,21,78,99,99,True
1608,2011-03-12,1,0,3,11,0,6,0,1,0.34,0.303,0.49,0.3284,36,83,119,119,True
1609,2011-03-12,1,0,3,12,0,6,0,1,0.34,0.3182,0.53,0.2836,51,107,158,158,True
1610,2011-03-12,1,0,3,13,0,6,0,1,0.36,0.3333,0.51,0.3582,62,95,157,157,True
1611,2011-03-12,1,0,3,14,0,6,0,1,0.4,0.4091,0.5,0.4478,70,96,166,166,True
1612,2011-03-12,1,0,3,15,0,6,0,1,0.42,0.4242,0.44,0.4775,81,101,182,182,True
1613,2011-03-12,1,0,3,16,0,6,0,1,0.46,0.4545,0.41,0.4478,100,144,244,244,True
1614,2011-03-12,1,0,3,17,0,6,0,1,0.46,0.4545,0.44,0.3284,99,114,213,213,True
1615,2011-03-12,1,0,3,18,0,6,0,1,0.42,0.4242,0.54,0.1642,54,91,145,145,True
1616,2011-03-12,1,0,3,19,0,6,0,1,0.42,0.4242,0.54,0.0896,26,86,112,112,True
1617,2011-03-12,1,0,3,20,0,6,0,1,0.4,0.4091,0.58,0.1045,22,64,86,86,True
1618,2011-03-12,1,0,3,21,0,6,0,1,0.38,0.3939,0.62,0.0,36,46,82,82,True
1619,2011-03-12,1,0,3,22,0,6,0,1,0.36,0.3788,0.71,0.0,7,56,63,63,True
1620,2011-03-12,1,0,3,23,0,6,0,1,0.38,0.3939,0.66,0.0896,11,38,49,49,True
1621,2011-03-13,1,0,3,0,0,0,0,1,0.38,0.3939,0.62,0.1045,3,35,38,38,True
1622,2011-03-13,1,0,3,1,0,0,0,1,0.36,0.3485,0.66,0.1343,10,23,33,33,True
1623,2011-03-13,1,0,3,3,0,0,0,1,0.34,0.3333,0.76,0.1343,6,17,23,23,True
1624,2011-03-13,1,0,3,4,0,0,0,1,0.34,0.3333,0.66,0.1642,4,9,13,13,True
1625,2011-03-13,1,0,3,5,0,0,0,1,0.36,0.3485,0.62,0.1343,0,3,3,3,True
1626,2011-03-13,1,0,3,6,0,0,0,1,0.34,0.3636,0.66,0.0,0,2,2,2,True
1627,2011-03-13,1,0,3,7,0,0,0,1,0.36,0.3485,0.62,0.194,2,8,10,10,True
1628,2011-03-13,1,0,3,8,0,0,0,1,0.4,0.4091,0.5,0.2985,11,23,34,34,True
1629,2011-03-13,1,0,3,9,0,0,0,1,0.4,0.4091,0.5,0.4179,8,36,44,44,True
1630,2011-03-13,1,0,3,10,0,0,0,1,0.42,0.4242,0.47,0.2537,36,86,122,122,True
1631,2011-03-13,1,0,3,11,0,0,0,1,0.44,0.4394,0.41,0.4179,88,93,181,181,True
1632,2011-03-13,1,0,3,12,0,0,0,1,0.46,0.4545,0.38,0.3881,74,120,194,194,True
1633,2011-03-13,1,0,3,13,0,0,0,1,0.46,0.4545,0.38,0.3881,97,124,221,221,True
1634,2011-03-13,1,0,3,14,0,0,0,1,0.46,0.4545,0.41,0.2985,114,106,220,220,True
1635,2011-03-13,1,0,3,15,0,0,0,1,0.48,0.4697,0.39,0.3284,114,155,269,269,True
1636,2011-03-13,1,0,3,16,0,0,0,1,0.46,0.4545,0.41,0.3881,114,132,246,246,True
1637,2011-03-13,1,0,3,17,0,0,0,1,0.44,0.4394,0.41,0.3582,98,143,241,241,True
1638,2011-03-13,1,0,3,18,0,0,0,1,0.4,0.4091,0.43,0.3582,55,92,147,147,True
1639,2011-03-13,1,0,3,19,0,0,0,1,0.36,0.3333,0.5,0.3582,28,73,101,101,True
1640,2011-03-13,1,0,3,20,0,0,0,1,0.32,0.303,0.57,0.2985,23,54,77,77,True
1641,2011-03-13,1,0,3,21,0,0,0,1,0.3,0.2879,0.56,0.2537,9,49,58,58,True
1642,2011-03-13,1,0,3,22,0,0,0,1,0.3,0.2727,0.56,0.3284,8,29,37,37,True
1643,2011-03-13,1,0,3,23,0,0,0,1,0.26,0.2576,0.65,0.2239,5,23,28,28,True
1644,2011-03-14,1,0,3,0,0,1,1,1,0.26,0.2727,0.65,0.1045,4,7,11,11,True
1645,2011-03-14,1,0,3,1,0,1,1,1,0.26,0.2879,0.65,0.0896,0,1,1,1,True
1646,2011-03-14,1,0,3,2,0,1,1,1,0.26,0.2879,0.65,0.0896,0,1,1,1,True
1647,2011-03-14,1,0,3,3,0,1,1,1,0.26,0.2727,0.65,0.1343,0,3,3,3,True
1648,2011-03-14,1,0,3,5,0,1,1,1,0.24,0.2424,0.7,0.1343,0,8,8,8,True
1649,2011-03-14,1,0,3,6,0,1,1,1,0.26,0.2727,0.65,0.1343,1,27,28,28,True
1650,2011-03-14,1,0,3,7,0,1,1,2,0.28,0.3182,0.61,0.0,4,84,88,88,True
1651,2011-03-14,1,0,3,8,0,1,1,2,0.3,0.303,0.56,0.1343,24,217,241,241,True
1652,2011-03-14,1,0,3,9,0,1,1,1,0.32,0.303,0.53,0.3284,13,127,140,140,True
1653,2011-03-14,1,0,3,10,0,1,1,1,0.34,0.3182,0.42,0.2537,27,57,84,84,True
1654,2011-03-14,1,0,3,11,0,1,1,1,0.36,0.3333,0.4,0.2537,26,45,71,71,True
1655,2011-03-14,1,0,3,12,0,1,1,1,0.38,0.3939,0.37,0.0,40,54,94,94,True
1656,2011-03-14,1,0,3,13,0,1,1,1,0.38,0.3939,0.36,0.3284,24,51,75,75,True
1657,2011-03-14,1,0,3,14,0,1,1,2,0.38,0.3939,0.34,0.0,27,52,79,79,True
1658,2011-03-14,1,0,3,15,0,1,1,1,0.38,0.3939,0.37,0.1642,24,77,101,101,True
1659,2011-03-14,1,0,3,16,0,1,1,1,0.4,0.4091,0.35,0.1045,27,80,107,107,True
1660,2011-03-14,1,0,3,17,0,1,1,1,0.38,0.3939,0.4,0.194,42,229,271,271,True
1661,2011-03-14,1,0,3,18,0,1,1,1,0.36,0.3636,0.4,0.1045,25,210,235,235,True
1662,2011-03-14,1,0,3,19,0,1,1,1,0.36,0.3485,0.43,0.1343,17,133,150,150,True
1663,2011-03-14,1,0,3,20,0,1,1,1,0.34,0.3182,0.46,0.2239,23,106,129,129,True
1664,2011-03-14,1,0,3,21,0,1,1,1,0.34,0.3333,0.46,0.1343,5,58,63,63,True
1665,2011-03-14,1,0,3,22,0,1,1,1,0.32,0.3333,0.49,0.1045,4,43,47,47,True
1666,2011-03-14,1,0,3,23,0,1,1,1,0.32,0.3485,0.53,0.0,2,17,19,19,True
1667,2011-03-15,1,0,3,0,0,2,1,1,0.32,0.3485,0.53,0.0,7,7,14,14,True
1668,2011-03-15,1,0,3,1,0,2,1,1,0.3,0.303,0.62,0.0896,4,6,10,10,True
1669,2011-03-15,1,0,3,2,0,2,1,1,0.3,0.303,0.62,0.0896,1,2,3,3,True
1670,2011-03-15,1,0,3,4,0,2,1,1,0.24,0.2576,0.75,0.0896,1,1,2,2,True
1671,2011-03-15,1,0,3,5,0,2,1,1,0.24,0.2273,0.75,0.194,0,11,11,11,True
1672,2011-03-15,1,0,3,6,0,2,1,1,0.22,0.2273,0.8,0.194,3,32,35,35,True
1673,2011-03-15,1,0,3,7,0,2,1,1,0.24,0.2424,0.75,0.1642,10,109,119,119,True
1674,2011-03-15,1,0,3,8,0,2,1,1,0.26,0.2879,0.7,0.0896,23,259,282,282,True
1675,2011-03-15,1,0,3,9,0,2,1,2,0.3,0.3333,0.7,0.0,10,147,157,157,True
1676,2011-03-15,1,0,3,10,0,2,1,2,0.32,0.3182,0.66,0.194,22,56,78,78,True
1677,2011-03-15,1,0,3,11,0,2,1,2,0.34,0.3182,0.57,0.2239,27,51,78,78,True
1678,2011-03-15,1,0,3,12,0,2,1,2,0.36,0.3485,0.5,0.2239,32,70,102,102,True
1679,2011-03-15,1,0,3,13,0,2,1,2,0.36,0.3333,0.57,0.2836,23,74,97,97,True
1680,2011-03-15,1,0,3,14,0,2,1,2,0.38,0.3939,0.46,0.2985,14,74,88,88,True
1681,2011-03-15,1,0,3,15,0,2,1,2,0.38,0.3939,0.43,0.2836,24,66,90,90,True
1682,2011-03-15,1,0,3,16,0,2,1,2,0.38,0.3939,0.46,0.3284,21,93,114,114,True
1683,2011-03-15,1,0,3,17,0,2,1,2,0.36,0.3485,0.62,0.194,22,195,217,217,True
1684,2011-03-15,1,0,3,18,0,2,1,2,0.36,0.3333,0.62,0.2985,18,207,225,225,True
1685,2011-03-15,1,0,3,19,0,2,1,2,0.34,0.3182,0.71,0.2836,14,138,152,152,True
1686,2011-03-15,1,0,3,20,0,2,1,2,0.34,0.3182,0.71,0.2836,9,79,88,88,True
1687,2011-03-15,1,0,3,21,0,2,1,3,0.32,0.3333,0.81,0.1045,2,53,55,55,True
1688,2011-03-15,1,0,3,22,0,2,1,2,0.32,0.3182,0.87,0.1642,1,20,21,21,True
1689,2011-03-15,1,0,3,23,0,2,1,2,0.32,0.3182,0.87,0.1642,1,17,18,18,True
1690,2011-03-16,1,0,3,0,0,3,1,3,0.3,0.2879,0.93,0.2537,0,8,8,8,True
1691,2011-03-16,1,0,3,1,0,3,1,3,0.3,0.2727,1.0,0.2985,1,2,3,3,True
1692,2011-03-16,1,0,3,3,0,3,1,2,0.28,0.2727,1.0,0.2239,1,2,3,3,True
1693,2011-03-16,1,0,3,4,0,3,1,2,0.3,0.303,0.93,0.1642,0,1,1,1,True
1694,2011-03-16,1,0,3,5,0,3,1,2,0.3,0.3182,0.93,0.1045,0,3,3,3,True
1695,2011-03-16,1,0,3,6,0,3,1,2,0.3,0.3182,0.93,0.1045,1,30,31,31,True
1696,2011-03-16,1,0,3,7,0,3,1,2,0.3,0.2879,0.93,0.194,10,101,111,111,True
1697,2011-03-16,1,0,3,8,0,3,1,2,0.32,0.3182,0.93,0.0,26,227,253,253,True
1698,2011-03-16,1,0,3,9,0,3,1,2,0.32,0.3333,0.93,0.1343,10,144,154,154,True
1699,2011-03-16,1,0,3,10,0,3,1,2,0.36,0.3485,0.81,0.1642,19,49,68,68,True
1700,2011-03-16,1,0,3,11,0,3,1,2,0.36,0.3485,0.81,0.1343,13,62,75,75,True
1701,2011-03-16,1,0,3,12,0,3,1,2,0.4,0.4091,0.71,0.1045,23,65,88,88,True
1702,2011-03-16,1,0,3,13,0,3,1,2,0.4,0.4091,0.76,0.1343,18,81,99,99,True
1703,2011-03-16,1,0,3,14,0,3,1,2,0.4,0.4091,0.76,0.2239,33,67,100,100,True
1704,2011-03-16,1,0,3,15,0,3,1,2,0.4,0.4091,0.76,0.2537,22,79,101,101,True
1705,2011-03-16,1,0,3,16,0,3,1,2,0.4,0.4091,0.76,0.1642,30,121,151,151,True
1706,2011-03-16,1,0,3,17,0,3,1,2,0.44,0.4394,0.54,0.2985,37,216,253,253,True
1707,2011-03-16,1,0,3,18,0,3,1,2,0.44,0.4394,0.54,0.2239,26,211,237,237,True
1708,2011-03-16,1,0,3,19,0,3,1,2,0.44,0.4394,0.51,0.3284,18,150,168,168,True
1709,2011-03-16,1,0,3,20,0,3,1,2,0.42,0.4242,0.54,0.2985,10,111,121,121,True
1710,2011-03-16,1,0,3,21,0,3,1,2,0.42,0.4242,0.58,0.2836,3,75,78,78,True
1711,2011-03-16,1,0,3,22,0,3,1,2,0.4,0.4091,0.62,0.3881,11,48,59,59,True
1712,2011-03-16,1,0,3,23,0,3,1,1,0.4,0.4091,0.65,0.194,9,18,27,27,True
1713,2011-03-17,1,0,3,0,0,4,1,1,0.38,0.3939,0.66,0.2537,4,19,23,23,True
1714,2011-03-17,1,0,3,1,0,4,1,1,0.36,0.3485,0.71,0.2239,1,11,12,12,True
1715,2011-03-17,1,0,3,2,0,4,1,1,0.34,0.303,0.71,0.2985,3,5,8,8,True
1716,2011-03-17,1,0,3,3,0,4,1,1,0.34,0.3333,0.66,0.1642,1,1,2,2,True
1717,2011-03-17,1,0,3,4,0,4,1,1,0.34,0.3333,0.71,0.194,0,3,3,3,True
1718,2011-03-17,1,0,3,5,0,4,1,1,0.32,0.3333,0.76,0.1045,0,13,13,13,True
1719,2011-03-17,1,0,3,6,0,4,1,1,0.32,0.3182,0.76,0.194,4,47,51,51,True
1720,2011-03-17,1,0,3,7,0,4,1,1,0.32,0.3333,0.76,0.1343,12,128,140,140,True
1721,2011-03-17,1,0,3,8,0,4,1,1,0.36,0.3485,0.66,0.1343,17,282,299,299,True
1722,2011-03-17,1,0,3,9,0,4,1,1,0.4,0.4091,0.62,0.2537,23,162,185,185,True
1723,2011-03-17,1,0,3,10,0,4,1,1,0.44,0.4394,0.54,0.3284,9,69,78,78,True
1724,2011-03-17,1,0,3,11,0,4,1,1,0.44,0.4394,0.54,0.2836,20,66,86,86,True
1725,2011-03-17,1,0,3,12,0,4,1,1,0.5,0.4848,0.45,0.2239,24,81,105,105,True
1726,2011-03-17,1,0,3,13,0,4,1,2,0.52,0.5,0.42,0.0896,26,85,111,111,True
1727,2011-03-17,1,0,3,14,0,4,1,1,0.5,0.4848,0.45,0.1045,32,87,119,119,True
1728,2011-03-17,1,0,3,15,0,4,1,1,0.52,0.5,0.42,0.2537,30,95,125,125,True
1729,2011-03-17,1,0,3,16,0,4,1,1,0.5,0.4848,0.48,0.2836,34,108,142,142,True
1730,2011-03-17,1,0,3,17,0,4,1,1,0.5,0.4848,0.42,0.194,48,265,313,313,True
1731,2011-03-17,1,0,3,18,0,4,1,2,0.46,0.4545,0.59,0.1642,50,260,310,310,True
1732,2011-03-17,1,0,3,19,0,4,1,1,0.44,0.4394,0.58,0.194,18,189,207,207,True
1733,2011-03-17,1,0,3,20,0,4,1,1,0.42,0.4242,0.67,0.2239,25,112,137,137,True
1734,2011-03-17,1,0,3,21,0,4,1,1,0.42,0.4242,0.62,0.2239,19,119,138,138,True
1735,2011-03-17,1,0,3,22,0,4,1,1,0.4,0.4091,0.66,0.2239,17,70,87,87,True
1736,2011-03-17,1,0,3,23,0,4,1,1,0.42,0.4242,0.62,0.2836,7,43,50,50,True
1737,2011-03-18,1,0,3,0,0,5,1,1,0.42,0.4242,0.58,0.2836,5,24,29,29,True
1738,2011-03-18,1,0,3,1,0,5,1,1,0.4,0.4091,0.62,0.2537,4,12,16,16,True
1739,2011-03-18,1,0,3,2,0,5,1,1,0.4,0.4091,0.62,0.194,5,9,14,14,True
1740,2011-03-18,1,0,3,3,0,5,1,1,0.36,0.3485,0.71,0.194,1,4,5,5,True
1741,2011-03-18,1,0,3,5,0,5,1,1,0.38,0.3939,0.66,0.1642,2,8,10,10,True
1742,2011-03-18,1,0,3,6,0,5,1,1,0.4,0.4091,0.66,0.194,1,35,36,36,True
1743,2011-03-18,1,0,3,7,0,5,1,1,0.4,0.4091,0.66,0.194,11,112,123,123,True
1744,2011-03-18,1,0,3,8,0,5,1,1,0.42,0.4242,0.67,0.2537,24,256,280,280,True
1745,2011-03-18,1,0,3,9,0,5,1,1,0.46,0.4545,0.63,0.2239,18,192,210,210,True
1746,2011-03-18,1,0,3,10,0,5,1,1,0.52,0.5,0.53,0.2836,43,74,117,117,True
1747,2011-03-18,1,0,3,11,0,5,1,1,0.54,0.5152,0.52,0.2836,55,104,159,159,True
1748,2011-03-18,1,0,3,12,0,5,1,2,0.56,0.5303,0.49,0.3582,72,123,195,195,True
1749,2011-03-18,1,0,3,13,0,5,1,1,0.64,0.6212,0.41,0.2836,57,118,175,175,True
1750,2011-03-18,1,0,3,14,0,5,1,1,0.66,0.6212,0.39,0.2537,71,103,174,174,True
1751,2011-03-18,1,0,3,15,0,5,1,2,0.68,0.6364,0.39,0.3582,62,111,173,173,True
1752,2011-03-18,1,0,3,16,0,5,1,1,0.68,0.6364,0.39,0.2836,67,137,204,204,True
1753,2011-03-18,1,0,3,17,0,5,1,1,0.7,0.6364,0.37,0.3284,95,237,332,332,True
1754,2011-03-18,1,0,3,18,0,5,1,1,0.68,0.6364,0.39,0.1642,84,247,331,331,True
1755,2011-03-18,1,0,3,19,0,5,1,1,0.66,0.6212,0.44,0.1343,58,132,190,190,True
1756,2011-03-18,1,0,3,20,0,5,1,1,0.62,0.6212,0.46,0.1343,46,103,149,149,True
1757,2011-03-18,1,0,3,21,0,5,1,1,0.62,0.6212,0.46,0.1045,22,91,113,113,True
1758,2011-03-18,1,0,3,22,0,5,1,1,0.62,0.6212,0.5,0.1642,55,63,118,118,True
1759,2011-03-18,1,0,3,23,0,5,1,2,0.6,0.6212,0.53,0.2239,26,60,86,86,True
1760,2011-03-19,1,0,3,0,0,6,0,2,0.6,0.6212,0.53,0.2537,26,50,76,76,True
1761,2011-03-19,1,0,3,1,0,6,0,2,0.58,0.5455,0.46,0.3582,16,35,51,51,True
1762,2011-03-19,1,0,3,2,0,6,0,2,0.56,0.5303,0.43,0.2239,5,20,25,25,True
1763,2011-03-19,1,0,3,3,0,6,0,2,0.54,0.5152,0.39,0.3284,1,7,8,8,True
1764,2011-03-19,1,0,3,4,0,6,0,1,0.52,0.5,0.34,0.4179,1,2,3,3,True
1765,2011-03-19,1,0,3,5,0,6,0,1,0.52,0.5,0.34,0.4179,0,2,2,2,True
1766,2011-03-19,1,0,3,6,0,6,0,1,0.44,0.4394,0.44,0.4179,0,10,10,10,True
1767,2011-03-19,1,0,3,7,0,6,0,1,0.4,0.4091,0.5,0.3284,4,9,13,13,True
1768,2011-03-19,1,0,3,8,0,6,0,1,0.42,0.4242,0.47,0.4775,11,37,48,48,True
1769,2011-03-19,1,0,3,9,0,6,0,1,0.42,0.4242,0.44,0.4627,35,41,76,76,True
1770,2011-03-19,1,0,3,10,0,6,0,1,0.44,0.4394,0.38,0.4179,55,85,140,140,True
1771,2011-03-19,1,0,3,11,0,6,0,1,0.46,0.4545,0.36,0.4478,90,106,196,196,True
1772,2011-03-19,1,0,3,12,0,6,0,1,0.46,0.4545,0.33,0.4179,114,141,255,255,True
1773,2011-03-19,1,0,3,13,0,6,0,1,0.5,0.4848,0.34,0.4627,114,127,241,241,True
1774,2011-03-19,1,0,3,14,0,6,0,1,0.5,0.4848,0.31,0.4775,114,144,258,258,True
1775,2011-03-19,1,0,3,15,0,6,0,1,0.5,0.4848,0.29,0.4179,114,143,257,257,True
1776,2011-03-19,1,0,3,16,0,6,0,1,0.5,0.4848,0.31,0.3881,114,129,243,243,True
1777,2011-03-19,1,0,3,17,0,6,0,1,0.48,0.4697,0.31,0.3284,114,140,254,254,True
1778,2011-03-19,1,0,3,18,0,6,0,1,0.46,0.4545,0.31,0.3284,92,125,217,217,True
1779,2011-03-19,1,0,3,19,0,6,0,1,0.44,0.4394,0.33,0.2836,38,116,154,154,True
1780,2011-03-19,1,0,3,20,0,6,0,1,0.42,0.4242,0.35,0.2239,39,69,108,108,True
1781,2011-03-19,1,0,3,21,0,6,0,1,0.4,0.4091,0.37,0.2985,20,73,93,93,True
1782,2011-03-19,1,0,3,22,0,6,0,1,0.4,0.4091,0.37,0.3284,27,45,72,72,True
1783,2011-03-19,1,0,3,23,0,6,0,1,0.38,0.3939,0.4,0.2985,13,37,50,50,True
1784,2011-03-20,1,0,3,0,0,0,0,1,0.34,0.303,0.49,0.4179,7,33,40,40,True
1785,2011-03-20,1,0,3,1,0,0,0,1,0.32,0.2879,0.53,0.3582,2,22,24,24,True
1786,2011-03-20,1,0,3,2,0,0,0,1,0.3,0.2879,0.52,0.2836,6,24,30,30,True
1787,2011-03-20,1,0,3,3,0,0,0,1,0.28,0.2727,0.56,0.2537,1,11,12,12,True
1788,2011-03-20,1,0,3,4,0,0,0,1,0.26,0.2576,0.56,0.2239,2,1,3,3,True
1789,2011-03-20,1,0,3,5,0,0,0,1,0.26,0.2576,0.6,0.194,3,6,9,9,True
1790,2011-03-20,1,0,3,6,0,0,0,1,0.26,0.2576,0.6,0.2239,1,3,4,4,True
1791,2011-03-20,1,0,3,7,0,0,0,1,0.24,0.2273,0.6,0.2239,5,9,14,14,True
1792,2011-03-20,1,0,3,8,0,0,0,1,0.28,0.2727,0.56,0.1642,7,30,37,37,True
1793,2011-03-20,1,0,3,9,0,0,0,1,0.3,0.303,0.52,0.1343,35,43,78,78,True
1794,2011-03-20,1,0,3,10,0,0,0,2,0.32,0.3485,0.45,0.0,55,81,136,136,True
1795,2011-03-20,1,0,3,11,0,0,0,1,0.34,0.3485,0.39,0.1045,92,111,203,203,True
1796,2011-03-20,1,0,3,12,0,0,0,1,0.36,0.3636,0.4,0.1045,114,108,222,222,True
1797,2011-03-20,1,0,3,13,0,0,0,1,0.38,0.3939,0.34,0.0,88,115,203,203,True
1798,2011-03-20,1,0,3,14,0,0,0,1,0.4,0.4091,0.3,0.0,114,134,248,248,True
1799,2011-03-20,1,0,3,15,0,0,0,1,0.4,0.4091,0.32,0.0896,114,136,250,250,True
1800,2011-03-20,1,0,3,16,0,0,0,1,0.42,0.4242,0.32,0.0,92,132,224,224,True
1801,2011-03-20,1,0,3,17,0,0,0,1,0.4,0.4091,0.35,0.2836,83,143,226,226,True
1802,2011-03-20,1,0,3,18,0,0,0,1,0.38,0.3939,0.4,0.3582,58,98,156,156,True
1803,2011-03-20,1,0,3,19,0,0,0,1,0.36,0.3333,0.43,0.2836,21,58,79,79,True
1804,2011-03-20,1,0,3,20,0,0,0,1,0.36,0.3333,0.46,0.2836,21,46,67,67,True
1805,2011-03-20,1,0,3,21,0,0,0,2,0.34,0.3182,0.53,0.2836,10,39,49,49,True
1806,2011-03-20,1,0,3,22,0,0,0,2,0.34,0.303,0.53,0.3284,8,30,38,38,True
1807,2011-03-20,1,0,3,23,0,0,0,3,0.34,0.303,0.61,0.3881,13,11,24,24,True
1808,2011-03-21,2,0,3,0,0,1,1,3,0.34,0.303,0.66,0.3881,2,11,13,13,True
1809,2011-03-21,2,0,3,1,0,1,1,2,0.34,0.303,0.71,0.3881,1,6,7,7,True
1810,2011-03-21,2,0,3,2,0,1,1,2,0.34,0.303,0.71,0.3284,1,5,6,6,True
1811,2011-03-21,2,0,3,3,0,1,1,2,0.34,0.303,0.71,0.3284,0,1,1,1,True
1812,2011-03-21,2,0,3,5,0,1,1,1,0.32,0.303,0.81,0.2985,1,1,2,2,True
1813,2011-03-21,2,0,3,6,0,1,1,3,0.32,0.303,0.76,0.2537,2,30,32,32,True
1814,2011-03-21,2,0,3,7,0,1,1,3,0.3,0.2727,0.87,0.4179,3,15,18,18,True
1815,2011-03-21,2,0,3,8,0,1,1,2,0.3,0.2727,0.87,0.4179,3,95,98,98,True
1816,2011-03-21,2,0,3,9,0,1,1,2,0.34,0.303,0.81,0.3284,12,115,127,127,True
1817,2011-03-21,2,0,3,10,0,1,1,2,0.38,0.3939,0.76,0.3881,17,45,62,62,True
1818,2011-03-21,2,0,3,11,0,1,1,2,0.42,0.4242,0.71,0.2985,32,47,79,79,True
1819,2011-03-21,2,0,3,12,0,1,1,2,0.44,0.4394,0.77,0.2537,25,56,81,81,True
1820,2011-03-21,2,0,3,13,0,1,1,2,0.5,0.4848,0.63,0.2239,35,77,112,112,True
1821,2011-03-21,2,0,3,14,0,1,1,2,0.54,0.5152,0.64,0.2239,36,65,101,101,True
1822,2011-03-21,2,0,3,15,0,1,1,2,0.56,0.5303,0.6,0.2239,41,66,107,107,True
1823,2011-03-21,2,0,3,16,0,1,1,2,0.54,0.5152,0.64,0.2836,29,112,141,141,True
1824,2011-03-21,2,0,3,17,0,1,1,2,0.54,0.5152,0.64,0.2537,41,231,272,272,True
1825,2011-03-21,2,0,3,18,0,1,1,2,0.52,0.5,0.72,0.2239,44,232,276,276,True
1826,2011-03-21,2,0,3,19,0,1,1,1,0.58,0.5455,0.6,0.4179,22,199,221,221,True
1827,2011-03-21,2,0,3,20,0,1,1,1,0.56,0.5303,0.64,0.194,16,106,122,122,True
1828,2011-03-21,2,0,3,21,0,1,1,1,0.46,0.4545,0.94,0.194,12,79,91,91,True
1829,2011-03-21,2,0,3,22,0,1,1,1,0.46,0.4545,0.88,0.2239,18,60,78,78,True
1830,2011-03-21,2,0,3,23,0,1,1,1,0.46,0.4545,0.88,0.0896,8,22,30,30,True
1831,2011-03-22,2,0,3,0,0,2,1,1,0.46,0.4545,0.88,0.194,4,7,11,11,True
1832,2011-03-22,2,0,3,1,0,2,1,1,0.42,0.4242,1.0,0.1343,6,13,19,19,True
1833,2011-03-22,2,0,3,2,0,2,1,1,0.44,0.4394,0.94,0.0896,0,1,1,1,True
1834,2011-03-22,2,0,3,3,0,2,1,1,0.44,0.4394,0.82,0.2239,3,2,5,5,True
1835,2011-03-22,2,0,3,4,0,2,1,2,0.42,0.4242,0.82,0.1642,0,1,1,1,True
1836,2011-03-22,2,0,3,5,0,2,1,2,0.4,0.4091,0.87,0.1343,1,11,12,12,True
1837,2011-03-22,2,0,3,6,0,2,1,1,0.4,0.4091,0.87,0.2537,2,58,60,60,True
1838,2011-03-22,2,0,3,7,0,2,1,2,0.4,0.4091,0.76,0.1045,4,132,136,136,True
1839,2011-03-22,2,0,3,8,0,2,1,2,0.4,0.4091,0.58,0.2985,24,312,336,336,True
1840,2011-03-22,2,0,3,9,0,2,1,2,0.4,0.4091,0.58,0.4627,19,159,178,178,True
1841,2011-03-22,2,0,3,10,0,2,1,2,0.44,0.4394,0.54,0.2985,29,95,124,124,True
1842,2011-03-22,2,0,3,11,0,2,1,1,0.44,0.4394,0.51,0.3284,22,64,86,86,True
1843,2011-03-22,2,0,3,12,0,2,1,1,0.46,0.4545,0.47,0.2537,35,86,121,121,True
1844,2011-03-22,2,0,3,13,0,2,1,1,0.5,0.4848,0.45,0.2239,21,85,106,106,True
1845,2011-03-22,2,0,3,14,0,2,1,1,0.5,0.4848,0.42,0.3284,30,71,101,101,True
1846,2011-03-22,2,0,3,15,0,2,1,1,0.5,0.4848,0.42,0.2239,55,79,134,134,True
1847,2011-03-22,2,0,3,16,0,2,1,1,0.5,0.4848,0.42,0.1045,40,125,165,165,True
1848,2011-03-22,2,0,3,17,0,2,1,1,0.5,0.4848,0.42,0.1045,42,265,307,307,True
1849,2011-03-22,2,0,3,18,0,2,1,1,0.48,0.4697,0.44,0.0896,41,271,312,312,True
1850,2011-03-22,2,0,3,19,0,2,1,2,0.44,0.4394,0.54,0.2537,22,142,164,164,True
1851,2011-03-22,2,0,3,20,0,2,1,2,0.44,0.4394,0.54,0.3582,19,116,135,135,True
1852,2011-03-22,2,0,3,21,0,2,1,2,0.42,0.4242,0.54,0.2836,24,63,87,87,True
1853,2011-03-22,2,0,3,22,0,2,1,2,0.4,0.4091,0.58,0.2537,13,57,70,70,True
1854,2011-03-22,2,0,3,23,0,2,1,2,0.4,0.4091,0.58,0.2537,4,28,32,32,True
1855,2011-03-23,2,0,3,0,0,3,1,3,0.36,0.3485,0.71,0.2239,3,8,11,11,True
1856,2011-03-23,2,0,3,1,0,3,1,3,0.34,0.3182,0.76,0.2239,0,7,7,7,True
1857,2011-03-23,2,0,3,2,0,3,1,3,0.34,0.3182,0.76,0.2239,1,1,2,2,True
1858,2011-03-23,2,0,3,3,0,3,1,2,0.34,0.3182,0.76,0.2537,0,3,3,3,True
1859,2011-03-23,2,0,3,5,0,3,1,3,0.32,0.3182,0.87,0.194,0,10,10,10,True
1860,2011-03-23,2,0,3,6,0,3,1,2,0.34,0.3182,0.87,0.2537,1,43,44,44,True
1861,2011-03-23,2,0,3,7,0,3,1,2,0.32,0.303,0.93,0.2239,7,111,118,118,True
1862,2011-03-23,2,0,3,8,0,3,1,2,0.32,0.3182,0.87,0.194,14,247,261,261,True
1863,2011-03-23,2,0,3,9,0,3,1,2,0.32,0.303,0.81,0.2537,8,174,182,182,True
1864,2011-03-23,2,0,3,10,0,3,1,2,0.34,0.3182,0.81,0.2836,15,60,75,75,True
1865,2011-03-23,2,0,3,11,0,3,1,2,0.34,0.3333,0.87,0.194,18,53,71,71,True
1866,2011-03-23,2,0,3,12,0,3,1,2,0.34,0.3182,0.87,0.2239,14,73,87,87,True
1867,2011-03-23,2,0,3,13,0,3,1,3,0.34,0.3333,0.87,0.1343,14,94,108,108,True
1868,2011-03-23,2,0,3,14,0,3,1,2,0.36,0.3636,0.87,0.1045,13,71,84,84,True
1869,2011-03-23,2,0,3,15,0,3,1,2,0.38,0.3939,0.82,0.2239,11,74,85,85,True
1870,2011-03-23,2,0,3,16,0,3,1,2,0.4,0.4091,0.76,0.2239,13,123,136,136,True
1871,2011-03-23,2,0,3,17,0,3,1,2,0.4,0.4091,0.76,0.2239,28,245,273,273,True
1872,2011-03-23,2,0,3,18,0,3,1,3,0.38,0.3939,0.82,0.2537,20,218,238,238,True
1873,2011-03-23,2,0,3,19,0,3,1,3,0.38,0.3939,0.82,0.2537,12,147,159,159,True
1874,2011-03-23,2,0,3,20,0,3,1,3,0.36,0.303,0.87,0.4775,3,72,75,75,True
1875,2011-03-23,2,0,3,21,0,3,1,3,0.32,0.2879,1.0,0.4179,0,22,22,22,True
1876,2011-03-23,2,0,3,22,0,3,1,2,0.32,0.3182,0.93,0.1642,6,38,44,44,True
1877,2011-03-23,2,0,3,23,0,3,1,3,0.32,0.3333,0.9,0.0,2,24,26,26,True
1878,2011-03-24,2,0,3,0,0,4,1,2,0.32,0.303,0.93,0.2239,0,11,11,11,True
1879,2011-03-24,2,0,3,1,0,4,1,2,0.3,0.2879,1.0,0.2239,0,3,3,3,True
1880,2011-03-24,2,0,3,2,0,4,1,2,0.3,0.2879,1.0,0.2537,0,6,6,6,True
1881,2011-03-24,2,0,3,3,0,4,1,2,0.28,0.2727,1.0,0.194,1,0,1,1,True
1882,2011-03-24,2,0,3,4,0,4,1,2,0.28,0.2727,1.0,0.194,0,1,1,1,True
1883,2011-03-24,2,0,3,5,0,4,1,2,0.28,0.2727,0.93,0.2239,1,8,9,9,True
1884,2011-03-24,2,0,3,6,0,4,1,2,0.28,0.2727,0.93,0.2239,0,41,41,41,True
1885,2011-03-24,2,0,3,7,0,4,1,3,0.26,0.2576,1.0,0.2239,2,106,108,108,True
1886,2011-03-24,2,0,3,8,0,4,1,3,0.26,0.2273,1.0,0.2985,4,120,124,124,True
1887,2011-03-24,2,0,3,9,0,4,1,2,0.26,0.2576,0.93,0.2239,3,94,97,97,True
1888,2011-03-24,2,0,3,10,0,4,1,2,0.26,0.2273,0.93,0.3284,10,55,65,65,True
1889,2011-03-24,2,0,3,11,0,4,1,2,0.3,0.2727,0.81,0.2985,10,61,71,71,True
1890,2011-03-24,2,0,3,12,0,4,1,2,0.3,0.2727,0.7,0.3284,12,82,94,94,True
1891,2011-03-24,2,0,3,13,0,4,1,2,0.32,0.303,0.7,0.2239,11,90,101,101,True
1892,2011-03-24,2,0,3,14,0,4,1,2,0.3,0.303,0.7,0.1343,17,66,83,83,True
1893,2011-03-24,2,0,3,15,0,4,1,2,0.3,0.2879,0.7,0.2537,13,77,90,90,True
1894,2011-03-24,2,0,3,16,0,4,1,2,0.3,0.2879,0.65,0.2239,6,78,84,84,True
1895,2011-03-24,2,0,3,17,0,4,1,2,0.3,0.2879,0.7,0.2239,12,221,233,233,True
1896,2011-03-24,2,0,3,18,0,4,1,2,0.3,0.2727,0.61,0.2985,17,197,214,214,True
1897,2011-03-24,2,0,3,19,0,4,1,1,0.3,0.2727,0.56,0.3881,16,122,138,138,True
1898,2011-03-24,2,0,3,20,0,4,1,1,0.28,0.2576,0.61,0.2836,8,110,118,118,True
1899,2011-03-24,2,0,3,21,0,4,1,1,0.26,0.2576,0.65,0.2239,11,67,78,78,True
1900,2011-03-24,2,0,3,22,0,4,1,1,0.26,0.2576,0.65,0.1642,3,59,62,62,True
1901,2011-03-24,2,0,3,23,0,4,1,1,0.24,0.2273,0.65,0.194,9,24,33,33,True
1902,2011-03-25,2,0,3,0,0,5,1,1,0.24,0.2273,0.6,0.194,1,17,18,18,True
1903,2011-03-25,2,0,3,1,0,5,1,1,0.2,0.2121,0.69,0.1642,0,5,5,5,True
1904,2011-03-25,2,0,3,2,0,5,1,1,0.2,0.197,0.69,0.2239,0,5,5,5,True
1905,2011-03-25,2,0,3,3,0,5,1,1,0.2,0.2273,0.69,0.1045,0,2,2,2,True
1906,2011-03-25,2,0,3,4,0,5,1,1,0.18,0.2121,0.74,0.1045,3,2,5,5,True
1907,2011-03-25,2,0,3,5,0,5,1,1,0.18,0.197,0.74,0.1642,0,9,9,9,True
1908,2011-03-25,2,0,3,6,0,5,1,1,0.18,0.1818,0.74,0.2239,0,32,32,32,True
1909,2011-03-25,2,0,3,7,0,5,1,1,0.2,0.1818,0.59,0.3582,4,100,104,104,True
1910,2011-03-25,2,0,3,8,0,5,1,1,0.22,0.2121,0.51,0.2836,9,228,237,237,True
1911,2011-03-25,2,0,3,9,0,5,1,1,0.24,0.2121,0.48,0.2985,16,150,166,166,True
1912,2011-03-25,2,0,3,10,0,5,1,1,0.26,0.2576,0.48,0.0,15,53,68,68,True
1913,2011-03-25,2,0,3,11,0,5,1,1,0.3,0.2879,0.45,0.2836,17,58,75,75,True
1914,2011-03-25,2,0,3,12,0,5,1,1,0.32,0.303,0.42,0.2537,37,108,145,145,True
1915,2011-03-25,2,0,3,13,0,5,1,1,0.32,0.3182,0.39,0.194,34,104,138,138,True
1916,2011-03-25,2,0,3,14,0,5,1,1,0.36,0.3333,0.32,0.3284,30,103,133,133,True
1917,2011-03-25,2,0,3,15,0,5,1,2,0.34,0.3182,0.36,0.2537,43,79,122,122,True
1918,2011-03-25,2,0,3,16,0,5,1,2,0.34,0.303,0.34,0.2985,23,127,150,150,True
1919,2011-03-25,2,0,3,17,0,5,1,2,0.32,0.2879,0.36,0.3582,23,202,225,225,True
1920,2011-03-25,2,0,3,18,0,5,1,1,0.3,0.2879,0.39,0.2537,8,190,198,198,True
1921,2011-03-25,2,0,3,19,0,5,1,2,0.3,0.2879,0.36,0.2836,9,126,135,135,True
1922,2011-03-25,2,0,3,20,0,5,1,2,0.3,0.303,0.39,0.1343,6,75,81,81,True
1923,2011-03-25,2,0,3,21,0,5,1,2,0.3,0.303,0.39,0.1642,11,64,75,75,True
1924,2011-03-25,2,0,3,22,0,5,1,2,0.28,0.2576,0.38,0.3284,3,40,43,43,True
1925,2011-03-25,2,0,3,23,0,5,1,2,0.26,0.2424,0.38,0.2836,8,31,39,39,True
1926,2011-03-26,2,0,3,0,0,6,0,2,0.26,0.2424,0.38,0.2836,3,25,28,28,True
1927,2011-03-26,2,0,3,1,0,6,0,1,0.26,0.2273,0.38,0.2985,3,24,27,27,True
1928,2011-03-26,2,0,3,2,0,6,0,1,0.22,0.2121,0.44,0.2239,4,21,25,25,True
1929,2011-03-26,2,0,3,3,0,6,0,1,0.2,0.197,0.47,0.194,2,7,9,9,True
1930,2011-03-26,2,0,3,4,0,6,0,1,0.22,0.2121,0.44,0.2239,2,4,6,6,True
1931,2011-03-26,2,0,3,5,0,6,0,1,0.2,0.197,0.51,0.194,0,8,8,8,True
1932,2011-03-26,2,0,3,6,0,6,0,1,0.18,0.1818,0.55,0.194,2,8,10,10,True
1933,2011-03-26,2,0,3,7,0,6,0,1,0.2,0.197,0.51,0.194,18,23,41,41,True
1934,2011-03-26,2,0,3,8,0,6,0,1,0.22,0.2273,0.44,0.1343,24,42,66,66,True
1935,2011-03-26,2,0,3,9,0,6,0,1,0.24,0.2424,0.41,0.1343,32,68,100,100,True
1936,2011-03-26,2,0,3,10,0,6,0,1,0.26,0.2576,0.41,0.1642,32,93,125,125,True
1937,2011-03-26,2,0,3,11,0,6,0,1,0.28,0.2727,0.38,0.1642,75,93,168,168,True
1938,2011-03-26,2,0,3,12,0,6,0,1,0.3,0.2879,0.36,0.194,98,129,227,227,True
1939,2011-03-26,2,0,3,13,0,6,0,1,0.32,0.303,0.33,0.2239,94,145,239,239,True
1940,2011-03-26,2,0,3,14,0,6,0,1,0.34,0.3182,0.29,0.2239,93,123,216,216,True
1941,2011-03-26,2,0,3,15,0,6,0,1,0.34,0.3333,0.29,0.194,110,109,219,219,True
1942,2011-03-26,2,0,3,16,0,6,0,1,0.34,0.3333,0.23,0.194,114,130,244,244,True
1943,2011-03-26,2,0,3,17,0,6,0,1,0.32,0.303,0.24,0.2239,102,101,203,203,True
1944,2011-03-26,2,0,3,18,0,6,0,2,0.32,0.3182,0.21,0.1642,64,89,153,153,True
1945,2011-03-26,2,0,3,19,0,6,0,2,0.28,0.2727,0.45,0.2537,45,93,138,138,True
1946,2011-03-26,2,0,3,20,0,6,0,2,0.28,0.2727,0.45,0.2537,18,67,85,85,True
1947,2011-03-26,2,0,3,21,0,6,0,2,0.26,0.2576,0.44,0.194,15,36,51,51,True
1948,2011-03-26,2,0,3,22,0,6,0,2,0.28,0.2727,0.41,0.2239,17,46,63,63,True
1949,2011-03-26,2,0,3,23,0,6,0,2,0.26,0.2424,0.44,0.2836,10,31,41,41,True
1950,2011-03-27,2,0,3,0,0,0,0,2,0.26,0.2576,0.41,0.1642,5,26,31,31,True
1951,2011-03-27,2,0,3,1,0,0,0,2,0.24,0.2273,0.52,0.194,3,17,20,20,True
1952,2011-03-27,2,0,3,2,0,0,0,3,0.22,0.2273,0.55,0.194,6,15,21,21,True
1953,2011-03-27,2,0,3,3,0,0,0,3,0.2,0.197,0.69,0.2239,0,14,14,14,True
1954,2011-03-27,2,0,3,4,0,0,0,3,0.18,0.197,0.74,0.1642,1,5,6,6,True
1955,2011-03-27,2,0,3,6,0,0,0,3,0.16,0.1818,0.86,0.1343,0,2,2,2,True
1956,2011-03-27,2,0,3,7,0,0,0,3,0.16,0.1667,0.86,0.1642,0,7,7,7,True
1957,2011-03-27,2,0,3,8,0,0,0,1,0.2,0.197,0.69,0.2239,6,8,14,14,True
1958,2011-03-27,2,0,3,9,0,0,0,1,0.22,0.2273,0.55,0.1343,17,37,54,54,True
1959,2011-03-27,2,0,3,10,0,0,0,2,0.22,0.2121,0.55,0.2239,27,59,86,86,True
1960,2011-03-27,2,0,3,11,0,0,0,2,0.24,0.2424,0.48,0.1642,23,85,108,108,True
1961,2011-03-27,2,0,3,12,0,0,0,2,0.26,0.2576,0.44,0.2239,43,120,163,163,True
1962,2011-03-27,2,0,3,13,0,0,0,1,0.3,0.2879,0.39,0.2239,47,100,147,147,True
1963,2011-03-27,2,0,3,14,0,0,0,1,0.32,0.3182,0.36,0.1642,61,103,164,164,True
1964,2011-03-27,2,0,3,15,0,0,0,1,0.32,0.303,0.36,0.2836,61,111,172,172,True
1965,2011-03-27,2,0,3,16,0,0,0,1,0.34,0.3333,0.34,0.0,45,98,143,143,True
1966,2011-03-27,2,0,3,17,0,0,0,1,0.32,0.303,0.31,0.2537,50,109,159,159,True
1967,2011-03-27,2,0,3,18,0,0,0,1,0.3,0.2879,0.33,0.194,32,105,137,137,True
1968,2011-03-27,2,0,3,19,0,0,0,1,0.3,0.2879,0.31,0.2239,23,80,103,103,True
1969,2011-03-27,2,0,3,20,0,0,0,1,0.28,0.2727,0.36,0.1642,7,50,57,57,True
1970,2011-03-27,2,0,3,21,0,0,0,1,0.26,0.2576,0.41,0.1642,7,29,36,36,True
1971,2011-03-27,2,0,3,22,0,0,0,1,0.26,0.2576,0.41,0.1642,5,25,30,30,True
1972,2011-03-27,2,0,3,23,0,0,0,1,0.26,0.2576,0.44,0.194,3,16,19,19,True
1973,2011-03-28,2,0,3,0,0,1,1,1,0.22,0.2273,0.55,0.194,1,11,12,12,True
1974,2011-03-28,2,0,3,1,0,1,1,1,0.22,0.2273,0.44,0.194,2,4,6,6,True
1975,2011-03-28,2,0,3,2,0,1,1,1,0.22,0.2273,0.44,0.1642,0,5,5,5,True
1976,2011-03-28,2,0,3,3,0,1,1,1,0.22,0.2273,0.44,0.1642,0,2,2,2,True
1977,2011-03-28,2,0,3,5,0,1,1,1,0.18,0.1818,0.43,0.194,0,8,8,8,True
1978,2011-03-28,2,0,3,6,0,1,1,1,0.18,0.1667,0.34,0.2836,0,40,40,40,True
1979,2011-03-28,2,0,3,7,0,1,1,1,0.2,0.1818,0.32,0.3284,6,104,110,110,True
1980,2011-03-28,2,0,3,8,0,1,1,1,0.2,0.197,0.34,0.2239,15,239,254,254,True
1981,2011-03-28,2,0,3,9,0,1,1,2,0.22,0.2121,0.32,0.2239,12,109,121,121,True
1982,2011-03-28,2,0,3,10,0,1,1,1,0.24,0.2273,0.3,0.194,22,47,69,69,True
1983,2011-03-28,2,0,3,11,0,1,1,2,0.26,0.2424,0.3,0.2836,18,39,57,57,True
1984,2011-03-28,2,0,3,12,0,1,1,2,0.26,0.2727,0.25,0.0,8,71,79,79,True
1985,2011-03-28,2,0,3,13,0,1,1,2,0.3,0.2879,0.24,0.2239,14,69,83,83,True
1986,2011-03-28,2,0,3,14,0,1,1,1,0.32,0.303,0.22,0.2239,15,65,80,80,True
1987,2011-03-28,2,0,3,15,0,1,1,1,0.32,0.303,0.24,0.2836,19,53,72,72,True
1988,2011-03-28,2,0,3,16,0,1,1,1,0.34,0.3182,0.23,0.2239,15,117,132,132,True
1989,2011-03-28,2,0,3,17,0,1,1,1,0.34,0.303,0.23,0.2985,25,227,252,252,True
1990,2011-03-28,2,0,3,18,0,1,1,1,0.32,0.303,0.21,0.2836,21,220,241,241,True
1991,2011-03-28,2,0,3,19,0,1,1,1,0.3,0.303,0.22,0.1343,17,156,173,173,True
1992,2011-03-28,2,0,3,20,0,1,1,1,0.32,0.3333,0.22,0.1045,5,107,112,112,True
1993,2011-03-28,2,0,3,21,0,1,1,1,0.32,0.3333,0.21,0.1343,6,55,61,61,True
1994,2011-03-28,2,0,3,22,0,1,1,1,0.3,0.2879,0.22,0.2239,0,40,40,40,True
1995,2011-03-28,2,0,3,23,0,1,1,1,0.28,0.2576,0.24,0.2985,1,18,19,19,True
1996,2011-03-29,2,0,3,0,0,2,1,1,0.26,0.2273,0.28,0.3284,1,15,16,16,True
1997,2011-03-29,2,0,3,1,0,2,1,1,0.24,0.2121,0.32,0.2985,0,4,4,4,True
1998,2011-03-29,2,0,3,2,0,2,1,1,0.24,0.2121,0.32,0.2985,0,3,3,3,True
1999,2011-03-29,2,0,3,3,0,2,1,1,0.24,0.2121,0.32,0.2985,2,1,3,3,True
2000,2011-03-29,2,0,3,4,0,2,1,1,0.2,0.2121,0.44,0.1642,1,1,2,2,True
2001,2011-03-29,2,0,3,5,0,2,1,1,0.22,0.2121,0.37,0.2537,0,8,8,8,True
2002,2011-03-29,2,0,3,6,0,2,1,1,0.22,0.2121,0.41,0.2985,4,46,50,50,True
2003,2011-03-29,2,0,3,7,0,2,1,1,0.22,0.197,0.41,0.3582,5,128,133,133,True
2004,2011-03-29,2,0,3,8,0,2,1,1,0.24,0.2121,0.35,0.3582,19,268,287,287,True
2005,2011-03-29,2,0,3,9,0,2,1,1,0.28,0.2576,0.28,0.3881,16,156,172,172,True
2006,2011-03-29,2,0,3,10,0,2,1,1,0.3,0.2727,0.24,0.2985,13,46,59,59,True
2007,2011-03-29,2,0,3,11,0,2,1,2,0.34,0.303,0.25,0.3881,18,63,81,81,True
2008,2011-03-29,2,0,3,12,0,2,1,1,0.34,0.3333,0.25,0.1642,29,77,106,106,True
2009,2011-03-29,2,0,3,13,0,2,1,1,0.34,0.303,0.25,0.2985,24,80,104,104,True
2010,2011-03-29,2,0,3,14,0,2,1,1,0.36,0.3333,0.25,0.2537,20,66,86,86,True
2011,2011-03-29,2,0,3,15,0,2,1,1,0.38,0.3939,0.25,0.2239,22,65,87,87,True
2012,2011-03-29,2,0,3,16,0,2,1,1,0.38,0.3939,0.22,0.1642,12,124,136,136,True
2013,2011-03-29,2,0,3,17,0,2,1,1,0.4,0.4091,0.2,0.1343,34,265,299,299,True
2014,2011-03-29,2,0,3,18,0,2,1,1,0.36,0.3636,0.21,0.0896,42,252,294,294,True
2015,2011-03-29,2,0,3,19,0,2,1,1,0.34,0.3333,0.23,0.194,20,170,190,190,True
2016,2011-03-29,2,0,3,20,0,2,1,1,0.36,0.3636,0.21,0.0896,13,119,132,132,True
2017,2011-03-29,2,0,3,21,0,2,1,1,0.34,0.3636,0.42,0.0,8,75,83,83,True
2018,2011-03-29,2,0,3,22,0,2,1,1,0.34,0.3636,0.49,0.0,6,49,55,55,True
2019,2011-03-29,2,0,3,23,0,2,1,2,0.32,0.3333,0.57,0.1045,8,27,35,35,True
2020,2011-03-30,2,0,3,0,0,3,1,2,0.32,0.3485,0.57,0.0,3,8,11,11,True
2021,2011-03-30,2,0,3,1,0,3,1,1,0.32,0.3485,0.39,0.0,1,9,10,10,True
2022,2011-03-30,2,0,3,2,0,3,1,2,0.32,0.3485,0.57,0.0,0,4,4,4,True
2023,2011-03-30,2,0,3,3,0,3,1,2,0.32,0.3485,0.49,0.0,0,4,4,4,True
2024,2011-03-30,2,0,3,4,0,3,1,2,0.32,0.3485,0.57,0.0,1,0,1,1,True
2025,2011-03-30,2,0,3,5,0,3,1,2,0.3,0.2879,0.56,0.194,0,7,7,7,True
2026,2011-03-30,2,0,3,6,0,3,1,2,0.3,0.303,0.49,0.1343,4,44,48,48,True
2027,2011-03-30,2,0,3,7,0,3,1,2,0.32,0.3333,0.45,0.1045,8,128,136,136,True
2028,2011-03-30,2,0,3,8,0,3,1,2,0.32,0.3182,0.49,0.1642,16,247,263,263,True
2029,2011-03-30,2,0,3,9,0,3,1,2,0.32,0.303,0.45,0.2239,7,147,154,154,True
2030,2011-03-30,2,0,3,10,0,3,1,2,0.34,0.3182,0.46,0.2239,13,51,64,64,True
2031,2011-03-30,2,0,3,11,0,3,1,2,0.34,0.3182,0.46,0.2537,26,64,90,90,True
2032,2011-03-30,2,0,3,12,0,3,1,2,0.34,0.3333,0.46,0.1642,15,65,80,80,True
2033,2011-03-30,2,0,3,13,0,3,1,2,0.36,0.3485,0.46,0.2239,14,84,98,98,True
2034,2011-03-30,2,0,3,14,0,3,1,2,0.36,0.3333,0.46,0.2985,16,64,80,80,True
2035,2011-03-30,2,0,3,15,0,3,1,3,0.28,0.2576,0.81,0.2985,14,56,70,70,True
2036,2011-03-30,2,0,3,16,0,3,1,3,0.28,0.2727,0.87,0.2537,0,36,36,36,True
2037,2011-03-30,2,0,3,17,0,3,1,3,0.26,0.2727,0.93,0.1045,11,105,116,116,True
2038,2011-03-30,2,0,3,18,0,3,1,2,0.26,0.2576,0.93,0.2239,6,79,85,85,True
2039,2011-03-30,2,0,3,19,0,3,1,2,0.26,0.2576,0.93,0.2239,5,67,72,72,True
2040,2011-03-30,2,0,3,20,0,3,1,3,0.24,0.2121,0.93,0.2985,4,40,44,44,True
2041,2011-03-30,2,0,3,21,0,3,1,2,0.24,0.2273,0.93,0.2537,0,27,27,27,True
2042,2011-03-30,2,0,3,22,0,3,1,3,0.24,0.2273,0.93,0.2239,3,21,24,24,True
2043,2011-03-30,2,0,3,23,0,3,1,3,0.24,0.2121,0.93,0.2836,1,11,12,12,True
2044,2011-03-31,2,0,3,0,0,4,1,3,0.24,0.2273,0.93,0.2239,0,3,3,3,True
2045,2011-03-31,2,0,3,1,0,4,1,3,0.24,0.2273,0.93,0.194,1,4,5,5,True
2046,2011-03-31,2,0,3,2,0,4,1,3,0.24,0.2273,0.93,0.194,0,5,5,5,True
2047,2011-03-31,2,0,3,3,0,4,1,3,0.24,0.2273,0.93,0.2239,0,1,1,1,True
2048,2011-03-31,2,0,3,4,0,4,1,3,0.24,0.2273,0.93,0.2537,0,2,2,2,True
2049,2011-03-31,2,0,3,5,0,4,1,3,0.24,0.2273,0.93,0.2239,0,8,8,8,True
2050,2011-03-31,2,0,3,6,0,4,1,3,0.24,0.2121,0.93,0.2985,2,34,36,36,True
2051,2011-03-31,2,0,3,7,0,4,1,3,0.24,0.2273,0.93,0.2537,5,87,92,92,True
2052,2011-03-31,2,0,3,8,0,4,1,2,0.24,0.2273,1.0,0.2537,7,185,192,192,True
2053,2011-03-31,2,0,3,9,0,4,1,3,0.26,0.2424,0.93,0.2537,6,126,132,132,True
2054,2011-03-31,2,0,3,10,0,4,1,3,0.26,0.2424,0.93,0.2537,15,54,69,69,True
2055,2011-03-31,2,0,3,11,0,4,1,3,0.28,0.2727,0.93,0.194,6,52,58,58,True
2056,2011-03-31,2,0,3,12,0,4,1,3,0.28,0.2727,0.93,0.194,17,73,90,90,True
2057,2011-03-31,2,0,3,13,0,4,1,3,0.3,0.303,0.87,0.1343,13,55,68,68,True
2058,2011-03-31,2,0,3,14,0,4,1,3,0.3,0.303,0.87,0.1343,27,49,76,76,True
2059,2011-03-31,2,0,3,15,0,4,1,3,0.3,0.2727,0.87,0.2985,4,61,65,65,True
2060,2011-03-31,2,0,3,16,0,4,1,2,0.3,0.2879,0.87,0.2537,13,72,85,85,True
2061,2011-03-31,2,0,3,17,0,4,1,2,0.3,0.2879,0.87,0.2537,15,153,168,168,True
2062,2011-03-31,2,0,3,18,0,4,1,2,0.3,0.303,0.87,0.1343,12,165,177,177,True
2063,2011-03-31,2,0,3,19,0,4,1,2,0.3,0.303,0.87,0.1343,12,118,130,130,True
2064,2011-03-31,2,0,3,20,0,4,1,3,0.28,0.2576,0.93,0.2836,6,79,85,85,True
2065,2011-03-31,2,0,3,21,0,4,1,2,0.28,0.2727,0.93,0.1642,7,53,60,60,True
2066,2011-03-31,2,0,3,22,0,4,1,3,0.28,0.2727,0.93,0.2537,7,44,51,51,True
2067,2011-03-31,2,0,3,23,0,4,1,3,0.26,0.2576,1.0,0.1642,4,23,27,27,True
2068,2011-04-01,2,0,4,0,0,5,1,3,0.26,0.2576,1.0,0.1642,0,6,6,6,True
2069,2011-04-01,2,0,4,1,0,5,1,3,0.26,0.2576,1.0,0.1642,0,4,4,4,True
2070,2011-04-01,2,0,4,2,0,5,1,3,0.26,0.2576,0.93,0.194,0,7,7,7,True
2071,2011-04-01,2,0,4,3,0,5,1,2,0.24,0.2273,0.93,0.2537,0,4,4,4,True
2072,2011-04-01,2,0,4,4,0,5,1,2,0.24,0.2273,0.93,0.2537,0,3,3,3,True
2073,2011-04-01,2,0,4,5,0,5,1,3,0.24,0.2273,0.93,0.2239,1,11,12,12,True
2074,2011-04-01,2,0,4,6,0,5,1,3,0.24,0.2273,0.93,0.2239,2,26,28,28,True
2075,2011-04-01,2,0,4,7,0,5,1,3,0.24,0.2424,0.93,0.0,4,91,95,95,True
2076,2011-04-01,2,0,4,8,0,5,1,2,0.26,0.2424,0.87,0.2537,8,198,206,206,True
2077,2011-04-01,2,0,4,9,0,5,1,1,0.32,0.2879,0.7,0.3582,11,162,173,173,True
2078,2011-04-01,2,0,4,10,0,5,1,1,0.32,0.303,0.66,0.2836,12,63,75,75,True
2079,2011-04-01,2,0,4,11,0,5,1,1,0.32,0.2879,0.61,0.3582,17,72,89,89,True
2080,2011-04-01,2,0,4,12,0,5,1,1,0.34,0.303,0.53,0.3582,15,80,95,95,True
2081,2011-04-01,2,0,4,13,0,5,1,1,0.36,0.3333,0.5,0.3582,18,92,110,110,True
2082,2011-04-01,2,0,4,14,0,5,1,2,0.36,0.3333,0.46,0.3582,26,61,87,87,True
2083,2011-04-01,2,0,4,15,0,5,1,1,0.34,0.303,0.46,0.4179,30,81,111,111,True
2084,2011-04-01,2,0,4,16,0,5,1,1,0.34,0.303,0.46,0.4179,42,125,167,167,True
2085,2011-04-01,2,0,4,17,0,5,1,1,0.34,0.303,0.46,0.3284,36,245,281,281,True
2086,2011-04-01,2,0,4,18,0,5,1,1,0.34,0.303,0.46,0.3284,36,205,241,241,True
2087,2011-04-01,2,0,4,19,0,5,1,1,0.34,0.303,0.49,0.3284,16,120,136,136,True
2088,2011-04-01,2,0,4,20,0,5,1,1,0.32,0.3182,0.53,0.194,2,75,77,77,True
2089,2011-04-01,2,0,4,21,0,5,1,1,0.32,0.3333,0.53,0.1343,9,84,93,93,True
2090,2011-04-01,2,0,4,22,0,5,1,1,0.3,0.303,0.56,0.1642,10,64,74,74,True
2091,2011-04-01,2,0,4,23,0,5,1,1,0.3,0.3182,0.61,0.0896,12,41,53,53,True
2092,2011-04-02,2,0,4,0,0,6,0,2,0.3,0.3333,0.61,0.0,3,29,32,32,True
2093,2011-04-02,2,0,4,1,0,6,0,1,0.26,0.2727,0.65,0.1343,4,28,32,32,True
2094,2011-04-02,2,0,4,2,0,6,0,1,0.24,0.2424,0.75,0.1343,1,20,21,21,True
2095,2011-04-02,2,0,4,3,0,6,0,1,0.24,0.2424,0.7,0.1642,1,8,9,9,True
2096,2011-04-02,2,0,4,4,0,6,0,1,0.24,0.2424,0.7,0.1642,0,5,5,5,True
2097,2011-04-02,2,0,4,5,0,6,0,2,0.24,0.2424,0.75,0.1642,1,4,5,5,True
2098,2011-04-02,2,0,4,6,0,6,0,1,0.26,0.2727,0.7,0.1045,5,7,12,12,True
2099,2011-04-02,2,0,4,7,0,6,0,2,0.26,0.2727,0.7,0.1045,2,16,18,18,True
2100,2011-04-02,2,0,4,8,0,6,0,1,0.3,0.3182,0.7,0.1045,10,45,55,55,True
2101,2011-04-02,2,0,4,9,0,6,0,2,0.34,0.3485,0.66,0.1045,22,65,87,87,True
2102,2011-04-02,2,0,4,10,0,6,0,2,0.36,0.3485,0.57,0.1642,41,113,154,154,True
2103,2011-04-02,2,0,4,11,0,6,0,2,0.4,0.4091,0.47,0.1642,72,126,198,198,True
2104,2011-04-02,2,0,4,12,0,6,0,3,0.32,0.3333,0.81,0.1343,84,100,184,184,True
2105,2011-04-02,2,0,4,13,0,6,0,1,0.34,0.3333,0.81,0.1343,56,81,137,137,True
2106,2011-04-02,2,0,4,14,0,6,0,3,0.32,0.303,0.76,0.3284,97,93,190,190,True
2107,2011-04-02,2,0,4,15,0,6,0,3,0.34,0.303,0.76,0.3881,72,64,136,136,True
2108,2011-04-02,2,0,4,16,0,6,0,1,0.38,0.3939,0.62,0.3284,111,85,196,196,True
2109,2011-04-02,2,0,4,17,0,6,0,1,0.38,0.3939,0.54,0.3582,89,95,184,184,True
2110,2011-04-02,2,0,4,18,0,6,0,1,0.38,0.3939,0.54,0.194,69,110,179,179,True
2111,2011-04-02,2,0,4,19,0,6,0,1,0.36,0.3333,0.53,0.3582,71,77,148,148,True
2112,2011-04-02,2,0,4,20,0,6,0,1,0.34,0.3182,0.53,0.2836,29,56,85,85,True
2113,2011-04-02,2,0,4,21,0,6,0,1,0.32,0.303,0.61,0.2537,24,53,77,77,True
2114,2011-04-02,2,0,4,22,0,6,0,1,0.32,0.303,0.61,0.2985,14,41,55,55,True
2115,2011-04-02,2,0,4,23,0,6,0,1,0.32,0.3182,0.61,0.1642,20,33,53,53,True
2116,2011-04-03,2,0,4,0,0,0,0,1,0.3,0.2879,0.65,0.194,8,31,39,39,True
2117,2011-04-03,2,0,4,1,0,0,0,1,0.3,0.3182,0.61,0.1045,8,26,34,34,True
2118,2011-04-03,2,0,4,2,0,0,0,1,0.26,0.2727,0.7,0.1343,5,19,24,24,True
2119,2011-04-03,2,0,4,3,0,0,0,1,0.3,0.3333,0.61,0.0,3,8,11,11,True
2120,2011-04-03,2,0,4,4,0,0,0,1,0.28,0.303,0.7,0.0896,3,0,3,3,True
2121,2011-04-03,2,0,4,5,0,0,0,1,0.28,0.2727,0.65,0.2239,1,4,5,5,True
2122,2011-04-03,2,0,4,6,0,0,0,1,0.28,0.2727,0.65,0.194,10,23,33,33,True
2123,2011-04-03,2,0,4,7,0,0,0,1,0.32,0.303,0.57,0.2239,13,20,33,33,True
2124,2011-04-03,2,0,4,8,0,0,0,1,0.34,0.3333,0.57,0.1642,18,44,62,62,True
2125,2011-04-03,2,0,4,9,0,0,0,1,0.36,0.3182,0.5,0.4775,68,74,142,142,True
2126,2011-04-03,2,0,4,10,0,0,0,1,0.4,0.4091,0.43,0.4179,111,104,215,215,True
2127,2011-04-03,2,0,4,11,0,0,0,1,0.42,0.4242,0.41,0.2537,114,104,218,218,True
2128,2011-04-03,2,0,4,12,0,0,0,1,0.44,0.4394,0.38,0.2836,114,147,261,261,True
2129,2011-04-03,2,0,4,13,0,0,0,1,0.44,0.4394,0.33,0.2985,114,148,262,262,True
2130,2011-04-03,2,0,4,14,0,0,0,1,0.46,0.4545,0.31,0.1343,114,109,223,223,True
2131,2011-04-03,2,0,4,15,0,0,0,2,0.46,0.4545,0.33,0.0,114,118,232,232,True
2132,2011-04-03,2,0,4,16,0,0,0,2,0.46,0.4545,0.31,0.194,114,156,270,270,True
2133,2011-04-03,2,0,4,17,0,0,0,2,0.46,0.4545,0.28,0.1343,114,126,240,240,True
2134,2011-04-03,2,0,4,18,0,0,0,2,0.46,0.4545,0.31,0.0,71,101,172,172,True
2135,2011-04-03,2,0,4,19,0,0,0,2,0.42,0.4242,0.44,0.194,51,93,144,144,True
2136,2011-04-03,2,0,4,20,0,0,0,3,0.42,0.4242,0.41,0.2239,24,55,79,79,True
2137,2011-04-03,2,0,4,21,0,0,0,2,0.42,0.4242,0.44,0.2239,8,37,45,45,True
2138,2011-04-03,2,0,4,22,0,0,0,1,0.4,0.4091,0.43,0.1045,7,29,36,36,True
2139,2011-04-03,2,0,4,23,0,0,0,1,0.4,0.4091,0.5,0.0896,9,22,31,31,True
2140,2011-04-04,2,0,4,0,0,1,1,1,0.4,0.4091,0.5,0.2239,1,5,6,6,True
2141,2011-04-04,2,0,4,1,0,1,1,1,0.4,0.4091,0.56,0.3582,7,4,11,11,True
2142,2011-04-04,2,0,4,2,0,1,1,1,0.38,0.3939,0.66,0.2537,1,1,2,2,True
2143,2011-04-04,2,0,4,3,0,1,1,1,0.38,0.3939,0.66,0.2836,1,0,1,1,True
2144,2011-04-04,2,0,4,4,0,1,1,1,0.38,0.3939,0.71,0.2985,1,1,2,2,True
2145,2011-04-04,2,0,4,5,0,1,1,1,0.4,0.4091,0.62,0.2537,0,7,7,7,True
2146,2011-04-04,2,0,4,6,0,1,1,1,0.42,0.4242,0.58,0.2836,3,43,46,46,True
2147,2011-04-04,2,0,4,7,0,1,1,2,0.44,0.4394,0.54,0.2537,7,150,157,157,True
2148,2011-04-04,2,0,4,8,0,1,1,2,0.46,0.4545,0.55,0.2985,31,308,339,339,True
2149,2011-04-04,2,0,4,9,0,1,1,2,0.5,0.4848,0.51,0.3881,24,134,158,158,True
2150,2011-04-04,2,0,4,10,0,1,1,2,0.54,0.5152,0.45,0.3582,35,55,90,90,True
2151,2011-04-04,2,0,4,11,0,1,1,1,0.6,0.6212,0.4,0.3881,58,66,124,124,True
2152,2011-04-04,2,0,4,12,0,1,1,1,0.64,0.6212,0.36,0.4627,59,98,157,157,True
2153,2011-04-04,2,0,4,13,0,1,1,1,0.68,0.6364,0.34,0.3284,47,92,139,139,True
2154,2011-04-04,2,0,4,14,0,1,1,2,0.74,0.6515,0.27,0.4775,47,76,123,123,True
2155,2011-04-04,2,0,4,15,0,1,1,1,0.76,0.6667,0.23,0.4775,47,96,143,143,True
2156,2011-04-04,2,0,4,16,0,1,1,1,0.76,0.6515,0.22,0.4775,59,130,189,189,True
2157,2011-04-04,2,0,4,17,0,1,1,1,0.74,0.6515,0.23,0.4775,83,283,366,366,True
2158,2011-04-04,2,0,4,18,0,1,1,2,0.72,0.6364,0.23,0.4775,78,308,386,386,True
2159,2011-04-04,2,0,4,19,0,1,1,1,0.7,0.6364,0.24,0.4627,51,227,278,278,True
2160,2011-04-04,2,0,4,20,0,1,1,2,0.7,0.6364,0.24,0.4775,40,133,173,173,True
2161,2011-04-04,2,0,4,21,0,1,1,2,0.7,0.6364,0.3,0.4478,19,76,95,95,True
2162,2011-04-04,2,0,4,22,0,1,1,2,0.68,0.6364,0.36,0.4627,17,58,75,75,True
2163,2011-04-04,2,0,4,23,0,1,1,2,0.64,0.6212,0.47,0.2239,18,30,48,48,True
2164,2011-04-05,2,0,4,0,0,2,1,1,0.62,0.6212,0.5,0.1045,10,12,22,22,True
2165,2011-04-05,2,0,4,1,0,2,1,3,0.62,0.6212,0.57,0.4179,10,5,15,15,True
2166,2011-04-05,2,0,4,2,0,2,1,2,0.54,0.5152,0.73,0.3284,0,5,5,5,True
2167,2011-04-05,2,0,4,3,0,2,1,2,0.54,0.5152,0.73,0.3284,1,3,4,4,True
2168,2011-04-05,2,0,4,4,0,2,1,3,0.5,0.4848,0.88,0.4775,0,2,2,2,True
2169,2011-04-05,2,0,4,5,0,2,1,3,0.46,0.4545,0.94,0.2985,0,5,5,5,True
2170,2011-04-05,2,0,4,6,0,2,1,2,0.48,0.4697,0.88,0.3284,2,36,38,38,True
2171,2011-04-05,2,0,4,7,0,2,1,2,0.48,0.4697,0.88,0.3284,10,124,134,134,True
2172,2011-04-05,2,0,4,8,0,2,1,3,0.38,0.3939,0.87,0.4775,9,148,157,157,True
2173,2011-04-05,2,0,4,9,0,2,1,3,0.36,0.3182,0.87,0.4775,2,44,46,46,True
2174,2011-04-05,2,0,4,10,0,2,1,3,0.34,0.303,0.81,0.3881,3,25,28,28,True
2175,2011-04-05,2,0,4,11,0,2,1,3,0.32,0.2879,0.81,0.4478,1,18,19,19,True
2176,2011-04-05,2,0,4,12,0,2,1,2,0.34,0.303,0.71,0.3881,6,32,38,38,True
2177,2011-04-05,2,0,4,13,0,2,1,2,0.36,0.3333,0.63,0.4179,5,51,56,56,True
2178,2011-04-05,2,0,4,14,0,2,1,2,0.36,0.3182,0.57,0.4775,9,67,76,76,True
2179,2011-04-05,2,0,4,15,0,2,1,1,0.4,0.4091,0.46,0.4627,6,62,68,68,True
2180,2011-04-05,2,0,4,16,0,2,1,1,0.38,0.3939,0.46,0.4179,17,113,130,130,True
2181,2011-04-05,2,0,4,17,0,2,1,1,0.42,0.4242,0.38,0.4179,27,246,273,273,True
2182,2011-04-05,2,0,4,18,0,2,1,1,0.38,0.3939,0.4,0.4775,19,248,267,267,True
2183,2011-04-05,2,0,4,19,0,2,1,1,0.36,0.3333,0.43,0.2985,12,148,160,160,True
2184,2011-04-05,2,0,4,20,0,2,1,1,0.34,0.3182,0.46,0.2836,4,87,91,91,True
2185,2011-04-05,2,0,4,21,0,2,1,1,0.34,0.2879,0.46,0.4775,8,81,89,89,True
2186,2011-04-05,2,0,4,22,0,2,1,1,0.32,0.303,0.49,0.2985,3,43,46,46,True
2187,2011-04-05,2,0,4,23,0,2,1,1,0.3,0.2879,0.49,0.2836,3,23,26,26,True
2188,2011-04-06,2,0,4,0,0,3,1,1,0.3,0.3182,0.49,0.1045,0,15,15,15,True
2189,2011-04-06,2,0,4,1,0,3,1,1,0.26,0.2727,0.6,0.1343,0,2,2,2,True
2190,2011-04-06,2,0,4,2,0,3,1,1,0.24,0.2424,0.7,0.1343,0,5,5,5,True
2191,2011-04-06,2,0,4,3,0,3,1,1,0.26,0.2727,0.6,0.1343,0,4,4,4,True
2192,2011-04-06,2,0,4,4,0,3,1,1,0.24,0.2424,0.65,0.1343,0,1,1,1,True
2193,2011-04-06,2,0,4,5,0,3,1,1,0.24,0.2576,0.7,0.1045,1,12,13,13,True
2194,2011-04-06,2,0,4,6,0,3,1,1,0.24,0.2576,0.7,0.1045,4,52,56,56,True
2195,2011-04-06,2,0,4,7,0,3,1,1,0.26,0.2727,0.65,0.1045,3,130,133,133,True
2196,2011-04-06,2,0,4,8,0,3,1,1,0.32,0.303,0.61,0.2239,17,308,325,325,True
2197,2011-04-06,2,0,4,9,0,3,1,1,0.36,0.3333,0.46,0.2537,8,157,165,165,True
2198,2011-04-06,2,0,4,10,0,3,1,1,0.4,0.4091,0.37,0.3881,21,48,69,69,True
2199,2011-04-06,2,0,4,11,0,3,1,1,0.42,0.4242,0.38,0.3881,23,70,93,93,True
2200,2011-04-06,2,0,4,12,0,3,1,1,0.44,0.4394,0.41,0.2537,22,112,134,134,True
2201,2011-04-06,2,0,4,13,0,3,1,1,0.46,0.4545,0.38,0.4775,29,83,112,112,True
2202,2011-04-06,2,0,4,14,0,3,1,1,0.5,0.4848,0.34,0.4179,35,80,115,115,True
2203,2011-04-06,2,0,4,15,0,3,1,1,0.52,0.5,0.32,0.3284,34,83,117,117,True
2204,2011-04-06,2,0,4,16,0,3,1,1,0.54,0.5152,0.28,0.4179,27,142,169,169,True
2205,2011-04-06,2,0,4,17,0,3,1,1,0.52,0.5,0.32,0.4478,53,303,356,356,True
2206,2011-04-06,2,0,4,18,0,3,1,1,0.52,0.5,0.29,0.3582,43,282,325,325,True
2207,2011-04-06,2,0,4,19,0,3,1,1,0.5,0.4848,0.31,0.2985,36,196,232,232,True
2208,2011-04-06,2,0,4,20,0,3,1,1,0.46,0.4545,0.51,0.2239,15,126,141,141,True
2209,2011-04-06,2,0,4,21,0,3,1,1,0.46,0.4545,0.41,0.2836,18,84,102,102,True
2210,2011-04-06,2,0,4,22,0,3,1,1,0.46,0.4545,0.41,0.2836,13,71,84,84,True
2211,2011-04-06,2,0,4,23,0,3,1,1,0.46,0.4545,0.41,0.2985,11,29,40,40,True
2212,2011-04-07,2,0,4,0,0,4,1,1,0.46,0.4545,0.41,0.2836,5,15,20,20,True
2213,2011-04-07,2,0,4,1,0,4,1,1,0.42,0.4242,0.47,0.1343,2,11,13,13,True
2214,2011-04-07,2,0,4,2,0,4,1,1,0.42,0.4242,0.54,0.0,0,7,7,7,True
2215,2011-04-07,2,0,4,3,0,4,1,1,0.36,0.3485,0.66,0.194,0,3,3,3,True
2216,2011-04-07,2,0,4,4,0,4,1,1,0.34,0.3333,0.76,0.194,0,1,1,1,True
2217,2011-04-07,2,0,4,5,0,4,1,1,0.34,0.3182,0.76,0.2239,0,6,6,6,True
2218,2011-04-07,2,0,4,6,0,4,1,1,0.32,0.303,0.81,0.2537,5,59,64,64,True
2219,2011-04-07,2,0,4,7,0,4,1,2,0.34,0.3333,0.76,0.1642,8,152,160,160,True
2220,2011-04-07,2,0,4,8,0,4,1,1,0.36,0.3485,0.76,0.194,23,291,314,314,True
2221,2011-04-07,2,0,4,9,0,4,1,2,0.4,0.4091,0.66,0.1343,15,155,170,170,True
2222,2011-04-07,2,0,4,10,0,4,1,2,0.42,0.4242,0.67,0.1045,29,66,95,95,True
2223,2011-04-07,2,0,4,11,0,4,1,2,0.46,0.4545,0.55,0.0,36,86,122,122,True
2224,2011-04-07,2,0,4,12,0,4,1,2,0.46,0.4545,0.55,0.0,39,114,153,153,True
2225,2011-04-07,2,0,4,13,0,4,1,2,0.52,0.5,0.48,0.0896,36,99,135,135,True
2226,2011-04-07,2,0,4,14,0,4,1,1,0.56,0.5303,0.43,0.0896,46,111,157,157,True
2227,2011-04-07,2,0,4,15,0,4,1,1,0.6,0.6212,0.38,0.1045,27,133,160,160,True
2228,2011-04-07,2,0,4,16,0,4,1,1,0.6,0.6212,0.35,0.0,52,161,213,213,True
2229,2011-04-07,2,0,4,17,0,4,1,1,0.52,0.5,0.52,0.2836,63,280,343,343,True
2230,2011-04-07,2,0,4,18,0,4,1,1,0.48,0.4697,0.55,0.2537,68,265,333,333,True
2231,2011-04-07,2,0,4,19,0,4,1,1,0.46,0.4545,0.59,0.2985,34,192,226,226,True
2232,2011-04-07,2,0,4,20,0,4,1,1,0.44,0.4394,0.62,0.1642,37,166,203,203,True
2233,2011-04-07,2,0,4,21,0,4,1,2,0.44,0.4394,0.67,0.2836,19,89,108,108,True
2234,2011-04-07,2,0,4,22,0,4,1,2,0.4,0.4091,0.76,0.194,18,63,81,81,True
2235,2011-04-07,2,0,4,23,0,4,1,1,0.38,0.3939,0.76,0.2537,9,45,54,54,True
2236,2011-04-08,2,0,4,0,0,5,1,2,0.36,0.3485,0.76,0.2239,4,21,25,25,True
2237,2011-04-08,2,0,4,1,0,5,1,2,0.34,0.3333,0.76,0.1343,3,6,9,9,True
2238,2011-04-08,2,0,4,2,0,5,1,3,0.34,0.3333,0.76,0.1642,3,10,13,13,True
2239,2011-04-08,2,0,4,3,0,5,1,3,0.34,0.3333,0.76,0.1642,0,1,1,1,True
2240,2011-04-08,2,0,4,4,0,5,1,2,0.34,0.3333,0.86,0.1343,0,1,1,1,True
2241,2011-04-08,2,0,4,5,0,5,1,2,0.32,0.3182,0.87,0.194,1,8,9,9,True
2242,2011-04-08,2,0,4,6,0,5,1,2,0.34,0.3636,0.87,0.0,2,33,35,35,True
2243,2011-04-08,2,0,4,7,0,5,1,3,0.34,0.3333,0.87,0.1642,4,109,113,113,True
2244,2011-04-08,2,0,4,8,0,5,1,3,0.34,0.3333,0.87,0.1642,13,208,221,221,True
2245,2011-04-08,2,0,4,9,0,5,1,2,0.36,0.3485,0.76,0.194,17,168,185,185,True
2246,2011-04-08,2,0,4,10,0,5,1,2,0.36,0.3333,0.71,0.2836,10,63,73,73,True
2247,2011-04-08,2,0,4,11,0,5,1,2,0.4,0.4091,0.62,0.3881,19,79,98,98,True
2248,2011-04-08,2,0,4,12,0,5,1,3,0.38,0.3939,0.66,0.2239,29,51,80,80,True
2249,2011-04-08,2,0,4,13,0,5,1,3,0.36,0.3333,0.76,0.2836,7,35,42,42,True
2250,2011-04-08,2,0,4,14,0,5,1,3,0.34,0.3182,0.87,0.2239,2,13,15,15,True
2251,2011-04-08,2,0,4,15,0,5,1,3,0.34,0.3182,0.87,0.2239,1,24,25,25,True
2252,2011-04-08,2,0,4,16,0,5,1,2,0.32,0.303,0.93,0.2537,2,58,60,60,True
2253,2011-04-08,2,0,4,17,0,5,1,3,0.32,0.303,0.93,0.2537,10,138,148,148,True
2254,2011-04-08,2,0,4,18,0,5,1,3,0.32,0.303,0.93,0.2537,8,54,62,62,True
2255,2011-04-08,2,0,4,19,0,5,1,3,0.3,0.2727,0.93,0.4179,1,52,53,53,True
2256,2011-04-08,2,0,4,20,0,5,1,2,0.3,0.2727,0.93,0.3284,12,51,63,63,True
2257,2011-04-08,2,0,4,21,0,5,1,2,0.3,0.2879,0.93,0.2537,11,43,54,54,True
2258,2011-04-08,2,0,4,22,0,5,1,2,0.3,0.2727,0.93,0.2985,9,42,51,51,True
2259,2011-04-08,2,0,4,23,0,5,1,2,0.3,0.2879,0.93,0.2239,4,31,35,35,True
2260,2011-04-09,2,0,4,0,0,6,0,2,0.3,0.2879,0.87,0.2239,5,26,31,31,True
2261,2011-04-09,2,0,4,1,0,6,0,2,0.3,0.303,0.87,0.1343,3,17,20,20,True
2262,2011-04-09,2,0,4,2,0,6,0,2,0.32,0.303,0.87,0.2239,2,15,17,17,True
2263,2011-04-09,2,0,4,3,0,6,0,3,0.3,0.2879,1.0,0.2537,3,11,14,14,True
2264,2011-04-09,2,0,4,4,0,6,0,3,0.3,0.2727,1.0,0.2537,0,3,3,3,True
2265,2011-04-09,2,0,4,5,0,6,0,2,0.3,0.2879,0.93,0.2239,0,5,5,5,True
2266,2011-04-09,2,0,4,6,0,6,0,2,0.3,0.2879,0.93,0.194,0,13,13,13,True
2267,2011-04-09,2,0,4,7,0,6,0,2,0.3,0.303,0.93,0.1642,8,13,21,21,True
2268,2011-04-09,2,0,4,8,0,6,0,2,0.32,0.303,0.93,0.1642,7,47,54,54,True
2269,2011-04-09,2,0,4,9,0,6,0,2,0.34,0.3485,0.87,0.1045,27,71,98,98,True
2270,2011-04-09,2,0,4,10,0,6,0,2,0.34,0.3333,0.87,0.1343,43,90,133,133,True
2271,2011-04-09,2,0,4,11,0,6,0,2,0.36,0.3636,0.81,0.0,51,91,142,142,True
2272,2011-04-09,2,0,4,12,0,6,0,2,0.36,0.3485,0.81,0.1343,79,123,202,202,True
2273,2011-04-09,2,0,4,13,0,6,0,2,0.36,0.3788,0.81,0.0,114,108,222,222,True
2274,2011-04-09,2,0,4,14,0,6,0,2,0.36,0.3485,0.81,0.1343,94,118,212,212,True
2275,2011-04-09,2,0,4,15,0,6,0,2,0.36,0.3788,0.87,0.0,85,116,201,201,True
2276,2011-04-09,2,0,4,16,0,6,0,2,0.38,0.3939,0.82,0.0,73,118,191,191,True
2277,2011-04-09,2,0,4,17,0,6,0,2,0.38,0.3939,0.82,0.0896,114,129,243,243,True
2278,2011-04-09,2,0,4,18,0,6,0,2,0.38,0.3939,0.82,0.1045,48,129,177,177,True
2279,2011-04-09,2,0,4,19,0,6,0,2,0.38,0.3939,0.82,0.1343,47,83,130,130,True
2280,2011-04-09,2,0,4,20,0,6,0,2,0.38,0.3939,0.87,0.1642,19,74,93,93,True
2281,2011-04-09,2,0,4,21,0,6,0,2,0.36,0.3485,0.93,0.1343,10,65,75,75,True
2282,2011-04-09,2,0,4,22,0,6,0,2,0.36,0.3485,0.93,0.1343,21,66,87,87,True
2283,2011-04-09,2,0,4,23,0,6,0,2,0.38,0.3939,0.87,0.0896,12,45,57,57,True
2284,2011-04-10,2,0,4,0,0,0,0,2,0.38,0.3939,0.87,0.0896,5,48,53,53,True
2285,2011-04-10,2,0,4,1,0,0,0,2,0.38,0.3939,0.87,0.1343,6,31,37,37,True
2286,2011-04-10,2,0,4,2,0,0,0,2,0.38,0.3939,0.87,0.0896,12,24,36,36,True
2287,2011-04-10,2,0,4,3,0,0,0,2,0.38,0.3939,0.87,0.1343,5,11,16,16,True
2288,2011-04-10,2,0,4,4,0,0,0,2,0.36,0.3636,0.93,0.1045,3,2,5,5,True
2289,2011-04-10,2,0,4,5,0,0,0,2,0.36,0.3636,0.93,0.0896,0,4,4,4,True
2290,2011-04-10,2,0,4,6,0,0,0,2,0.36,0.3636,0.93,0.0896,0,4,4,4,True
2291,2011-04-10,2,0,4,7,0,0,0,2,0.36,0.3636,1.0,0.0896,3,7,10,10,True
2292,2011-04-10,2,0,4,8,0,0,0,2,0.38,0.3939,0.94,0.0896,17,38,55,55,True
2293,2011-04-10,2,0,4,9,0,0,0,2,0.38,0.3939,0.94,0.1343,31,50,81,81,True
2294,2011-04-10,2,0,4,10,0,0,0,2,0.4,0.4091,0.87,0.0,69,81,150,150,True
2295,2011-04-10,2,0,4,11,0,0,0,2,0.4,0.4091,0.87,0.1343,93,109,202,202,True
2296,2011-04-10,2,0,4,12,0,0,0,2,0.42,0.4242,0.88,0.1343,94,136,230,230,True
2297,2011-04-10,2,0,4,13,0,0,0,1,0.46,0.4545,0.82,0.1045,114,142,256,256,True
2298,2011-04-10,2,0,4,14,0,0,0,1,0.5,0.4848,0.72,0.194,114,133,247,247,True
2299,2011-04-10,2,0,4,15,0,0,0,1,0.5,0.4848,0.77,0.2239,114,141,255,255,True
2300,2011-04-10,2,0,4,16,0,0,0,2,0.52,0.5,0.72,0.1642,114,153,267,267,True
2301,2011-04-10,2,0,4,17,0,0,0,2,0.52,0.5,0.72,0.194,84,152,236,236,True
2302,2011-04-10,2,0,4,18,0,0,0,1,0.5,0.4848,0.77,0.194,103,137,240,240,True
2303,2011-04-10,2,0,4,19,0,0,0,1,0.5,0.4848,0.77,0.194,47,84,131,131,True
2304,2011-04-10,2,0,4,20,0,0,0,1,0.46,0.4545,0.82,0.1343,21,71,92,92,True
2305,2011-04-10,2,0,4,21,0,0,0,1,0.44,0.4394,0.88,0.194,18,77,95,95,True
2306,2011-04-10,2,0,4,22,0,0,0,1,0.44,0.4394,0.94,0.2537,12,45,57,57,True
2307,2011-04-10,2,0,4,23,0,0,0,1,0.46,0.4545,0.88,0.3582,5,27,32,32,True
2308,2011-04-11,2,0,4,0,0,1,1,1,0.48,0.4697,0.88,0.3284,7,16,23,23,True
2309,2011-04-11,2,0,4,1,0,1,1,1,0.46,0.4545,0.94,0.2836,1,3,4,4,True
2310,2011-04-11,2,0,4,2,0,1,1,1,0.46,0.4545,0.94,0.2836,7,2,9,9,True
2311,2011-04-11,2,0,4,4,0,1,1,1,0.46,0.4545,0.94,0.194,0,1,1,1,True
2312,2011-04-11,2,0,4,5,0,1,1,1,0.46,0.4545,0.94,0.194,1,12,13,13,True
2313,2011-04-11,2,0,4,6,0,1,1,2,0.46,0.4545,1.0,0.2239,2,59,61,61,True
2314,2011-04-11,2,0,4,7,0,1,1,2,0.5,0.4848,0.88,0.2239,12,164,176,176,True
2315,2011-04-11,2,0,4,8,0,1,1,2,0.52,0.5,0.88,0.2836,28,286,314,314,True
2316,2011-04-11,2,0,4,9,0,1,1,2,0.56,0.5303,0.83,0.2836,33,132,165,165,True
2317,2011-04-11,2,0,4,10,0,1,1,2,0.56,0.5303,0.83,0.2985,41,55,96,96,True
2318,2011-04-11,2,0,4,11,0,1,1,2,0.6,0.5909,0.73,0.2985,45,59,104,104,True
2319,2011-04-11,2,0,4,12,0,1,1,2,0.6,0.5909,0.73,0.3284,37,97,134,134,True
2320,2011-04-11,2,0,4,13,0,1,1,2,0.64,0.6061,0.69,0.4179,62,77,139,139,True
2321,2011-04-11,2,0,4,14,0,1,1,2,0.72,0.6667,0.54,0.3582,60,85,145,145,True
2322,2011-04-11,2,0,4,15,0,1,1,1,0.74,0.6667,0.48,0.4775,56,85,141,141,True
2323,2011-04-11,2,0,4,16,0,1,1,1,0.74,0.6667,0.48,0.4775,73,162,235,235,True
2324,2011-04-11,2,0,4,17,0,1,1,1,0.74,0.6667,0.48,0.4775,100,352,452,452,True
2325,2011-04-11,2,0,4,18,0,1,1,1,0.72,0.6667,0.51,0.3881,93,290,383,383,True
2326,2011-04-11,2,0,4,19,0,1,1,1,0.72,0.6667,0.51,0.4478,73,211,284,284,True
2327,2011-04-11,2,0,4,20,0,1,1,1,0.68,0.6364,0.57,0.4775,44,122,166,166,True
2328,2011-04-11,2,0,4,21,0,1,1,1,0.66,0.6212,0.61,0.2537,39,119,158,158,True
2329,2011-04-11,2,0,4,22,0,1,1,2,0.64,0.6212,0.5,0.2836,25,66,91,91,True
2330,2011-04-11,2,0,4,23,0,1,1,3,0.58,0.5455,0.6,0.0,16,38,54,54,True
2331,2011-04-12,2,0,4,0,0,2,1,2,0.62,0.6212,0.5,0.1045,11,13,24,24,True
2332,2011-04-12,2,0,4,1,0,2,1,2,0.62,0.6212,0.5,0.0896,6,7,13,13,True
2333,2011-04-12,2,0,4,2,0,2,1,2,0.6,0.6212,0.53,0.1343,7,7,14,14,True
2334,2011-04-12,2,0,4,3,0,2,1,2,0.58,0.5455,0.56,0.1343,0,1,1,1,True
2335,2011-04-12,2,0,4,4,0,2,1,2,0.56,0.5303,0.64,0.1343,4,2,6,6,True
2336,2011-04-12,2,0,4,5,0,2,1,2,0.54,0.5152,0.68,0.1343,1,15,16,16,True
2337,2011-04-12,2,0,4,6,0,2,1,2,0.54,0.5152,0.68,0.2836,3,55,58,58,True
2338,2011-04-12,2,0,4,7,0,2,1,2,0.54,0.5152,0.68,0.2239,12,177,189,189,True
2339,2011-04-12,2,0,4,8,0,2,1,3,0.48,0.4697,0.88,0.3881,15,211,226,226,True
2340,2011-04-12,2,0,4,9,0,2,1,3,0.46,0.4545,0.94,0.4775,4,50,54,54,True
2341,2011-04-12,2,0,4,10,0,2,1,3,0.5,0.4848,0.82,0.4179,6,34,40,40,True
2342,2011-04-12,2,0,4,11,0,2,1,1,0.52,0.5,0.77,0.3582,11,38,49,49,True
2343,2011-04-12,2,0,4,12,0,2,1,2,0.56,0.5303,0.64,0.4627,9,83,92,92,True
2344,2011-04-12,2,0,4,13,0,2,1,3,0.54,0.5152,0.68,0.2836,22,84,106,106,True
2345,2011-04-12,2,0,4,14,0,2,1,2,0.5,0.4848,0.82,0.2836,16,28,44,44,True
2346,2011-04-12,2,0,4,15,0,2,1,2,0.48,0.4697,0.77,0.4775,24,54,78,78,True
2347,2011-04-12,2,0,4,16,0,2,1,2,0.48,0.4697,0.77,0.3881,19,80,99,99,True
2348,2011-04-12,2,0,4,17,0,2,1,3,0.44,0.4394,0.77,0.2239,29,262,291,291,True
2349,2011-04-12,2,0,4,18,0,2,1,3,0.44,0.4394,0.77,0.2239,21,203,224,224,True
2350,2011-04-12,2,0,4,19,0,2,1,2,0.42,0.4242,0.82,0.2836,3,127,130,130,True
2351,2011-04-12,2,0,4,20,0,2,1,2,0.42,0.4242,0.82,0.2836,9,94,103,103,True
2352,2011-04-12,2,0,4,21,0,2,1,2,0.42,0.4242,0.82,0.194,10,74,84,84,True
2353,2011-04-12,2,0,4,22,0,2,1,2,0.4,0.4091,0.94,0.2985,7,47,54,54,True
2354,2011-04-12,2,0,4,23,0,2,1,2,0.4,0.4091,0.94,0.2537,8,31,39,39,True
2355,2011-04-13,2,0,4,0,0,3,1,2,0.4,0.4091,1.0,0.2985,3,12,15,15,True
2356,2011-04-13,2,0,4,1,0,3,1,2,0.4,0.4091,1.0,0.2985,0,1,1,1,True
2357,2011-04-13,2,0,4,2,0,3,1,3,0.4,0.4091,1.0,0.2985,0,2,2,2,True
2358,2011-04-13,2,0,4,3,0,3,1,3,0.4,0.4091,0.94,0.3284,0,2,2,2,True
2359,2011-04-13,2,0,4,4,0,3,1,3,0.4,0.4091,0.94,0.3284,1,2,3,3,True
2360,2011-04-13,2,0,4,5,0,3,1,3,0.38,0.3939,0.94,0.2537,1,4,5,5,True
2361,2011-04-13,2,0,4,6,0,3,1,3,0.38,0.3939,0.94,0.2239,1,33,34,34,True
2362,2011-04-13,2,0,4,7,0,3,1,3,0.36,0.3485,1.0,0.2239,3,67,70,70,True
2363,2011-04-13,2,0,4,8,0,3,1,3,0.38,0.3939,0.94,0.194,6,158,164,164,True
2364,2011-04-13,2,0,4,9,0,3,1,2,0.38,0.3939,0.94,0.2239,2,63,65,65,True
2365,2011-04-13,2,0,4,10,0,3,1,2,0.4,0.4091,0.87,0.194,4,42,46,46,True
2366,2011-04-13,2,0,4,11,0,3,1,2,0.42,0.4242,0.82,0.194,4,57,61,61,True
2367,2011-04-13,2,0,4,12,0,3,1,3,0.42,0.4242,0.82,0.2537,12,83,95,95,True
2368,2011-04-13,2,0,4,13,0,3,1,2,0.44,0.4394,0.77,0.194,6,55,61,61,True
2369,2011-04-13,2,0,4,14,0,3,1,2,0.42,0.4242,0.77,0.2537,24,82,106,106,True
2370,2011-04-13,2,0,4,15,0,3,1,2,0.44,0.4394,0.72,0.2836,12,69,81,81,True
2371,2011-04-13,2,0,4,16,0,3,1,1,0.46,0.4545,0.67,0.2836,23,119,142,142,True
2372,2011-04-13,2,0,4,17,0,3,1,1,0.46,0.4545,0.67,0.2985,25,284,309,309,True
2373,2011-04-13,2,0,4,18,0,3,1,1,0.44,0.4394,0.62,0.3881,28,293,321,321,True
2374,2011-04-13,2,0,4,19,0,3,1,1,0.44,0.4394,0.62,0.2537,15,160,175,175,True
2375,2011-04-13,2,0,4,20,0,3,1,1,0.44,0.4394,0.62,0.2537,7,119,126,126,True
2376,2011-04-13,2,0,4,21,0,3,1,1,0.42,0.4242,0.67,0.1642,17,100,117,117,True
2377,2011-04-13,2,0,4,22,0,3,1,1,0.42,0.4242,0.67,0.194,10,89,99,99,True
2378,2011-04-13,2,0,4,23,0,3,1,1,0.4,0.4091,0.71,0.1343,5,57,62,62,True
2379,2011-04-14,2,0,4,0,0,4,1,1,0.38,0.3939,0.76,0.1343,3,18,21,21,True
2380,2011-04-14,2,0,4,1,0,4,1,1,0.38,0.3939,0.76,0.2239,1,9,10,10,True
2381,2011-04-14,2,0,4,2,0,4,1,1,0.36,0.3485,0.76,0.1343,0,3,3,3,True
2382,2011-04-14,2,0,4,3,0,4,1,1,0.34,0.3333,0.81,0.1343,0,2,2,2,True
2383,2011-04-14,2,0,4,4,0,4,1,1,0.34,0.3636,0.76,0.0,1,8,9,9,True
2384,2011-04-14,2,0,4,5,0,4,1,1,0.34,0.3485,0.76,0.0896,2,12,14,14,True
2385,2011-04-14,2,0,4,6,0,4,1,1,0.34,0.3485,0.76,0.1045,4,66,70,70,True
2386,2011-04-14,2,0,4,7,0,4,1,1,0.38,0.3939,0.66,0.0,11,182,193,193,True
2387,2011-04-14,2,0,4,8,0,4,1,1,0.42,0.4242,0.58,0.1642,21,316,337,337,True
2388,2011-04-14,2,0,4,9,0,4,1,1,0.46,0.4545,0.51,0.1343,18,152,170,170,True
2389,2011-04-14,2,0,4,10,0,4,1,1,0.5,0.4848,0.51,0.194,21,68,89,89,True
2390,2011-04-14,2,0,4,11,0,4,1,1,0.52,0.5,0.45,0.1642,28,87,115,115,True
2391,2011-04-14,2,0,4,12,0,4,1,1,0.54,0.5152,0.42,0.1343,35,110,145,145,True
2392,2011-04-14,2,0,4,13,0,4,1,1,0.56,0.5303,0.37,0.2239,38,121,159,159,True
2393,2011-04-14,2,0,4,14,0,4,1,1,0.56,0.5303,0.35,0.0896,36,101,137,137,True
2394,2011-04-14,2,0,4,15,0,4,1,1,0.6,0.6212,0.31,0.0896,57,85,142,142,True
2395,2011-04-14,2,0,4,16,0,4,1,1,0.6,0.6061,0.26,0.1045,49,153,202,202,True
2396,2011-04-14,2,0,4,17,0,4,1,1,0.6,0.6061,0.28,0.0,50,338,388,388,True
2397,2011-04-14,2,0,4,18,0,4,1,1,0.56,0.5303,0.3,0.0,47,290,337,337,True
2398,2011-04-14,2,0,4,19,0,4,1,1,0.54,0.5152,0.32,0.0,37,222,259,259,True
2399,2011-04-14,2,0,4,20,0,4,1,1,0.5,0.4848,0.51,0.194,22,147,169,169,True
2400,2011-04-14,2,0,4,21,0,4,1,1,0.46,0.4545,0.63,0.1343,19,126,145,145,True
2401,2011-04-14,2,0,4,22,0,4,1,1,0.48,0.4697,0.55,0.1045,22,82,104,104,True
2402,2011-04-14,2,0,4,23,0,4,1,1,0.46,0.4545,0.59,0.1045,7,40,47,47,True
2403,2011-04-15,2,0,4,0,1,5,0,1,0.44,0.4394,0.67,0.0,6,21,27,27,True
2404,2011-04-15,2,0,4,1,1,5,0,1,0.44,0.4394,0.62,0.0,6,9,15,15,True
2405,2011-04-15,2,0,4,2,1,5,0,1,0.4,0.4091,0.76,0.0,8,10,18,18,True
2406,2011-04-15,2,0,4,3,1,5,0,1,0.4,0.4091,0.76,0.0,0,3,3,3,True
2407,2011-04-15,2,0,4,4,1,5,0,1,0.38,0.3939,0.82,0.0896,0,3,3,3,True
2408,2011-04-15,2,0,4,5,1,5,0,1,0.36,0.3636,0.81,0.1045,2,11,13,13,True
2409,2011-04-15,2,0,4,6,1,5,0,1,0.36,0.3636,0.81,0.0896,5,42,47,47,True
2410,2011-04-15,2,0,4,7,1,5,0,1,0.4,0.4091,0.71,0.1642,10,139,149,149,True
2411,2011-04-15,2,0,4,8,1,5,0,1,0.44,0.4394,0.62,0.2985,21,279,300,300,True
2412,2011-04-15,2,0,4,9,1,5,0,1,0.5,0.4848,0.55,0.194,16,162,178,178,True
2413,2011-04-15,2,0,4,10,1,5,0,1,0.5,0.4848,0.55,0.194,31,91,122,122,True
2414,2011-04-15,2,0,4,11,1,5,0,1,0.52,0.5,0.55,0.194,41,95,136,136,True
2415,2011-04-15,2,0,4,12,1,5,0,1,0.52,0.5,0.55,0.2836,45,155,200,200,True
2416,2011-04-15,2,0,4,13,1,5,0,1,0.54,0.5152,0.52,0.2537,47,133,180,180,True
2417,2011-04-15,2,0,4,14,1,5,0,1,0.54,0.5152,0.52,0.2537,57,106,163,163,True
2418,2011-04-15,2,0,4,15,1,5,0,1,0.54,0.5152,0.52,0.4478,50,112,162,162,True
2419,2011-04-15,2,0,4,16,1,5,0,1,0.52,0.5,0.55,0.4775,70,173,243,243,True
2420,2011-04-15,2,0,4,17,1,5,0,2,0.5,0.4848,0.63,0.3881,64,267,331,331,True
2421,2011-04-15,2,0,4,18,1,5,0,2,0.46,0.4545,0.67,0.3881,47,216,263,263,True
2422,2011-04-15,2,0,4,19,1,5,0,1,0.42,0.4242,0.77,0.3881,41,168,209,209,True
2423,2011-04-15,2,0,4,20,1,5,0,2,0.4,0.4091,0.76,0.3284,26,92,118,118,True
2424,2011-04-15,2,0,4,21,1,5,0,2,0.4,0.4091,0.76,0.2985,25,77,102,102,True
2425,2011-04-15,2,0,4,22,1,5,0,2,0.38,0.3939,0.82,0.3881,16,64,80,80,True
2426,2011-04-15,2,0,4,23,1,5,0,2,0.36,0.3485,0.81,0.194,8,56,64,64,True
2427,2011-04-16,2,0,4,0,0,6,0,2,0.36,0.3485,0.81,0.2239,7,36,43,43,True
2428,2011-04-16,2,0,4,1,0,6,0,2,0.36,0.3333,0.87,0.2836,5,28,33,33,True
2429,2011-04-16,2,0,4,2,0,6,0,2,0.36,0.3485,0.87,0.1343,5,19,24,24,True
2430,2011-04-16,2,0,4,3,0,6,0,2,0.36,0.3485,0.87,0.1642,5,9,14,14,True
2431,2011-04-16,2,0,4,4,0,6,0,2,0.36,0.3485,0.87,0.2239,1,4,5,5,True
2432,2011-04-16,2,0,4,5,0,6,0,2,0.38,0.3939,0.87,0.2836,1,3,4,4,True
2433,2011-04-16,2,0,4,6,0,6,0,3,0.4,0.4091,0.82,0.3284,1,9,10,10,True
2434,2011-04-16,2,0,4,7,0,6,0,2,0.4,0.4091,0.82,0.4179,3,18,21,21,True
2435,2011-04-16,2,0,4,8,0,6,0,3,0.4,0.4091,0.87,0.3582,7,38,45,45,True
2436,2011-04-16,2,0,4,9,0,6,0,3,0.4,0.4091,1.0,0.2985,2,27,29,29,True
2437,2011-04-16,2,0,4,10,0,6,0,3,0.42,0.4242,0.94,0.3881,1,21,22,22,True
2438,2011-04-16,2,0,4,11,0,6,0,3,0.42,0.4242,0.94,0.4478,4,27,31,31,True
2439,2011-04-16,2,0,4,12,0,6,0,2,0.46,0.4545,0.88,0.4775,6,26,32,32,True
2440,2011-04-16,2,0,4,13,0,6,0,3,0.46,0.4545,0.94,0.4775,9,49,58,58,True
2441,2011-04-16,2,0,4,14,0,6,0,3,0.52,0.5,0.83,0.4775,14,49,63,63,True
2442,2011-04-16,2,0,4,15,0,6,0,3,0.52,0.5,0.83,0.4775,16,62,78,78,True
2443,2011-04-16,2,0,4,16,0,6,0,3,0.5,0.4848,0.88,0.4627,6,27,33,33,True
2444,2011-04-16,2,0,4,17,0,6,0,3,0.5,0.4848,0.88,0.4775,1,14,15,15,True
2445,2011-04-16,2,0,4,18,0,6,0,2,0.5,0.4848,0.94,0.3881,6,32,38,38,True
2446,2011-04-16,2,0,4,19,0,6,0,2,0.52,0.5,0.94,0.4179,9,62,71,71,True
2447,2011-04-16,2,0,4,20,0,6,0,3,0.44,0.4394,0.94,0.2239,4,49,53,53,True
2448,2011-04-16,2,0,4,21,0,6,0,2,0.44,0.4394,0.94,0.0,1,13,14,14,True
2449,2011-04-16,2,0,4,22,0,6,0,3,0.42,0.4242,1.0,0.0,2,22,24,24,True
2450,2011-04-16,2,0,4,23,0,6,0,2,0.44,0.4394,0.77,0.2836,5,30,35,35,True
2451,2011-04-17,2,0,4,0,0,0,0,2,0.44,0.4394,0.77,0.2836,4,29,33,33,True
2452,2011-04-17,2,0,4,1,0,0,0,1,0.42,0.4242,0.67,0.2239,6,25,31,31,True
2453,2011-04-17,2,0,4,2,0,0,0,1,0.4,0.4091,0.62,0.194,4,25,29,29,True
2454,2011-04-17,2,0,4,3,0,0,0,1,0.4,0.4091,0.66,0.1343,12,13,25,25,True
2455,2011-04-17,2,0,4,4,0,0,0,1,0.36,0.3636,0.76,0.1045,2,5,7,7,True
2456,2011-04-17,2,0,4,5,0,0,0,1,0.36,0.3485,0.71,0.1642,2,1,3,3,True
2457,2011-04-17,2,0,4,6,0,0,0,1,0.36,0.3182,0.66,0.4478,3,5,8,8,True
2458,2011-04-17,2,0,4,7,0,0,0,1,0.36,0.3333,0.5,0.3582,2,14,16,16,True
2459,2011-04-17,2,0,4,8,0,0,0,1,0.38,0.3939,0.46,0.3881,7,36,43,43,True
2460,2011-04-17,2,0,4,9,0,0,0,1,0.4,0.4091,0.43,0.2836,31,71,102,102,True
2461,2011-04-17,2,0,4,10,0,0,0,1,0.42,0.4242,0.44,0.4478,91,120,211,211,True
2462,2011-04-17,2,0,4,11,0,0,0,1,0.46,0.4545,0.41,0.4179,114,185,299,299,True
2463,2011-04-17,2,0,4,12,0,0,0,1,0.46,0.4545,0.38,0.3881,114,187,301,301,True
2464,2011-04-17,2,0,4,13,0,0,0,1,0.5,0.4848,0.34,0.3881,114,162,276,276,True
2465,2011-04-17,2,0,4,14,0,0,0,1,0.52,0.5,0.34,0.3881,114,191,305,305,True
2466,2011-04-17,2,0,4,15,0,0,0,1,0.54,0.5152,0.32,0.4775,114,209,323,323,True
2467,2011-04-17,2,0,4,16,0,0,0,1,0.54,0.5152,0.3,0.3582,114,182,296,296,True
2468,2011-04-17,2,0,4,17,0,0,0,1,0.56,0.5303,0.3,0.4478,114,163,277,277,True
2469,2011-04-17,2,0,4,18,0,0,0,1,0.56,0.5303,0.3,0.3881,102,175,277,277,True
2470,2011-04-17,2,0,4,19,0,0,0,1,0.56,0.5303,0.3,0.2985,75,135,210,210,True
2471,2011-04-17,2,0,4,20,0,0,0,1,0.52,0.5,0.36,0.194,44,97,141,141,True
2472,2011-04-17,2,0,4,21,0,0,0,1,0.5,0.4848,0.42,0.194,13,70,83,83,True
2473,2011-04-17,2,0,4,22,0,0,0,1,0.5,0.4848,0.39,0.1045,21,49,70,70,True
2474,2011-04-17,2,0,4,23,0,0,0,1,0.44,0.4394,0.67,0.1642,19,37,56,56,True
2475,2011-04-18,2,0,4,0,0,1,1,1,0.46,0.4545,0.47,0.0896,15,24,39,39,True
2476,2011-04-18,2,0,4,1,0,1,1,1,0.46,0.4545,0.47,0.1343,11,8,19,19,True
2477,2011-04-18,2,0,4,2,0,1,1,1,0.42,0.4242,0.67,0.1045,14,2,16,16,True
2478,2011-04-18,2,0,4,3,0,1,1,1,0.42,0.4242,0.62,0.1045,6,1,7,7,True
2479,2011-04-18,2,0,4,4,0,1,1,1,0.4,0.4091,0.87,0.1642,2,4,6,6,True
2480,2011-04-18,2,0,4,5,0,1,1,1,0.4,0.4091,0.76,0.0896,0,16,16,16,True
2481,2011-04-18,2,0,4,6,0,1,1,1,0.4,0.4091,0.82,0.0,3,51,54,54,True
2482,2011-04-18,2,0,4,7,0,1,1,1,0.46,0.4545,0.63,0.0,12,156,168,168,True
2483,2011-04-18,2,0,4,8,0,1,1,1,0.46,0.4545,0.63,0.0,20,277,297,297,True
2484,2011-04-18,2,0,4,9,0,1,1,2,0.5,0.4848,0.55,0.1045,37,132,169,169,True
2485,2011-04-18,2,0,4,10,0,1,1,2,0.52,0.5,0.55,0.1045,41,68,109,109,True
2486,2011-04-18,2,0,4,11,0,1,1,2,0.54,0.5152,0.52,0.0896,36,87,123,123,True
2487,2011-04-18,2,0,4,12,0,1,1,2,0.56,0.5303,0.49,0.0896,60,124,184,184,True
2488,2011-04-18,2,0,4,13,0,1,1,2,0.56,0.5303,0.49,0.1642,41,128,169,169,True
2489,2011-04-18,2,0,4,14,0,1,1,2,0.58,0.5455,0.49,0.194,49,95,144,144,True
2490,2011-04-18,2,0,4,15,0,1,1,2,0.6,0.6212,0.43,0.194,64,112,176,176,True
2491,2011-04-18,2,0,4,16,0,1,1,1,0.6,0.6212,0.46,0.2836,40,165,205,205,True
2492,2011-04-18,2,0,4,17,0,1,1,1,0.58,0.5455,0.49,0.2836,66,362,428,428,True
2493,2011-04-18,2,0,4,18,0,1,1,1,0.64,0.6212,0.31,0.3582,41,321,362,362,True
2494,2011-04-18,2,0,4,19,0,1,1,1,0.56,0.5303,0.46,0.2537,42,244,286,286,True
2495,2011-04-18,2,0,4,20,0,1,1,1,0.6,0.6212,0.33,0.2985,29,136,165,165,True
2496,2011-04-18,2,0,4,21,0,1,1,1,0.56,0.5303,0.37,0.2836,20,131,151,151,True
2497,2011-04-18,2,0,4,22,0,1,1,1,0.52,0.5,0.55,0.2836,9,81,90,90,True
2498,2011-04-18,2,0,4,23,0,1,1,1,0.5,0.4848,0.59,0.2537,11,35,46,46,True
2499,2011-04-19,2,0,4,0,0,2,1,1,0.5,0.4848,0.55,0.2239,2,23,25,25,True
2500,2011-04-19,2,0,4,1,0,2,1,1,0.46,0.4545,0.63,0.2239,5,2,7,7,True
2501,2011-04-19,2,0,4,2,0,2,1,1,0.46,0.4545,0.67,0.2836,8,5,13,13,True
2502,2011-04-19,2,0,4,3,0,2,1,1,0.48,0.4697,0.63,0.2239,0,3,3,3,True
2503,2011-04-19,2,0,4,4,0,2,1,1,0.46,0.4545,0.67,0.0896,1,4,5,5,True
2504,2011-04-19,2,0,4,5,0,2,1,2,0.46,0.4545,0.72,0.194,1,17,18,18,True
2505,2011-04-19,2,0,4,6,0,2,1,2,0.48,0.4697,0.67,0.0,2,63,65,65,True
2506,2011-04-19,2,0,4,7,0,2,1,2,0.52,0.5,0.55,0.0,22,166,188,188,True
2507,2011-04-19,2,0,4,8,0,2,1,2,0.5,0.4848,0.68,0.1343,20,331,351,351,True
2508,2011-04-19,2,0,4,9,0,2,1,3,0.52,0.5,0.63,0.0896,23,139,162,162,True
2509,2011-04-19,2,0,4,10,0,2,1,2,0.5,0.4848,0.72,0.2239,15,60,75,75,True
2510,2011-04-19,2,0,4,11,0,2,1,2,0.54,0.5152,0.68,0.1642,19,53,72,72,True
2511,2011-04-19,2,0,4,12,0,2,1,2,0.54,0.5152,0.64,0.0896,19,84,103,103,True
2512,2011-04-19,2,0,4,13,0,2,1,2,0.54,0.5152,0.68,0.2239,26,103,129,129,True
2513,2011-04-19,2,0,4,14,0,2,1,2,0.54,0.5152,0.64,0.194,19,88,107,107,True
2514,2011-04-19,2,0,4,15,0,2,1,2,0.54,0.5152,0.65,0.1642,44,83,127,127,True
2515,2011-04-19,2,0,4,16,0,2,1,1,0.56,0.5303,0.52,0.2985,30,162,192,192,True
2516,2011-04-19,2,0,4,17,0,2,1,1,0.56,0.5303,0.6,0.1045,39,372,411,411,True
2517,2011-04-19,2,0,4,18,0,2,1,2,0.54,0.5152,0.64,0.1343,44,377,421,421,True
2518,2011-04-19,2,0,4,19,0,2,1,2,0.5,0.4848,0.72,0.194,28,248,276,276,True
2519,2011-04-19,2,0,4,20,0,2,1,2,0.5,0.4848,0.72,0.2239,20,148,168,168,True
2520,2011-04-19,2,0,4,21,0,2,1,2,0.5,0.4848,0.72,0.1343,8,114,122,122,True
2521,2011-04-19,2,0,4,22,0,2,1,1,0.48,0.4697,0.77,0.0896,3,109,112,112,True
2522,2011-04-19,2,0,4,23,0,2,1,1,0.46,0.4545,0.88,0.0896,11,41,52,52,True
2523,2011-04-20,2,0,4,0,0,3,1,1,0.44,0.4394,0.88,0.1343,4,29,33,33,True
2524,2011-04-20,2,0,4,1,0,3,1,1,0.42,0.4242,0.94,0.1642,2,5,7,7,True
2525,2011-04-20,2,0,4,2,0,3,1,1,0.42,0.4242,0.94,0.1642,0,2,2,2,True
2526,2011-04-20,2,0,4,3,0,3,1,1,0.42,0.4242,0.94,0.0,0,2,2,2,True
2527,2011-04-20,2,0,4,4,0,3,1,1,0.4,0.4091,1.0,0.1045,5,4,9,9,True
2528,2011-04-20,2,0,4,5,0,3,1,1,0.4,0.4091,0.94,0.194,1,14,15,15,True
2529,2011-04-20,2,0,4,6,0,3,1,1,0.42,0.4242,0.94,0.1642,2,62,64,64,True
2530,2011-04-20,2,0,4,7,0,3,1,1,0.44,0.4394,0.94,0.0,26,211,237,237,True
2531,2011-04-20,2,0,4,8,0,3,1,1,0.62,0.6061,0.69,0.4627,22,374,396,396,True
2532,2011-04-20,2,0,4,9,0,3,1,1,0.66,0.6212,0.61,0.2836,27,170,197,197,True
2533,2011-04-20,2,0,4,10,0,3,1,1,0.62,0.6061,0.69,0.0896,45,86,131,131,True
2534,2011-04-20,2,0,4,11,0,3,1,1,0.62,0.6061,0.69,0.0896,31,87,118,118,True
2535,2011-04-20,2,0,4,12,0,3,1,1,0.7,0.6515,0.48,0.3881,28,117,145,145,True
2536,2011-04-20,2,0,4,13,0,3,1,1,0.7,0.6515,0.48,0.3881,42,135,177,177,True
2537,2011-04-20,2,0,4,14,0,3,1,1,0.74,0.6515,0.4,0.4627,33,115,148,148,True
2538,2011-04-20,2,0,4,15,0,3,1,2,0.76,0.6667,0.35,0.3582,32,113,145,145,True
2539,2011-04-20,2,0,4,16,0,3,1,2,0.76,0.6667,0.35,0.3582,54,201,255,255,True
2540,2011-04-20,2,0,4,17,0,3,1,2,0.74,0.6515,0.37,0.4179,34,398,432,432,True
2541,2011-04-20,2,0,4,18,0,3,1,1,0.74,0.6515,0.3,0.3582,56,385,441,441,True
2542,2011-04-20,2,0,4,19,0,3,1,1,0.7,0.6364,0.32,0.2537,74,309,383,383,True
2543,2011-04-20,2,0,4,20,0,3,1,1,0.68,0.6212,0.32,0.1045,31,194,225,225,True
2544,2011-04-20,2,0,4,21,0,3,1,1,0.66,0.6212,0.36,0.2836,38,134,172,172,True
2545,2011-04-20,2,0,4,22,0,3,1,1,0.62,0.6212,0.41,0.2537,12,105,117,117,True
2546,2011-04-20,2,0,4,23,0,3,1,1,0.6,0.6212,0.4,0.3284,14,79,93,93,True
2547,2011-04-21,2,0,4,0,0,4,1,1,0.56,0.5303,0.43,0.3582,11,33,44,44,True
2548,2011-04-21,2,0,4,1,0,4,1,1,0.52,0.5,0.45,0.2239,6,20,26,26,True
2549,2011-04-21,2,0,4,2,0,4,1,1,0.5,0.4848,0.42,0.3881,3,10,13,13,True
2550,2011-04-21,2,0,4,3,0,4,1,2,0.46,0.4545,0.51,0.4627,4,3,7,7,True
2551,2011-04-21,2,0,4,4,0,4,1,2,0.44,0.4394,0.54,0.4478,2,4,6,6,True
2552,2011-04-21,2,0,4,5,0,4,1,2,0.42,0.4242,0.54,0.4775,0,14,14,14,True
2553,2011-04-21,2,0,4,6,0,4,1,2,0.4,0.4091,0.58,0.4775,2,73,75,75,True
2554,2011-04-21,2,0,4,7,0,4,1,2,0.42,0.4242,0.47,0.4627,15,183,198,198,True
2555,2011-04-21,2,0,4,8,0,4,1,2,0.4,0.4091,0.5,0.4775,19,346,365,365,True
2556,2011-04-21,2,0,4,9,0,4,1,2,0.42,0.4242,0.47,0.2836,18,178,196,196,True
2557,2011-04-21,2,0,4,10,0,4,1,1,0.42,0.4242,0.44,0.3582,25,73,98,98,True
2558,2011-04-21,2,0,4,11,0,4,1,1,0.44,0.4394,0.41,0.2836,34,99,133,133,True
2559,2011-04-21,2,0,4,12,0,4,1,1,0.46,0.4545,0.38,0.1642,49,150,199,199,True
2560,2011-04-21,2,0,4,13,0,4,1,1,0.48,0.4697,0.33,0.3284,55,122,177,177,True
2561,2011-04-21,2,0,4,14,0,4,1,1,0.5,0.4848,0.34,0.3881,68,160,228,228,True
2562,2011-04-21,2,0,4,15,0,4,1,1,0.52,0.5,0.29,0.4179,69,166,235,235,True
2563,2011-04-21,2,0,4,16,0,4,1,1,0.52,0.5,0.27,0.3582,66,228,294,294,True
2564,2011-04-21,2,0,4,17,0,4,1,1,0.5,0.4848,0.29,0.1642,79,402,481,481,True
2565,2011-04-21,2,0,4,18,0,4,1,1,0.5,0.4848,0.25,0.2836,71,381,452,452,True
2566,2011-04-21,2,0,4,19,0,4,1,1,0.46,0.4545,0.28,0.2836,52,272,324,324,True
2567,2011-04-21,2,0,4,20,0,4,1,1,0.44,0.4394,0.3,0.1343,28,176,204,204,True
2568,2011-04-21,2,0,4,21,0,4,1,1,0.42,0.4242,0.47,0.194,25,159,184,184,True
2569,2011-04-21,2,0,4,22,0,4,1,1,0.42,0.4242,0.38,0.0896,31,106,137,137,True
2570,2011-04-21,2,0,4,23,0,4,1,1,0.4,0.4091,0.43,0.1045,13,86,99,99,True
2571,2011-04-22,2,0,4,0,0,5,1,1,0.36,0.3485,0.62,0.194,3,30,33,33,True
2572,2011-04-22,2,0,4,1,0,5,1,1,0.36,0.3333,0.53,0.2537,2,22,24,24,True
2573,2011-04-22,2,0,4,2,0,5,1,1,0.36,0.3333,0.53,0.2985,2,7,9,9,True
2574,2011-04-22,2,0,4,3,0,5,1,1,0.36,0.3333,0.53,0.2985,0,2,2,2,True
2575,2011-04-22,2,0,4,4,0,5,1,1,0.34,0.3182,0.53,0.2836,1,2,3,3,True
2576,2011-04-22,2,0,4,5,0,5,1,1,0.34,0.3182,0.53,0.2239,0,16,16,16,True
2577,2011-04-22,2,0,4,6,0,5,1,1,0.34,0.3182,0.53,0.2836,2,47,49,49,True
2578,2011-04-22,2,0,4,7,0,5,1,2,0.34,0.3182,0.53,0.2836,5,175,180,180,True
2579,2011-04-22,2,0,4,8,0,5,1,2,0.34,0.3182,0.53,0.2537,15,331,346,346,True
2580,2011-04-22,2,0,4,9,0,5,1,3,0.34,0.303,0.61,0.2985,17,178,195,195,True
2581,2011-04-22,2,0,4,10,0,5,1,2,0.36,0.3485,0.62,0.194,32,104,136,136,True
2582,2011-04-22,2,0,4,11,0,5,1,3,0.34,0.3333,0.66,0.194,23,83,106,106,True
2583,2011-04-22,2,0,4,12,0,5,1,3,0.34,0.3333,0.76,0.1343,19,61,80,80,True
2584,2011-04-22,2,0,4,13,0,5,1,3,0.34,0.3333,0.87,0.194,3,37,40,40,True
2585,2011-04-22,2,0,4,14,0,5,1,3,0.34,0.3182,0.87,0.2537,3,33,36,36,True
2586,2011-04-22,2,0,4,15,0,5,1,3,0.34,0.3333,0.87,0.194,13,62,75,75,True
2587,2011-04-22,2,0,4,16,0,5,1,3,0.34,0.3333,0.87,0.1343,4,58,62,62,True
2588,2011-04-22,2,0,4,17,0,5,1,3,0.32,0.303,0.93,0.2239,6,63,69,69,True
2589,2011-04-22,2,0,4,18,0,5,1,3,0.32,0.303,0.93,0.2239,4,47,51,51,True
2590,2011-04-22,2,0,4,19,0,5,1,3,0.32,0.303,0.93,0.2239,7,48,55,55,True
2591,2011-04-22,2,0,4,20,0,5,1,3,0.32,0.303,0.87,0.2239,8,39,47,47,True
2592,2011-04-22,2,0,4,21,0,5,1,3,0.3,0.303,0.93,0.1642,5,23,28,28,True
2593,2011-04-22,2,0,4,22,0,5,1,3,0.3,0.303,1.0,0.1343,3,21,24,24,True
2594,2011-04-22,2,0,4,23,0,5,1,3,0.32,0.3333,0.93,0.1045,0,17,17,17,True
2595,2011-04-23,2,0,4,0,0,6,0,2,0.32,0.3182,1.0,0.194,0,18,18,18,True
2596,2011-04-23,2,0,4,1,0,6,0,2,0.32,0.3182,1.0,0.194,5,11,16,16,True
2597,2011-04-23,2,0,4,2,0,6,0,3,0.32,0.3333,1.0,0.1343,3,14,17,17,True
2598,2011-04-23,2,0,4,3,0,6,0,3,0.32,0.3333,1.0,0.0896,0,4,4,4,True
2599,2011-04-23,2,0,4,4,0,6,0,3,0.34,0.3636,1.0,0.0,2,3,5,5,True
2600,2011-04-23,2,0,4,5,0,6,0,3,0.34,0.3636,1.0,0.0,1,6,7,7,True
2601,2011-04-23,2,0,4,6,0,6,0,2,0.34,0.3333,1.0,0.1642,0,11,11,11,True
2602,2011-04-23,2,0,4,7,0,6,0,3,0.34,0.3333,1.0,0.1642,2,17,19,19,True
2603,2011-04-23,2,0,4,8,0,6,0,2,0.36,0.3333,1.0,0.2537,15,32,47,47,True
2604,2011-04-23,2,0,4,9,0,6,0,2,0.38,0.3939,0.94,0.2985,13,55,68,68,True
2605,2011-04-23,2,0,4,10,0,6,0,2,0.42,0.4242,0.88,0.2239,36,93,129,129,True
2606,2011-04-23,2,0,4,11,0,6,0,2,0.46,0.4545,0.88,0.2239,68,164,232,232,True
2607,2011-04-23,2,0,4,12,0,6,0,1,0.52,0.5,0.83,0.4179,94,197,291,291,True
2608,2011-04-23,2,0,4,13,0,6,0,1,0.52,0.5,0.83,0.3881,114,186,300,300,True
2609,2011-04-23,2,0,4,14,0,6,0,1,0.58,0.5455,0.78,0.3582,114,209,323,323,True
2610,2011-04-23,2,0,4,15,0,6,0,1,0.6,0.5909,0.73,0.3881,114,226,340,340,True
2611,2011-04-23,2,0,4,16,0,6,0,1,0.6,0.5909,0.73,0.2836,114,246,360,360,True
2612,2011-04-23,2,0,4,17,0,6,0,1,0.6,0.5909,0.73,0.3284,114,215,329,329,True
2613,2011-04-23,2,0,4,18,0,6,0,1,0.58,0.5455,0.78,0.194,114,227,341,341,True
2614,2011-04-23,2,0,4,19,0,6,0,1,0.56,0.5303,0.83,0.2836,84,199,283,283,True
2615,2011-04-23,2,0,4,20,0,6,0,2,0.54,0.5152,0.88,0.2537,45,138,183,183,True
2616,2011-04-23,2,0,4,21,0,6,0,2,0.56,0.5303,0.83,0.2836,32,103,135,135,True
2617,2011-04-23,2,0,4,22,0,6,0,2,0.58,0.5455,0.78,0.2537,55,114,169,169,True
2618,2011-04-23,2,0,4,23,0,6,0,2,0.54,0.5152,0.88,0.1642,31,86,117,117,True
2619,2011-04-24,2,0,4,0,0,0,0,1,0.52,0.5,0.83,0.2239,30,66,96,96,True
2620,2011-04-24,2,0,4,1,0,0,0,1,0.5,0.4848,0.88,0.194,14,40,54,54,True
2621,2011-04-24,2,0,4,2,0,0,0,1,0.5,0.4848,0.88,0.194,27,45,72,72,True
2622,2011-04-24,2,0,4,3,0,0,0,1,0.5,0.4848,0.94,0.0896,4,20,24,24,True
2623,2011-04-24,2,0,4,4,0,0,0,1,0.5,0.4848,0.94,0.0896,0,5,5,5,True
2624,2011-04-24,2,0,4,5,0,0,0,1,0.5,0.4848,0.94,0.0896,5,7,12,12,True
2625,2011-04-24,2,0,4,6,0,0,0,2,0.5,0.4848,1.0,0.0,10,3,13,13,True
2626,2011-04-24,2,0,4,7,0,0,0,2,0.5,0.4848,1.0,0.0,16,11,27,27,True
2627,2011-04-24,2,0,4,8,0,0,0,1,0.52,0.5,0.94,0.2239,38,42,80,80,True
2628,2011-04-24,2,0,4,9,0,0,0,1,0.56,0.5303,0.88,0.2537,73,104,177,177,True
2629,2011-04-24,2,0,4,10,0,0,0,1,0.6,0.5758,0.78,0.1642,114,171,285,285,True
2630,2011-04-24,2,0,4,11,0,0,0,1,0.66,0.6212,0.65,0.1343,114,193,307,307,True
2631,2011-04-24,2,0,4,12,0,0,0,1,0.68,0.6364,0.65,0.2537,114,220,334,334,True
2632,2011-04-24,2,0,4,13,0,0,0,1,0.7,0.6515,0.58,0.2836,114,236,350,350,True
2633,2011-04-24,2,0,4,14,0,0,0,1,0.7,0.6515,0.54,0.3284,114,223,337,337,True
2634,2011-04-24,2,0,4,15,0,0,0,1,0.66,0.6212,0.61,0.2537,114,202,316,316,True
2635,2011-04-24,2,0,4,16,0,0,0,1,0.74,0.6667,0.48,0.3881,114,197,311,311,True
2636,2011-04-24,2,0,4,17,0,0,0,1,0.66,0.6212,0.65,0.2985,114,189,303,303,True
2637,2011-04-24,2,0,4,18,0,0,0,1,0.64,0.6061,0.69,0.1642,96,174,270,270,True
2638,2011-04-24,2,0,4,19,0,0,0,3,0.6,0.5606,0.83,0.2836,62,132,194,194,True
2639,2011-04-24,2,0,4,20,0,0,0,3,0.6,0.5606,0.83,0.2836,34,71,105,105,True
2640,2011-04-24,2,0,4,21,0,0,0,3,0.54,0.5152,0.94,0.1642,8,53,61,61,True
2641,2011-04-24,2,0,4,22,0,0,0,3,0.54,0.5152,1.0,0.1642,5,40,45,45,True
2642,2011-04-24,2,0,4,23,0,0,0,3,0.54,0.5152,1.0,0.0896,5,37,42,42,True
2643,2011-04-25,2,0,4,0,0,1,1,3,0.52,0.5,1.0,0.0,2,10,12,12,True
2644,2011-04-25,2,0,4,1,0,1,1,1,0.54,0.5152,1.0,0.0896,2,8,10,10,True
2645,2011-04-25,2,0,4,2,0,1,1,1,0.54,0.5152,1.0,0.0896,1,9,10,10,True
2646,2011-04-25,2,0,4,3,0,1,1,2,0.5,0.4848,1.0,0.1045,2,8,10,10,True
2647,2011-04-25,2,0,4,4,0,1,1,2,0.52,0.5,1.0,0.0,1,4,5,5,True
2648,2011-04-25,2,0,4,5,0,1,1,2,0.46,0.4545,1.0,0.0,3,14,17,17,True
2649,2011-04-25,2,0,4,6,0,1,1,2,0.5,0.4848,1.0,0.0,7,59,66,66,True
2650,2011-04-25,2,0,4,7,0,1,1,2,0.52,0.5,1.0,0.0896,13,183,196,196,True
2651,2011-04-25,2,0,4,8,0,1,1,1,0.56,0.5303,0.88,0.1045,27,326,353,353,True
2652,2011-04-25,2,0,4,9,0,1,1,1,0.6,0.5606,0.83,0.1343,27,147,174,174,True
2653,2011-04-25,2,0,4,10,0,1,1,1,0.64,0.6061,0.73,0.2239,61,64,125,125,True
2654,2011-04-25,2,0,4,11,0,1,1,1,0.64,0.6061,0.73,0.2239,53,94,147,147,True
2655,2011-04-25,2,0,4,12,0,1,1,1,0.66,0.6212,0.74,0.2537,48,140,188,188,True
2656,2011-04-25,2,0,4,13,0,1,1,1,0.7,0.6515,0.65,0.2239,57,146,203,203,True
2657,2011-04-25,2,0,4,14,0,1,1,1,0.72,0.6667,0.54,0.2239,47,99,146,146,True
2658,2011-04-25,2,0,4,15,0,1,1,1,0.74,0.6667,0.51,0.2239,50,125,175,175,True
2659,2011-04-25,2,0,4,16,0,1,1,1,0.7,0.6515,0.54,0.3582,41,198,239,239,True
2660,2011-04-25,2,0,4,17,0,1,1,1,0.7,0.6515,0.54,0.2985,80,441,521,521,True
2661,2011-04-25,2,0,4,18,0,1,1,1,0.68,0.6364,0.57,0.3582,74,425,499,499,True
2662,2011-04-25,2,0,4,19,0,1,1,1,0.66,0.6212,0.57,0.3284,62,320,382,382,True
2663,2011-04-25,2,0,4,20,0,1,1,1,0.66,0.6212,0.61,0.2836,42,195,237,237,True
2664,2011-04-25,2,0,4,21,0,1,1,1,0.62,0.6061,0.69,0.2537,41,149,190,190,True
2665,2011-04-25,2,0,4,22,0,1,1,1,0.6,0.5909,0.73,0.2985,23,83,106,106,True
2666,2011-04-25,2,0,4,23,0,1,1,1,0.58,0.5455,0.78,0.2836,9,53,62,62,True
2667,2011-04-26,2,0,4,0,0,2,1,1,0.62,0.6061,0.69,0.2836,10,17,27,27,True
2668,2011-04-26,2,0,4,1,0,2,1,1,0.62,0.5909,0.73,0.2836,16,5,21,21,True
2669,2011-04-26,2,0,4,2,0,2,1,1,0.56,0.5303,0.83,0.3284,17,9,26,26,True
2670,2011-04-26,2,0,4,3,0,2,1,1,0.54,0.5152,0.88,0.2836,17,4,21,21,True
2671,2011-04-26,2,0,4,4,0,2,1,1,0.56,0.5303,0.83,0.2537,2,4,6,6,True
2672,2011-04-26,2,0,4,5,0,2,1,1,0.54,0.5152,0.88,0.2537,0,16,16,16,True
2673,2011-04-26,2,0,4,6,0,2,1,1,0.56,0.5303,0.88,0.2239,0,80,80,80,True
2674,2011-04-26,2,0,4,7,0,2,1,1,0.58,0.5455,0.83,0.2985,16,254,270,270,True
2675,2011-04-26,2,0,4,8,0,2,1,1,0.58,0.5455,0.83,0.2985,32,417,449,449,True
2676,2011-04-26,2,0,4,9,0,2,1,1,0.64,0.6061,0.73,0.3582,35,164,199,199,True
2677,2011-04-26,2,0,4,10,0,2,1,1,0.66,0.6212,0.69,0.3582,22,98,120,120,True
2678,2011-04-26,2,0,4,11,0,2,1,1,0.68,0.6364,0.65,0.3881,40,132,172,172,True
2679,2011-04-26,2,0,4,12,0,2,1,1,0.7,0.6515,0.61,0.4179,40,146,186,186,True
2680,2011-04-26,2,0,4,13,0,2,1,1,0.74,0.6667,0.51,0.4478,37,139,176,176,True
2681,2011-04-26,2,0,4,14,0,2,1,1,0.72,0.6667,0.58,0.3284,40,115,155,155,True
2682,2011-04-26,2,0,4,15,0,2,1,1,0.7,0.6515,0.61,0.3582,34,119,153,153,True
2683,2011-04-26,2,0,4,16,0,2,1,1,0.7,0.6515,0.58,0.3881,40,251,291,291,True
2684,2011-04-26,2,0,4,17,0,2,1,1,0.68,0.6364,0.61,0.3582,66,455,521,521,True
2685,2011-04-26,2,0,4,18,0,2,1,1,0.68,0.6364,0.65,0.4478,65,463,528,528,True
2686,2011-04-26,2,0,4,19,0,2,1,1,0.64,0.6061,0.73,0.4179,42,286,328,328,True
2687,2011-04-26,2,0,4,20,0,2,1,1,0.64,0.6061,0.73,0.3582,35,199,234,234,True
2688,2011-04-26,2,0,4,21,0,2,1,1,0.62,0.5909,0.78,0.2836,33,162,195,195,True
2689,2011-04-26,2,0,4,22,0,2,1,2,0.6,0.5606,0.83,0.194,32,116,148,148,True
2690,2011-04-26,2,0,4,23,0,2,1,2,0.6,0.5606,0.83,0.2239,7,71,78,78,True
2691,2011-04-27,2,0,4,0,0,3,1,1,0.6,0.5606,0.83,0.2239,3,24,27,27,True
2692,2011-04-27,2,0,4,1,0,3,1,1,0.6,0.5606,0.83,0.2537,2,15,17,17,True
2693,2011-04-27,2,0,4,2,0,3,1,1,0.58,0.5455,0.88,0.2537,0,5,5,5,True
2694,2011-04-27,2,0,4,3,0,3,1,2,0.58,0.5455,0.88,0.2836,3,4,7,7,True
2695,2011-04-27,2,0,4,4,0,3,1,1,0.56,0.5303,0.94,0.2239,0,6,6,6,True
2696,2011-04-27,2,0,4,5,0,3,1,2,0.56,0.5303,0.94,0.2537,1,16,17,17,True
2697,2011-04-27,2,0,4,6,0,3,1,1,0.56,0.5303,0.94,0.2537,5,79,84,84,True
2698,2011-04-27,2,0,4,7,0,3,1,2,0.58,0.5455,0.88,0.2836,17,229,246,246,True
2699,2011-04-27,2,0,4,8,0,3,1,2,0.58,0.5455,0.88,0.3284,31,413,444,444,True
2700,2011-04-27,2,0,4,9,0,3,1,2,0.6,0.5455,0.88,0.4179,20,161,181,181,True
2701,2011-04-27,2,0,4,10,0,3,1,2,0.62,0.5758,0.83,0.2836,26,66,92,92,True
2702,2011-04-27,2,0,4,11,0,3,1,2,0.64,0.5909,0.78,0.2836,53,103,156,156,True
2703,2011-04-27,2,0,4,12,0,3,1,1,0.66,0.6061,0.78,0.3284,38,135,173,173,True
2704,2011-04-27,2,0,4,13,0,3,1,1,0.64,0.5909,0.78,0.2985,31,119,150,150,True
2705,2011-04-27,2,0,4,14,0,3,1,1,0.68,0.6364,0.74,0.2836,29,119,148,148,True
2706,2011-04-27,2,0,4,15,0,3,1,1,0.7,0.6515,0.65,0.4775,18,120,138,138,True
2707,2011-04-27,2,0,4,16,0,3,1,1,0.7,0.6515,0.7,0.3881,29,189,218,218,True
2708,2011-04-27,2,0,4,17,0,3,1,3,0.66,0.6061,0.83,0.3881,63,458,521,521,True
2709,2011-04-27,2,0,4,18,0,3,1,3,0.66,0.6061,0.83,0.3881,46,366,412,412,True
2710,2011-04-27,2,0,4,19,0,3,1,1,0.62,0.5909,0.78,0.2836,40,220,260,260,True
2711,2011-04-27,2,0,4,20,0,3,1,1,0.64,0.5758,0.83,0.3284,30,188,218,218,True
2712,2011-04-27,2,0,4,21,0,3,1,1,0.62,0.5606,0.88,0.2836,19,126,145,145,True
2713,2011-04-27,2,0,4,22,0,3,1,2,0.62,0.5606,0.88,0.3284,18,111,129,129,True
2714,2011-04-27,2,0,4,23,0,3,1,2,0.62,0.5606,0.88,0.3582,25,53,78,78,True
2715,2011-04-28,2,0,4,0,0,4,1,1,0.64,0.5909,0.78,0.3582,13,41,54,54,True
2716,2011-04-28,2,0,4,1,0,4,1,2,0.62,0.5758,0.83,0.3881,8,12,20,20,True
2717,2011-04-28,2,0,4,2,0,4,1,2,0.62,0.5758,0.83,0.4478,14,7,21,21,True
2718,2011-04-28,2,0,4,3,0,4,1,2,0.64,0.5909,0.78,0.3881,2,1,3,3,True
2719,2011-04-28,2,0,4,4,0,4,1,2,0.62,0.5758,0.83,0.4179,4,5,9,9,True
2720,2011-04-28,2,0,4,5,0,4,1,2,0.62,0.5758,0.83,0.3881,0,13,13,13,True
2721,2011-04-28,2,0,4,6,0,4,1,2,0.64,0.5909,0.78,0.4627,7,79,86,86,True
2722,2011-04-28,2,0,4,7,0,4,1,2,0.64,0.5909,0.78,0.4478,14,201,215,215,True
2723,2011-04-28,2,0,4,8,0,4,1,2,0.66,0.6061,0.78,0.4478,31,367,398,398,True
2724,2011-04-28,2,0,4,9,0,4,1,3,0.62,0.5606,0.88,0.3284,18,165,183,183,True
2725,2011-04-28,2,0,4,10,0,4,1,2,0.62,0.5606,0.88,0.2836,9,45,54,54,True
2726,2011-04-28,2,0,4,11,0,4,1,2,0.62,0.5758,0.83,0.2836,10,74,84,84,True
2727,2011-04-28,2,0,4,12,0,4,1,2,0.62,0.5909,0.78,0.2537,23,84,107,107,True
2728,2011-04-28,2,0,4,13,0,4,1,2,0.62,0.5758,0.83,0.2985,18,103,121,121,True
2729,2011-04-28,2,0,4,14,0,4,1,1,0.62,0.5758,0.83,0.2985,21,121,142,142,True
2730,2011-04-28,2,0,4,15,0,4,1,1,0.66,0.6212,0.69,0.3284,46,117,163,163,True
2731,2011-04-28,2,0,4,16,0,4,1,1,0.62,0.5909,0.78,0.2537,42,228,270,270,True
2732,2011-04-28,2,0,4,17,0,4,1,1,0.64,0.6212,0.47,0.3582,49,406,455,455,True
2733,2011-04-28,2,0,4,18,0,4,1,1,0.64,0.6212,0.47,0.3582,44,486,530,530,True
2734,2011-04-28,2,0,4,19,0,4,1,1,0.62,0.6212,0.43,0.2985,57,347,404,404,True
2735,2011-04-28,2,0,4,20,0,4,1,1,0.58,0.5455,0.43,0.2239,49,220,269,269,True
2736,2011-04-28,2,0,4,21,0,4,1,1,0.56,0.5303,0.46,0.1343,27,167,194,194,True
2737,2011-04-28,2,0,4,22,0,4,1,1,0.54,0.5152,0.45,0.1642,34,119,153,153,True
2738,2011-04-28,2,0,4,23,0,4,1,1,0.54,0.5152,0.39,0.0896,29,81,110,110,True
2739,2011-04-29,2,0,4,0,0,5,1,1,0.52,0.5,0.39,0.2836,11,37,48,48,True
2740,2011-04-29,2,0,4,1,0,5,1,1,0.5,0.4848,0.45,0.0896,10,21,31,31,True
2741,2011-04-29,2,0,4,2,0,5,1,1,0.46,0.4545,0.63,0.1045,2,8,10,10,True
2742,2011-04-29,2,0,4,3,0,5,1,1,0.46,0.4545,0.59,0.0896,1,4,5,5,True
2743,2011-04-29,2,0,4,4,0,5,1,1,0.46,0.4545,0.51,0.1343,0,6,6,6,True
2744,2011-04-29,2,0,4,5,0,5,1,1,0.46,0.4545,0.47,0.1343,0,25,25,25,True
2745,2011-04-29,2,0,4,6,0,5,1,1,0.5,0.4848,0.45,0.2836,4,67,71,71,True
2746,2011-04-29,2,0,4,7,0,5,1,1,0.52,0.5,0.42,0.194,18,222,240,240,True
2747,2011-04-29,2,0,4,8,0,5,1,1,0.54,0.5152,0.39,0.2985,35,386,421,421,True
2748,2011-04-29,2,0,4,9,0,5,1,1,0.54,0.5152,0.39,0.3284,45,185,230,230,True
2749,2011-04-29,2,0,4,10,0,5,1,1,0.56,0.5303,0.4,0.2836,57,99,156,156,True
2750,2011-04-29,2,0,4,11,0,5,1,1,0.6,0.6212,0.38,0.2239,49,108,157,157,True
2751,2011-04-29,2,0,4,12,0,5,1,1,0.56,0.5303,0.37,0.2836,63,160,223,223,True
2752,2011-04-29,2,0,4,13,0,5,1,1,0.56,0.5303,0.37,0.2985,74,234,308,308,True
2753,2011-04-29,2,0,4,14,0,5,1,1,0.6,0.6212,0.35,0.3284,58,190,248,248,True
2754,2011-04-29,2,0,4,15,0,5,1,2,0.56,0.5303,0.4,0.2985,77,175,252,252,True
2755,2011-04-29,2,0,4,16,0,5,1,2,0.54,0.5152,0.42,0.3582,59,240,299,299,True
2756,2011-04-29,2,0,4,17,0,5,1,2,0.52,0.5,0.45,0.3881,75,433,508,508,True
2757,2011-04-29,2,0,4,18,0,5,1,1,0.52,0.5,0.48,0.3582,55,384,439,439,True
2758,2011-04-29,2,0,4,19,0,5,1,1,0.46,0.4545,0.55,0.3284,40,230,270,270,True
2759,2011-04-29,2,0,4,20,0,5,1,1,0.48,0.4697,0.48,0.2239,34,160,194,194,True
2760,2011-04-29,2,0,4,21,0,5,1,1,0.46,0.4545,0.51,0.194,50,145,195,195,True
2761,2011-04-29,2,0,4,22,0,5,1,1,0.42,0.4242,0.58,0.1642,36,110,146,146,True
2762,2011-04-29,2,0,4,23,0,5,1,2,0.44,0.4394,0.54,0.0896,25,88,113,113,True
2763,2011-04-30,2,0,4,0,0,6,0,2,0.44,0.4394,0.54,0.2537,33,73,106,106,True
2764,2011-04-30,2,0,4,1,0,6,0,2,0.44,0.4394,0.54,0.1642,15,59,74,74,True
2765,2011-04-30,2,0,4,2,0,6,0,2,0.44,0.4394,0.54,0.2239,12,53,65,65,True
2766,2011-04-30,2,0,4,3,0,6,0,2,0.42,0.4242,0.54,0.194,4,13,17,17,True
2767,2011-04-30,2,0,4,4,0,6,0,2,0.42,0.4242,0.54,0.2239,2,5,7,7,True
2768,2011-04-30,2,0,4,5,0,6,0,1,0.42,0.4242,0.54,0.3881,3,4,7,7,True
2769,2011-04-30,2,0,4,6,0,6,0,1,0.4,0.4091,0.58,0.2836,10,11,21,21,True
2770,2011-04-30,2,0,4,7,0,6,0,1,0.4,0.4091,0.54,0.3881,21,27,48,48,True
2771,2011-04-30,2,0,4,8,0,6,0,1,0.4,0.4091,0.54,0.2985,21,70,91,91,True
2772,2011-04-30,2,0,4,9,0,6,0,1,0.44,0.4394,0.51,0.3582,35,121,156,156,True
2773,2011-04-30,2,0,4,10,0,6,0,1,0.48,0.4697,0.44,0.3881,94,185,279,279,True
2774,2011-04-30,2,0,4,11,0,6,0,1,0.5,0.4848,0.42,0.3582,114,201,315,315,True
2775,2011-04-30,2,0,4,12,0,6,0,1,0.52,0.5,0.42,0.3881,114,238,352,352,True
2776,2011-04-30,2,0,4,13,0,6,0,1,0.54,0.5152,0.39,0.2985,114,270,384,384,True
2777,2011-04-30,2,0,4,14,0,6,0,1,0.54,0.5152,0.39,0.2239,114,268,382,382,True
2778,2011-04-30,2,0,4,15,0,6,0,1,0.56,0.5303,0.37,0.1343,114,282,396,396,True
2779,2011-04-30,2,0,4,16,0,6,0,1,0.58,0.5455,0.37,0.194,114,273,387,387,True
2780,2011-04-30,2,0,4,17,0,6,0,1,0.56,0.5303,0.43,0.1343,114,245,359,359,True
2781,2011-04-30,2,0,4,18,0,6,0,1,0.54,0.5152,0.43,0.1343,114,237,351,351,True
2782,2011-04-30,2,0,4,19,0,6,0,1,0.54,0.5152,0.43,0.1343,114,237,351,351,True
2783,2011-04-30,2,0,4,20,0,6,0,1,0.44,0.4394,0.62,0.1343,65,159,224,224,True
2784,2011-04-30,2,0,4,21,0,6,0,1,0.44,0.4394,0.62,0.1343,58,119,177,177,True
2785,2011-04-30,2,0,4,22,0,6,0,1,0.44,0.4394,0.67,0.1045,37,106,143,143,True
2786,2011-04-30,2,0,4,23,0,6,0,1,0.44,0.4394,0.67,0.1045,34,91,125,125,True
2787,2011-05-01,2,0,5,0,0,0,0,1,0.42,0.4242,0.67,0.0896,19,77,96,96,True
2788,2011-05-01,2,0,5,1,0,0,0,1,0.42,0.4242,0.69,0.1045,9,50,59,59,True
2789,2011-05-01,2,0,5,2,0,0,0,1,0.42,0.4242,0.77,0.1045,7,43,50,50,True
2790,2011-05-01,2,0,5,3,0,0,0,1,0.4,0.4091,0.82,0.1045,8,15,23,23,True
2791,2011-05-01,2,0,5,4,0,0,0,1,0.4,0.4091,0.76,0.1045,6,11,17,17,True
2792,2011-05-01,2,0,5,5,0,0,0,1,0.4,0.4091,0.82,0.0896,0,10,10,10,True
2793,2011-05-01,2,0,5,6,0,0,0,2,0.4,0.4091,0.82,0.0896,4,9,13,13,True
2794,2011-05-01,2,0,5,7,0,0,0,2,0.42,0.4242,0.77,0.0896,7,26,33,33,True
2795,2011-05-01,2,0,5,8,0,0,0,2,0.44,0.4394,0.77,0.1343,16,43,59,59,True
2796,2011-05-01,2,0,5,9,0,0,0,2,0.46,0.4545,0.72,0.1343,45,96,141,141,True
2797,2011-05-01,2,0,5,10,0,0,0,2,0.48,0.4697,0.63,0.194,109,155,264,264,True
2798,2011-05-01,2,0,5,11,0,0,0,1,0.46,0.4545,0.82,0.1045,109,141,250,250,True
2799,2011-05-01,2,0,5,12,0,0,0,2,0.48,0.4697,0.77,0.1045,109,172,281,281,True
2800,2011-05-01,2,0,5,13,0,0,0,2,0.5,0.4848,0.63,0.1642,114,209,323,323,True
2801,2011-05-01,2,0,5,14,0,0,0,2,0.5,0.4848,0.68,0.1045,85,153,238,238,True
2802,2011-05-01,2,0,5,15,0,0,0,2,0.5,0.4848,0.72,0.0,113,153,266,266,True
2803,2011-05-01,2,0,5,16,0,0,0,2,0.5,0.4848,0.72,0.194,75,139,214,214,True
2804,2011-05-01,2,0,5,17,0,0,0,2,0.48,0.4697,0.82,0.2537,60,136,196,196,True
2805,2011-05-01,2,0,5,18,0,0,0,2,0.46,0.4545,0.82,0.0896,33,126,159,159,True
2806,2011-05-01,2,0,5,19,0,0,0,2,0.46,0.4545,0.84,0.1045,47,131,178,178,True
2807,2011-05-01,2,0,5,20,0,0,0,2,0.46,0.4545,0.82,0.0,35,86,121,121,True
2808,2011-05-01,2,0,5,21,0,0,0,2,0.46,0.4545,0.82,0.0,23,82,105,105,True
2809,2011-05-01,2,0,5,22,0,0,0,2,0.46,0.4545,0.82,0.0,32,68,100,100,True
2810,2011-05-01,2,0,5,23,0,0,0,1,0.46,0.4545,0.77,0.194,64,82,146,146,True
2811,2011-05-02,2,0,5,0,0,1,1,1,0.46,0.4545,0.72,0.1343,68,109,177,177,True
2812,2011-05-02,2,0,5,1,0,1,1,1,0.46,0.4545,0.72,0.1343,41,73,114,114,True
2813,2011-05-02,2,0,5,2,0,1,1,2,0.44,0.4394,0.77,0.2239,16,19,35,35,True
2814,2011-05-02,2,0,5,3,0,1,1,1,0.44,0.4394,0.77,0.1343,9,7,16,16,True
2815,2011-05-02,2,0,5,4,0,1,1,1,0.44,0.4394,0.77,0.1642,9,8,17,17,True
2816,2011-05-02,2,0,5,5,0,1,1,2,0.44,0.4394,0.77,0.1343,4,16,20,20,True
2817,2011-05-02,2,0,5,6,0,1,1,1,0.44,0.4394,0.88,0.1045,3,59,62,62,True
2818,2011-05-02,2,0,5,7,0,1,1,2,0.46,0.4545,0.82,0.3284,16,193,209,209,True
2819,2011-05-02,2,0,5,8,0,1,1,2,0.48,0.4697,0.77,0.2239,21,350,371,371,True
2820,2011-05-02,2,0,5,9,0,1,1,2,0.5,0.4848,0.77,0.2836,41,131,172,172,True
2821,2011-05-02,2,0,5,10,0,1,1,2,0.54,0.5152,0.77,0.2239,31,77,108,108,True
2822,2011-05-02,2,0,5,11,0,1,1,1,0.58,0.5455,0.73,0.2985,34,96,130,130,True
2823,2011-05-02,2,0,5,12,0,1,1,1,0.62,0.6061,0.69,0.2239,40,147,187,187,True
2824,2011-05-02,2,0,5,13,0,1,1,2,0.62,0.6061,0.69,0.194,51,119,170,170,True
2825,2011-05-02,2,0,5,14,0,1,1,1,0.64,0.6061,0.69,0.2239,48,133,181,181,True
2826,2011-05-02,2,0,5,15,0,1,1,1,0.66,0.6212,0.61,0.194,45,110,155,155,True
2827,2011-05-02,2,0,5,16,0,1,1,1,0.66,0.6212,0.61,0.2239,49,220,269,269,True
2828,2011-05-02,2,0,5,17,0,1,1,1,0.66,0.6212,0.65,0.194,65,472,537,537,True
2829,2011-05-02,2,0,5,18,0,1,1,2,0.64,0.6061,0.65,0.194,68,450,518,518,True
2830,2011-05-02,2,0,5,19,0,1,1,2,0.62,0.6061,0.69,0.1343,46,268,314,314,True
2831,2011-05-02,2,0,5,20,0,1,1,2,0.62,0.6061,0.69,0.1343,44,174,218,218,True
2832,2011-05-02,2,0,5,21,0,1,1,2,0.6,0.5909,0.73,0.1045,54,178,232,232,True
2833,2011-05-02,2,0,5,22,0,1,1,2,0.6,0.5909,0.73,0.0,28,97,125,125,True
2834,2011-05-02,2,0,5,23,0,1,1,2,0.56,0.5303,0.83,0.194,16,48,64,64,True
2835,2011-05-03,2,0,5,0,0,2,1,2,0.56,0.5303,0.83,0.2239,0,16,16,16,True
2836,2011-05-03,2,0,5,1,0,2,1,2,0.56,0.5303,0.78,0.2537,0,14,14,14,True
2837,2011-05-03,2,0,5,2,0,2,1,2,0.56,0.5303,0.78,0.2537,0,5,5,5,True
2838,2011-05-03,2,0,5,3,0,2,1,1,0.54,0.5152,0.83,0.2836,0,2,2,2,True
2839,2011-05-03,2,0,5,4,0,2,1,1,0.52,0.5,0.88,0.2239,3,1,4,4,True
2840,2011-05-03,2,0,5,5,0,2,1,1,0.52,0.5,0.88,0.1343,0,14,14,14,True
2841,2011-05-03,2,0,5,6,0,2,1,2,0.52,0.5,0.94,0.1642,7,102,109,109,True
2842,2011-05-03,2,0,5,7,0,2,1,2,0.54,0.5152,0.88,0.2239,17,248,265,265,True
2843,2011-05-03,2,0,5,8,0,2,1,2,0.56,0.5303,0.83,0.2836,24,435,459,459,True
2844,2011-05-03,2,0,5,9,0,2,1,2,0.6,0.5758,0.78,0.3582,29,157,186,186,True
2845,2011-05-03,2,0,5,10,0,2,1,2,0.64,0.6061,0.69,0.3582,36,91,127,127,True
2846,2011-05-03,2,0,5,11,0,2,1,2,0.66,0.6212,0.65,0.3284,20,120,140,140,True
2847,2011-05-03,2,0,5,12,0,2,1,2,0.68,0.6364,0.61,0.4775,48,169,217,217,True
2848,2011-05-03,2,0,5,13,0,2,1,2,0.7,0.6515,0.58,0.4775,50,144,194,194,True
2849,2011-05-03,2,0,5,14,0,2,1,2,0.7,0.6515,0.58,0.4775,36,122,158,158,True
2850,2011-05-03,2,0,5,15,0,2,1,2,0.7,0.6515,0.58,0.4478,37,117,154,154,True
2851,2011-05-03,2,0,5,16,0,2,1,1,0.72,0.6667,0.54,0.4627,46,225,271,271,True
2852,2011-05-03,2,0,5,17,0,2,1,1,0.7,0.6515,0.54,0.4627,53,464,517,517,True
2853,2011-05-03,2,0,5,18,0,2,1,1,0.7,0.6515,0.48,0.4179,59,485,544,544,True
2854,2011-05-03,2,0,5,19,0,2,1,1,0.68,0.6364,0.57,0.3582,42,323,365,365,True
2855,2011-05-03,2,0,5,20,0,2,1,1,0.66,0.6212,0.61,0.194,28,262,290,290,True
2856,2011-05-03,2,0,5,21,0,2,1,2,0.64,0.6212,0.61,0.4478,42,183,225,225,True
2857,2011-05-03,2,0,5,22,0,2,1,2,0.58,0.5455,0.6,0.3881,14,99,113,113,True
2858,2011-05-03,2,0,5,23,0,2,1,2,0.56,0.5303,0.68,0.3284,12,50,62,62,True
2859,2011-05-04,2,0,5,0,0,3,1,3,0.52,0.5,0.77,0.1642,5,22,27,27,True
2860,2011-05-04,2,0,5,1,0,3,1,3,0.5,0.4848,0.82,0.2836,1,6,7,7,True
2861,2011-05-04,2,0,5,2,0,3,1,3,0.5,0.4848,0.82,0.2836,0,4,4,4,True
2862,2011-05-04,2,0,5,3,0,3,1,3,0.42,0.4242,0.88,0.4775,0,1,1,1,True
2863,2011-05-04,2,0,5,4,0,3,1,3,0.38,0.3939,0.94,0.3284,1,2,3,3,True
2864,2011-05-04,2,0,5,5,0,3,1,3,0.36,0.3333,0.87,0.3284,1,8,9,9,True
2865,2011-05-04,2,0,5,6,0,3,1,3,0.34,0.303,0.93,0.3881,0,21,21,21,True
2866,2011-05-04,2,0,5,7,0,3,1,3,0.34,0.303,0.93,0.3582,6,46,52,52,True
2867,2011-05-04,2,0,5,8,0,3,1,3,0.34,0.303,0.93,0.3881,5,74,79,79,True
2868,2011-05-04,2,0,5,9,0,3,1,3,0.34,0.303,0.93,0.3582,5,35,40,40,True
2869,2011-05-04,2,0,5,10,0,3,1,2,0.34,0.3182,0.93,0.2836,5,26,31,31,True
2870,2011-05-04,2,0,5,11,0,3,1,1,0.4,0.4091,0.82,0.3284,3,69,72,72,True
2871,2011-05-04,2,0,5,12,0,3,1,2,0.44,0.4394,0.62,0.3582,19,105,124,124,True
2872,2011-05-04,2,0,5,13,0,3,1,2,0.46,0.4545,0.59,0.4478,15,128,143,143,True
2873,2011-05-04,2,0,5,14,0,3,1,1,0.5,0.4848,0.51,0.3881,13,94,107,107,True
2874,2011-05-04,2,0,5,15,0,3,1,1,0.48,0.4697,0.51,0.4179,22,107,129,129,True
2875,2011-05-04,2,0,5,16,0,3,1,1,0.5,0.4848,0.45,0.4627,22,173,195,195,True
2876,2011-05-04,2,0,5,17,0,3,1,1,0.4,0.4091,0.71,0.2537,22,388,410,410,True
2877,2011-05-04,2,0,5,18,0,3,1,1,0.42,0.4242,0.67,0.2537,29,367,396,396,True
2878,2011-05-04,2,0,5,19,0,3,1,1,0.42,0.4242,0.58,0.3582,30,266,296,296,True
2879,2011-05-04,2,0,5,20,0,3,1,1,0.4,0.4091,0.62,0.3284,17,174,191,191,True
2880,2011-05-04,2,0,5,21,0,3,1,1,0.4,0.4091,0.62,0.1642,17,133,150,150,True
2881,2011-05-04,2,0,5,22,0,3,1,1,0.38,0.3939,0.62,0.2239,9,80,89,89,True
2882,2011-05-04,2,0,5,23,0,3,1,1,0.36,0.3485,0.62,0.2239,8,49,57,57,True
2883,2011-05-05,2,0,5,0,0,4,1,1,0.36,0.3485,0.66,0.194,4,23,27,27,True
2884,2011-05-05,2,0,5,1,0,4,1,1,0.34,0.3333,0.71,0.194,4,6,10,10,True
2885,2011-05-05,2,0,5,2,0,4,1,1,0.34,0.3182,0.66,0.2239,1,4,5,5,True
2886,2011-05-05,2,0,5,3,0,4,1,1,0.34,0.3182,0.66,0.2537,0,4,4,4,True
2887,2011-05-05,2,0,5,4,0,4,1,1,0.34,0.3182,0.66,0.2537,4,3,7,7,True
2888,2011-05-05,2,0,5,5,0,4,1,1,0.34,0.3182,0.66,0.2537,1,29,30,30,True
2889,2011-05-05,2,0,5,6,0,4,1,1,0.34,0.3182,0.66,0.2537,3,86,89,89,True
2890,2011-05-05,2,0,5,7,0,4,1,1,0.38,0.3939,0.58,0.2537,16,255,271,271,True
2891,2011-05-05,2,0,5,8,0,4,1,1,0.42,0.4242,0.5,0.2537,25,415,440,440,True
2892,2011-05-05,2,0,5,9,0,4,1,1,0.46,0.4545,0.44,0.2836,20,164,184,184,True
2893,2011-05-05,2,0,5,10,0,4,1,1,0.5,0.4848,0.39,0.2836,30,98,128,128,True
2894,2011-05-05,2,0,5,11,0,4,1,1,0.52,0.5,0.36,0.4478,43,105,148,148,True
2895,2011-05-05,2,0,5,12,0,4,1,1,0.52,0.5,0.34,0.3582,27,169,196,196,True
2896,2011-05-05,2,0,5,13,0,4,1,1,0.54,0.5152,0.3,0.4775,50,142,192,192,True
2897,2011-05-05,2,0,5,14,0,4,1,1,0.54,0.5152,0.28,0.4478,19,135,154,154,True
2898,2011-05-05,2,0,5,15,0,4,1,1,0.56,0.5303,0.26,0.4775,27,120,147,147,True
2899,2011-05-05,2,0,5,16,0,4,1,1,0.58,0.5455,0.24,0.4179,36,233,269,269,True
2900,2011-05-05,2,0,5,17,0,4,1,1,0.56,0.5303,0.26,0.3881,66,467,533,533,True
2901,2011-05-05,2,0,5,18,0,4,1,1,0.56,0.5303,0.26,0.2836,64,456,520,520,True
2902,2011-05-05,2,0,5,19,0,4,1,1,0.54,0.5152,0.28,0.2239,56,305,361,361,True
2903,2011-05-05,2,0,5,20,0,4,1,1,0.5,0.4848,0.34,0.1642,33,225,258,258,True
2904,2011-05-05,2,0,5,21,0,4,1,1,0.5,0.4848,0.36,0.194,39,141,180,180,True
2905,2011-05-05,2,0,5,22,0,4,1,1,0.48,0.4697,0.39,0.194,30,135,165,165,True
2906,2011-05-05,2,0,5,23,0,4,1,1,0.46,0.4545,0.41,0.194,16,99,115,115,True
2907,2011-05-06,2,0,5,0,0,5,1,1,0.44,0.4394,0.44,0.1642,13,43,56,56,True
2908,2011-05-06,2,0,5,1,0,5,1,1,0.4,0.4091,0.62,0.1642,8,24,32,32,True
2909,2011-05-06,2,0,5,2,0,5,1,1,0.38,0.3939,0.62,0.1045,1,15,16,16,True
2910,2011-05-06,2,0,5,3,0,5,1,1,0.36,0.3636,0.71,0.1045,3,6,9,9,True
2911,2011-05-06,2,0,5,4,0,5,1,1,0.36,0.3636,0.71,0.1045,0,1,1,1,True
2912,2011-05-06,2,0,5,5,0,5,1,1,0.34,0.3485,0.81,0.1045,0,16,16,16,True
2913,2011-05-06,2,0,5,6,0,5,1,1,0.36,0.3636,0.81,0.0896,8,74,82,82,True
2914,2011-05-06,2,0,5,7,0,5,1,1,0.4,0.4091,0.82,0.0,20,202,222,222,True
2915,2011-05-06,2,0,5,8,0,5,1,1,0.42,0.4242,0.77,0.2537,35,415,450,450,True
2916,2011-05-06,2,0,5,9,0,5,1,1,0.46,0.4545,0.67,0.2836,27,161,188,188,True
2917,2011-05-06,2,0,5,10,0,5,1,2,0.54,0.5152,0.49,0.3284,30,97,127,127,True
2918,2011-05-06,2,0,5,11,0,5,1,2,0.54,0.5152,0.49,0.3284,42,123,165,165,True
2919,2011-05-06,2,0,5,12,0,5,1,1,0.56,0.5303,0.49,0.3582,48,198,246,246,True
2920,2011-05-06,2,0,5,13,0,5,1,1,0.58,0.5455,0.4,0.3284,71,182,253,253,True
2921,2011-05-06,2,0,5,14,0,5,1,1,0.6,0.6212,0.4,0.4478,86,127,213,213,True
2922,2011-05-06,2,0,5,15,0,5,1,1,0.6,0.6212,0.38,0.3881,89,171,260,260,True
2923,2011-05-06,2,0,5,16,0,5,1,1,0.6,0.6212,0.4,0.2537,82,262,344,344,True
2924,2011-05-06,2,0,5,17,0,5,1,1,0.58,0.5455,0.4,0.3582,83,470,553,553,True
2925,2011-05-06,2,0,5,18,0,5,1,3,0.54,0.5152,0.52,0.3582,85,385,470,470,True
2926,2011-05-06,2,0,5,19,0,5,1,3,0.54,0.5152,0.52,0.3582,39,253,292,292,True
2927,2011-05-06,2,0,5,20,0,5,1,1,0.52,0.5,0.48,0.1045,29,161,190,190,True
2928,2011-05-06,2,0,5,21,0,5,1,1,0.48,0.4697,0.67,0.1343,22,130,152,152,True
2929,2011-05-06,2,0,5,22,0,5,1,1,0.46,0.4545,0.72,0.2239,46,105,151,151,True
2930,2011-05-06,2,0,5,23,0,5,1,1,0.44,0.4394,0.82,0.1343,27,93,120,120,True
2931,2011-05-07,2,0,5,0,0,6,0,1,0.42,0.4242,0.82,0.1343,10,76,86,86,True
2932,2011-05-07,2,0,5,1,0,6,0,1,0.42,0.4242,0.82,0.1045,8,50,58,58,True
2933,2011-05-07,2,0,5,2,0,6,0,1,0.42,0.4242,0.82,0.0896,5,47,52,52,True
2934,2011-05-07,2,0,5,3,0,6,0,1,0.42,0.4242,0.77,0.0896,9,9,18,18,True
2935,2011-05-07,2,0,5,4,0,6,0,1,0.4,0.4091,0.82,0.1045,1,4,5,5,True
2936,2011-05-07,2,0,5,5,0,6,0,1,0.46,0.4545,0.59,0.1343,4,3,7,7,True
2937,2011-05-07,2,0,5,6,0,6,0,1,0.42,0.4242,0.77,0.0896,1,12,13,13,True
2938,2011-05-07,2,0,5,7,0,6,0,1,0.48,0.4697,0.59,0.0,8,32,40,40,True
2939,2011-05-07,2,0,5,8,0,6,0,1,0.52,0.5,0.52,0.194,19,96,115,115,True
2940,2011-05-07,2,0,5,9,0,6,0,1,0.54,0.5152,0.49,0.2836,54,164,218,218,True
2941,2011-05-07,2,0,5,10,0,6,0,1,0.56,0.5303,0.49,0.2985,90,208,298,298,True
2942,2011-05-07,2,0,5,11,0,6,0,1,0.56,0.5303,0.43,0.0,114,215,329,329,True
2943,2011-05-07,2,0,5,12,0,6,0,1,0.6,0.6212,0.4,0.194,114,244,358,358,True
2944,2011-05-07,2,0,5,13,0,6,0,1,0.6,0.6212,0.35,0.2836,114,240,354,354,True
2945,2011-05-07,2,0,5,14,0,6,0,3,0.6,0.6212,0.35,0.1642,114,235,349,349,True
2946,2011-05-07,2,0,5,15,0,6,0,1,0.6,0.6212,0.38,0.2537,114,230,344,344,True
2947,2011-05-07,2,0,5,16,0,6,0,1,0.6,0.6212,0.38,0.194,114,223,337,337,True
2948,2011-05-07,2,0,5,17,0,6,0,1,0.58,0.5455,0.4,0.2239,114,216,330,330,True
2949,2011-05-07,2,0,5,18,0,6,0,1,0.58,0.5455,0.37,0.1642,114,175,289,289,True
2950,2011-05-07,2,0,5,19,0,6,0,1,0.56,0.5303,0.43,0.194,88,179,267,267,True
2951,2011-05-07,2,0,5,20,0,6,0,1,0.56,0.5303,0.43,0.1343,82,137,219,219,True
2952,2011-05-07,2,0,5,21,0,6,0,1,0.54,0.5152,0.49,0.2239,58,124,182,182,True
2953,2011-05-07,2,0,5,22,0,6,0,1,0.54,0.5152,0.49,0.194,26,94,120,120,True
2954,2011-05-07,2,0,5,23,0,6,0,1,0.5,0.4848,0.59,0.1045,30,89,119,119,True
2955,2011-05-08,2,0,5,0,0,0,0,2,0.5,0.4848,0.59,0.1045,22,78,100,100,True
2956,2011-05-08,2,0,5,1,0,0,0,2,0.52,0.5,0.55,0.0,8,56,64,64,True
2957,2011-05-08,2,0,5,2,0,0,0,1,0.48,0.4697,0.63,0.0,17,42,59,59,True
2958,2011-05-08,2,0,5,3,0,0,0,1,0.46,0.4545,0.72,0.0896,10,21,31,31,True
2959,2011-05-08,2,0,5,4,0,0,0,1,0.42,0.4242,0.82,0.0,2,8,10,10,True
2960,2011-05-08,2,0,5,5,0,0,0,2,0.44,0.4394,0.77,0.0,0,5,5,5,True
2961,2011-05-08,2,0,5,6,0,0,0,2,0.44,0.4394,0.82,0.0,2,4,6,6,True
2962,2011-05-08,2,0,5,7,0,0,0,2,0.46,0.4545,0.82,0.0,8,15,23,23,True
2963,2011-05-08,2,0,5,8,0,0,0,1,0.52,0.5,0.63,0.1343,28,58,86,86,True
2964,2011-05-08,2,0,5,9,0,0,0,1,0.56,0.5303,0.52,0.2239,48,112,160,160,True
2965,2011-05-08,2,0,5,10,0,0,0,1,0.58,0.5455,0.49,0.1343,91,153,244,244,True
2966,2011-05-08,2,0,5,11,0,0,0,1,0.58,0.5455,0.49,0.0896,114,198,312,312,True
2967,2011-05-08,2,0,5,12,0,0,0,1,0.6,0.6212,0.46,0.0896,114,243,357,357,True
2968,2011-05-08,2,0,5,13,0,0,0,1,0.6,0.6212,0.49,0.1343,114,224,338,338,True
2969,2011-05-08,2,0,5,14,0,0,0,1,0.6,0.6212,0.49,0.0,114,240,354,354,True
2970,2011-05-08,2,0,5,15,0,0,0,1,0.6,0.6212,0.49,0.0,114,230,344,344,True
2971,2011-05-08,2,0,5,16,0,0,0,1,0.6,0.6212,0.46,0.1045,114,263,377,377,True
2972,2011-05-08,2,0,5,17,0,0,0,3,0.58,0.5455,0.49,0.2836,106,245,351,351,True
2973,2011-05-08,2,0,5,18,0,0,0,1,0.58,0.5455,0.49,0.0,63,205,268,268,True
2974,2011-05-08,2,0,5,19,0,0,0,1,0.56,0.5303,0.64,0.0,61,178,239,239,True
2975,2011-05-08,2,0,5,20,0,0,0,1,0.52,0.5,0.77,0.1343,42,132,174,174,True
2976,2011-05-08,2,0,5,21,0,0,0,1,0.52,0.5,0.77,0.0896,32,95,127,127,True
2977,2011-05-08,2,0,5,22,0,0,0,1,0.5,0.4848,0.88,0.0896,29,86,115,115,True
2978,2011-05-08,2,0,5,23,0,0,0,1,0.46,0.4545,0.88,0.0896,9,41,50,50,True
2979,2011-05-09,2,0,5,0,0,1,1,1,0.46,0.4545,0.82,0.0896,31,22,53,53,True
2980,2011-05-09,2,0,5,1,0,1,1,1,0.44,0.4394,0.88,0.0,25,8,33,33,True
2981,2011-05-09,2,0,5,2,0,1,1,1,0.44,0.4394,0.94,0.0,6,2,8,8,True
2982,2011-05-09,2,0,5,3,0,1,1,1,0.46,0.4545,0.82,0.0896,0,7,7,7,True
2983,2011-05-09,2,0,5,4,0,1,1,1,0.42,0.4242,0.82,0.1642,0,4,4,4,True
2984,2011-05-09,2,0,5,5,0,1,1,1,0.42,0.4242,0.77,0.1642,0,23,23,23,True
2985,2011-05-09,2,0,5,6,0,1,1,1,0.44,0.4394,0.72,0.2537,2,87,89,89,True
2986,2011-05-09,2,0,5,7,0,1,1,1,0.48,0.4697,0.63,0.2537,16,221,237,237,True
2987,2011-05-09,2,0,5,8,0,1,1,1,0.52,0.5,0.55,0.2239,23,351,374,374,True
2988,2011-05-09,2,0,5,9,0,1,1,1,0.54,0.5152,0.56,0.1642,36,142,178,178,True
2989,2011-05-09,2,0,5,10,0,1,1,1,0.56,0.5303,0.52,0.194,24,95,119,119,True
2990,2011-05-09,2,0,5,11,0,1,1,1,0.6,0.6212,0.46,0.2239,26,99,125,125,True
2991,2011-05-09,2,0,5,12,0,1,1,1,0.6,0.6212,0.43,0.194,35,160,195,195,True
2992,2011-05-09,2,0,5,13,0,1,1,1,0.62,0.6212,0.38,0.2836,36,138,174,174,True
2993,2011-05-09,2,0,5,14,0,1,1,1,0.62,0.6212,0.41,0.2239,44,118,162,162,True
2994,2011-05-09,2,0,5,15,0,1,1,1,0.62,0.6212,0.41,0.2239,51,148,199,199,True
2995,2011-05-09,2,0,5,16,0,1,1,1,0.64,0.6212,0.38,0.2239,49,255,304,304,True
2996,2011-05-09,2,0,5,17,0,1,1,1,0.62,0.6212,0.38,0.2537,59,499,558,558,True
2997,2011-05-09,2,0,5,18,0,1,1,1,0.62,0.6212,0.38,0.2985,66,458,524,524,True
2998,2011-05-09,2,0,5,19,0,1,1,1,0.58,0.5455,0.43,0.194,45,339,384,384,True
2999,2011-05-09,2,0,5,20,0,1,1,1,0.54,0.5152,0.49,0.194,25,214,239,239,True
3000,2011-05-09,2,0,5,21,0,1,1,1,0.52,0.5,0.59,0.1343,28,128,156,156,True
3001,2011-05-09,2,0,5,22,0,1,1,1,0.52,0.5,0.68,0.0896,21,95,116,116,True
3002,2011-05-09,2,0,5,23,0,1,1,1,0.5,0.4848,0.68,0.0896,16,45,61,61,True
3003,2011-05-10,2,0,5,0,0,2,1,1,0.48,0.4697,0.63,0.0,6,12,18,18,True
3004,2011-05-10,2,0,5,1,0,2,1,1,0.46,0.4545,0.59,0.0896,3,12,15,15,True
3005,2011-05-10,2,0,5,2,0,2,1,1,0.44,0.4394,0.58,0.1343,1,4,5,5,True
3006,2011-05-10,2,0,5,3,0,2,1,1,0.44,0.4394,0.54,0.194,1,3,4,4,True
3007,2011-05-10,2,0,5,4,0,2,1,1,0.42,0.4242,0.62,0.2537,0,2,2,2,True
3008,2011-05-10,2,0,5,5,0,2,1,1,0.4,0.4091,0.66,0.2239,1,28,29,29,True
3009,2011-05-10,2,0,5,6,0,2,1,1,0.42,0.4242,0.67,0.1343,9,103,112,112,True
3010,2011-05-10,2,0,5,7,0,2,1,2,0.44,0.4394,0.62,0.1343,13,301,314,314,True
3011,2011-05-10,2,0,5,8,0,2,1,2,0.5,0.4848,0.51,0.1045,28,397,425,425,True
3012,2011-05-10,2,0,5,9,0,2,1,2,0.52,0.5,0.48,0.1045,29,176,205,205,True
3013,2011-05-10,2,0,5,10,0,2,1,2,0.56,0.5303,0.37,0.0896,27,100,127,127,True
3014,2011-05-10,2,0,5,11,0,2,1,2,0.56,0.5303,0.43,0.1343,17,108,125,125,True
3015,2011-05-10,2,0,5,12,0,2,1,2,0.6,0.6212,0.38,0.0,47,170,217,217,True
3016,2011-05-10,2,0,5,13,0,2,1,2,0.62,0.6212,0.38,0.2537,50,152,202,202,True
3017,2011-05-10,2,0,5,14,0,2,1,2,0.62,0.6212,0.33,0.0,42,134,176,176,True
3018,2011-05-10,2,0,5,15,0,2,1,2,0.64,0.6212,0.33,0.0896,28,152,180,180,True
3019,2011-05-10,2,0,5,16,0,2,1,1,0.66,0.6212,0.31,0.1045,56,271,327,327,True
3020,2011-05-10,2,0,5,17,0,2,1,1,0.64,0.6212,0.33,0.0,79,499,578,578,True
3021,2011-05-10,2,0,5,18,0,2,1,1,0.64,0.6212,0.29,0.1343,70,480,550,550,True
3022,2011-05-10,2,0,5,19,0,2,1,1,0.6,0.6212,0.43,0.2239,69,365,434,434,True
3023,2011-05-10,2,0,5,20,0,2,1,1,0.54,0.5152,0.6,0.1343,50,241,291,291,True
3024,2011-05-10,2,0,5,21,0,2,1,1,0.54,0.5152,0.52,0.0,30,173,203,203,True
3025,2011-05-10,2,0,5,22,0,2,1,1,0.52,0.5,0.55,0.1045,29,121,150,150,True
3026,2011-05-10,2,0,5,23,0,2,1,2,0.52,0.5,0.59,0.1343,9,72,81,81,True
3027,2011-05-11,2,0,5,0,0,3,1,2,0.52,0.5,0.55,0.1343,8,30,38,38,True
3028,2011-05-11,2,0,5,1,0,3,1,2,0.5,0.4848,0.59,0.1045,4,16,20,20,True
3029,2011-05-11,2,0,5,2,0,3,1,1,0.52,0.5,0.59,0.0,6,4,10,10,True
3030,2011-05-11,2,0,5,3,0,3,1,1,0.5,0.4848,0.63,0.2239,0,3,3,3,True
3031,2011-05-11,2,0,5,4,0,3,1,2,0.48,0.4697,0.88,0.1343,0,2,2,2,True
3032,2011-05-11,2,0,5,5,0,3,1,1,0.46,0.4545,0.88,0.1343,0,20,20,20,True
3033,2011-05-11,2,0,5,6,0,3,1,1,0.46,0.4545,0.82,0.1343,6,93,99,99,True
3034,2011-05-11,2,0,5,7,0,3,1,1,0.48,0.4697,0.72,0.194,25,293,318,318,True
3035,2011-05-11,2,0,5,8,0,3,1,1,0.48,0.4697,0.77,0.2537,21,421,442,442,True
3036,2011-05-11,2,0,5,9,0,3,1,1,0.52,0.5,0.72,0.1343,21,182,203,203,True
3037,2011-05-11,2,0,5,10,0,3,1,1,0.54,0.5152,0.68,0.0896,30,124,154,154,True
3038,2011-05-11,2,0,5,11,0,3,1,1,0.56,0.5303,0.64,0.0896,18,123,141,141,True
3039,2011-05-11,2,0,5,12,0,3,1,1,0.6,0.6212,0.56,0.0,41,185,226,226,True
3040,2011-05-11,2,0,5,13,0,3,1,1,0.62,0.6212,0.5,0.0,36,157,193,193,True
3041,2011-05-11,2,0,5,14,0,3,1,1,0.62,0.6212,0.53,0.0896,36,141,177,177,True
3042,2011-05-11,2,0,5,15,0,3,1,1,0.64,0.6212,0.41,0.0,48,131,179,179,True
3043,2011-05-11,2,0,5,16,0,3,1,1,0.66,0.6212,0.39,0.0,49,240,289,289,True
3044,2011-05-11,2,0,5,17,0,3,1,1,0.64,0.6212,0.47,0.1045,17,242,259,259,True
3045,2011-05-11,2,0,5,18,0,3,1,1,0.62,0.6212,0.5,0.2985,40,234,274,274,True
3046,2011-05-11,2,0,5,19,0,3,1,1,0.56,0.5303,0.52,0.1343,60,341,401,401,True
3047,2011-05-11,2,0,5,20,0,3,1,1,0.54,0.5152,0.64,0.1343,28,245,273,273,True
3048,2011-05-11,2,0,5,21,0,3,1,1,0.54,0.5152,0.6,0.0,32,202,234,234,True
3049,2011-05-11,2,0,5,22,0,3,1,1,0.5,0.4848,0.72,0.2537,12,134,146,146,True
3050,2011-05-11,2,0,5,23,0,3,1,1,0.46,0.4545,0.88,0.2537,12,69,81,81,True
3051,2011-05-12,2,0,5,0,0,4,1,2,0.46,0.4545,0.88,0.2239,5,39,44,44,True
3052,2011-05-12,2,0,5,1,0,4,1,1,0.46,0.4545,0.88,0.2239,1,16,17,17,True
3053,2011-05-12,2,0,5,2,0,4,1,1,0.44,0.4394,0.94,0.194,1,14,15,15,True
3054,2011-05-12,2,0,5,3,0,4,1,1,0.44,0.4394,0.88,0.1343,0,5,5,5,True
3055,2011-05-12,2,0,5,4,0,4,1,1,0.42,0.4242,0.94,0.0,1,5,6,6,True
3056,2011-05-12,2,0,5,5,0,4,1,1,0.42,0.4242,0.94,0.1343,2,27,29,29,True
3057,2011-05-12,2,0,5,6,0,4,1,1,0.44,0.4394,0.88,0.0,9,103,112,112,True
3058,2011-05-12,2,0,5,7,0,4,1,1,0.46,0.4545,0.88,0.1343,14,283,297,297,True
3059,2011-05-12,2,0,5,8,0,4,1,1,0.48,0.4697,0.82,0.194,27,394,421,421,True
3060,2011-05-12,2,0,5,9,0,4,1,2,0.5,0.4848,0.77,0.2836,21,191,212,212,True
3061,2011-05-12,2,0,5,10,0,4,1,2,0.54,0.5152,0.68,0.2239,28,119,147,147,True
3062,2011-05-12,2,0,5,11,0,4,1,1,0.58,0.5455,0.6,0.2239,43,136,179,179,True
3063,2011-05-12,2,0,5,12,0,4,1,1,0.58,0.5455,0.6,0.2239,43,164,207,207,True
3064,2011-05-12,2,0,5,13,0,4,1,2,0.62,0.6212,0.57,0.2985,48,170,218,218,True
3065,2011-05-12,2,0,5,14,0,4,1,2,0.62,0.6061,0.61,0.2239,43,148,191,191,True
3066,2011-05-12,2,0,5,15,0,4,1,2,0.64,0.6212,0.53,0.2537,54,163,217,217,True
3067,2011-05-12,2,0,5,16,0,4,1,2,0.64,0.6212,0.57,0.2537,50,238,288,288,True
3068,2011-05-12,2,0,5,17,0,4,1,2,0.64,0.6212,0.57,0.194,54,499,553,553,True
3069,2011-05-12,2,0,5,18,0,4,1,1,0.62,0.6061,0.69,0.2239,64,463,527,527,True
3070,2011-05-12,2,0,5,19,0,4,1,2,0.6,0.6061,0.64,0.194,59,305,364,364,True
3071,2011-05-12,2,0,5,20,0,4,1,1,0.6,0.6061,0.64,0.194,56,220,276,276,True
3072,2011-05-12,2,0,5,21,0,4,1,1,0.56,0.5303,0.83,0.1343,31,192,223,223,True
3073,2011-05-12,2,0,5,22,0,4,1,1,0.54,0.5152,0.83,0.194,25,147,172,172,True
3074,2011-05-12,2,0,5,23,0,4,1,2,0.54,0.5152,0.77,0.194,16,87,103,103,True
3075,2011-05-13,2,0,5,0,0,5,1,2,0.52,0.5,0.83,0.1642,6,46,52,52,True
3076,2011-05-13,2,0,5,1,0,5,1,1,0.52,0.5,0.83,0.1642,5,15,20,20,True
3077,2011-05-13,2,0,5,2,0,5,1,2,0.5,0.4848,0.88,0.1343,3,8,11,11,True
3078,2011-05-13,2,0,5,3,0,5,1,2,0.5,0.4848,0.88,0.1343,2,2,4,4,True
3079,2011-05-13,2,0,5,4,0,5,1,3,0.5,0.4848,0.88,0.1642,2,3,5,5,True
3080,2011-05-13,2,0,5,5,0,5,1,2,0.5,0.4848,0.88,0.194,1,24,25,25,True
3081,2011-05-13,2,0,5,6,0,5,1,3,0.5,0.4848,0.88,0.1343,6,76,82,82,True
3082,2011-05-13,2,0,5,7,0,5,1,3,0.5,0.4848,0.88,0.1642,16,141,157,157,True
3083,2011-05-13,2,0,5,8,0,5,1,2,0.5,0.4848,0.88,0.194,26,361,387,387,True
3084,2011-05-13,2,0,5,9,0,5,1,2,0.5,0.4848,0.88,0.194,18,215,233,233,True
3085,2011-05-13,2,0,5,10,0,5,1,2,0.52,0.5,0.83,0.1343,31,99,130,130,True
3086,2011-05-13,2,0,5,11,0,5,1,2,0.52,0.5,0.83,0.1642,56,90,146,146,True
3087,2011-05-13,2,0,5,12,0,5,1,2,0.52,0.5,0.88,0.194,53,170,223,223,True
3088,2011-05-13,2,0,5,13,0,5,1,2,0.52,0.5,0.88,0.3881,69,157,226,226,True
3089,2011-05-13,2,0,5,14,0,5,1,2,0.52,0.5,0.87,0.2836,70,120,190,190,True
3090,2011-05-13,2,0,5,15,0,5,1,2,0.52,0.5,0.88,0.1642,56,142,198,198,True
3091,2011-05-13,2,0,5,16,0,5,1,2,0.52,0.5,0.88,0.1343,44,256,300,300,True
3092,2011-05-13,2,0,5,17,0,5,1,3,0.52,0.5,0.88,0.1642,62,429,491,491,True
3093,2011-05-13,2,0,5,18,0,5,1,3,0.52,0.5,0.88,0.1642,39,359,398,398,True
3094,2011-05-13,2,0,5,19,0,5,1,2,0.52,0.5,0.83,0.194,25,245,270,270,True
3095,2011-05-13,2,0,5,20,0,5,1,2,0.52,0.5,0.83,0.1343,22,130,152,152,True
3096,2011-05-13,2,0,5,21,0,5,1,2,0.52,0.5,0.84,0.1642,24,130,154,154,True
3097,2011-05-13,2,0,5,22,0,5,1,2,0.52,0.5,0.83,0.2239,25,107,132,132,True
3098,2011-05-13,2,0,5,23,0,5,1,3,0.5,0.4848,0.88,0.1642,31,88,119,119,True
3099,2011-05-14,2,0,5,0,0,6,0,2,0.5,0.4848,0.88,0.1343,24,78,102,102,True
3100,2011-05-14,2,0,5,1,0,6,0,2,0.5,0.4848,0.88,0.1343,18,64,82,82,True
3101,2011-05-14,2,0,5,2,0,6,0,2,0.5,0.4848,0.88,0.1343,15,37,52,52,True
3102,2011-05-14,2,0,5,3,0,6,0,2,0.5,0.4848,0.88,0.1343,5,30,35,35,True
3103,2011-05-14,2,0,5,4,0,6,0,2,0.5,0.4848,0.82,0.1642,1,4,5,5,True
3104,2011-05-14,2,0,5,5,0,6,0,2,0.5,0.4848,0.82,0.1045,7,7,14,14,True
3105,2011-05-14,2,0,5,6,0,6,0,2,0.5,0.4848,0.88,0.1045,2,9,11,11,True
3106,2011-05-14,2,0,5,7,0,6,0,3,0.48,0.4697,1.0,0.0,4,28,32,32,True
3107,2011-05-14,2,0,5,8,0,6,0,3,0.5,0.4848,0.94,0.0,16,72,88,88,True
3108,2011-05-14,2,0,5,9,0,6,0,2,0.52,0.5,0.94,0.0896,14,86,100,100,True
3109,2011-05-14,2,0,5,10,0,6,0,2,0.52,0.5,0.94,0.1642,34,133,167,167,True
3110,2011-05-14,2,0,5,11,0,6,0,2,0.52,0.5,0.94,0.1343,72,207,279,279,True
3111,2011-05-14,2,0,5,12,0,6,0,3,0.52,0.5,1.0,0.0896,75,204,279,279,True
3112,2011-05-14,2,0,5,13,0,6,0,3,0.52,0.5,1.0,0.0896,68,180,248,248,True
3113,2011-05-14,2,0,5,14,0,6,0,2,0.54,0.5152,0.94,0.1343,57,159,216,216,True
3114,2011-05-14,2,0,5,15,0,6,0,2,0.54,0.5152,0.94,0.1642,73,221,294,294,True
3115,2011-05-14,2,0,5,16,0,6,0,2,0.54,0.5152,0.94,0.194,107,188,295,295,True
3116,2011-05-14,2,0,5,17,0,6,0,2,0.56,0.5303,0.88,0.194,78,194,272,272,True
3117,2011-05-14,2,0,5,18,0,6,0,2,0.56,0.5303,0.88,0.2239,88,216,304,304,True
3118,2011-05-14,2,0,5,19,0,6,0,3,0.54,0.5152,0.94,0.1343,69,179,248,248,True
3119,2011-05-14,2,0,5,20,0,6,0,3,0.54,0.5152,0.94,0.1343,42,115,157,157,True
3120,2011-05-14,2,0,5,21,0,6,0,3,0.54,0.5152,0.94,0.2239,15,44,59,59,True
3121,2011-05-14,2,0,5,22,0,6,0,3,0.54,0.5152,0.94,0.1642,7,19,26,26,True
3122,2011-05-14,2,0,5,23,0,6,0,3,0.52,0.5,1.0,0.194,11,33,44,44,True
3123,2011-05-15,2,0,5,0,0,0,0,2,0.52,0.5,1.0,0.0,5,34,39,39,True
3124,2011-05-15,2,0,5,1,0,0,0,2,0.52,0.5,1.0,0.1045,4,43,47,47,True
3125,2011-05-15,2,0,5,2,0,0,0,2,0.52,0.5,1.0,0.1343,13,37,50,50,True
3126,2011-05-15,2,0,5,3,0,0,0,2,0.52,0.5,1.0,0.0,11,21,32,32,True
3127,2011-05-15,2,0,5,4,0,0,0,2,0.52,0.5,1.0,0.0,5,8,13,13,True
3128,2011-05-15,2,0,5,5,0,0,0,3,0.52,0.5,1.0,0.1045,3,11,14,14,True
3129,2011-05-15,2,0,5,6,0,0,0,2,0.52,0.5,1.0,0.1343,3,14,17,17,True
3130,2011-05-15,2,0,5,7,0,0,0,2,0.52,0.5,1.0,0.1343,4,38,42,42,True
3131,2011-05-15,2,0,5,8,0,0,0,2,0.54,0.5152,0.94,0.1343,24,46,70,70,True
3132,2011-05-15,2,0,5,9,0,0,0,1,0.58,0.5455,0.83,0.2537,36,98,134,134,True
3133,2011-05-15,2,0,5,10,0,0,0,1,0.58,0.5455,0.83,0.2239,73,153,226,226,True
3134,2011-05-15,2,0,5,11,0,0,0,1,0.6,0.5758,0.78,0.2239,114,202,316,316,True
3135,2011-05-15,2,0,5,12,0,0,0,1,0.62,0.5909,0.73,0.2985,114,247,361,361,True
3136,2011-05-15,2,0,5,13,0,0,0,1,0.62,0.5909,0.73,0.2836,114,261,375,375,True
3137,2011-05-15,2,0,5,14,0,0,0,1,0.64,0.6061,0.73,0.194,114,254,368,368,True
3138,2011-05-15,2,0,5,15,0,0,0,1,0.66,0.6212,0.69,0.2537,114,253,367,367,True
3139,2011-05-15,2,0,5,16,0,0,0,1,0.64,0.6061,0.69,0.2537,114,282,396,396,True
3140,2011-05-15,2,0,5,17,0,0,0,3,0.56,0.5303,0.78,0.3582,114,255,369,369,True
3141,2011-05-15,2,0,5,18,0,0,0,1,0.56,0.5303,0.78,0.2537,60,177,237,237,True
3142,2011-05-15,2,0,5,19,0,0,0,1,0.56,0.5303,0.83,0.1045,78,153,231,231,True
3143,2011-05-15,2,0,5,20,0,0,0,1,0.54,0.5152,0.88,0.0,53,138,191,191,True
3144,2011-05-15,2,0,5,21,0,0,0,1,0.54,0.5152,0.88,0.0,44,107,151,151,True
3145,2011-05-15,2,0,5,22,0,0,0,1,0.56,0.5303,0.83,0.0,29,88,117,117,True
3146,2011-05-15,2,0,5,23,0,0,0,1,0.54,0.5152,0.88,0.2239,18,51,69,69,True
3147,2011-05-16,2,0,5,0,0,1,1,1,0.52,0.5,0.94,0.1045,17,21,38,38,True
3148,2011-05-16,2,0,5,1,0,1,1,1,0.52,0.5,0.94,0.1343,6,8,14,14,True
3149,2011-05-16,2,0,5,2,0,1,1,1,0.5,0.4848,1.0,0.0896,4,9,13,13,True
3150,2011-05-16,2,0,5,3,0,1,1,1,0.5,0.4848,0.94,0.1642,1,3,4,4,True
3151,2011-05-16,2,0,5,4,0,1,1,1,0.5,0.4848,1.0,0.1343,1,5,6,6,True
3152,2011-05-16,2,0,5,5,0,1,1,1,0.5,0.4848,0.93,0.194,1,20,21,21,True
3153,2011-05-16,2,0,5,6,0,1,1,1,0.52,0.5,0.88,0.1642,11,93,104,104,True
3154,2011-05-16,2,0,5,7,0,1,1,1,0.52,0.5,0.83,0.2836,27,245,272,272,True
3155,2011-05-16,2,0,5,8,0,1,1,1,0.56,0.5303,0.73,0.2985,28,366,394,394,True
3156,2011-05-16,2,0,5,9,0,1,1,1,0.6,0.5909,0.69,0.194,38,156,194,194,True
3157,2011-05-16,2,0,5,10,0,1,1,1,0.62,0.6061,0.65,0.0896,37,75,112,112,True
3158,2011-05-16,2,0,5,11,0,1,1,1,0.64,0.6212,0.57,0.0,56,129,185,185,True
3159,2011-05-16,2,0,5,12,0,1,1,1,0.66,0.6212,0.54,0.0896,72,137,209,209,True
3160,2011-05-16,2,0,5,13,0,1,1,1,0.68,0.6364,0.51,0.0,61,153,214,214,True
3161,2011-05-16,2,0,5,14,0,1,1,1,0.68,0.6364,0.51,0.0,76,117,193,193,True
3162,2011-05-16,2,0,5,15,0,1,1,1,0.72,0.6667,0.51,0.0,55,110,165,165,True
3163,2011-05-16,2,0,5,16,0,1,1,3,0.6,0.5758,0.78,0.2537,45,181,226,226,True
3164,2011-05-16,2,0,5,17,0,1,1,1,0.58,0.5455,0.88,0.2239,47,227,274,274,True
3165,2011-05-16,2,0,5,18,0,1,1,3,0.58,0.5455,0.83,0.194,55,398,453,453,True
3166,2011-05-16,2,0,5,19,0,1,1,1,0.58,0.5455,0.83,0.2537,36,272,308,308,True
3167,2011-05-16,2,0,5,20,0,1,1,1,0.58,0.5455,0.83,0.0,31,167,198,198,True
3168,2011-05-16,2,0,5,21,0,1,1,1,0.58,0.5455,0.83,0.0,28,149,177,177,True
3169,2011-05-16,2,0,5,22,0,1,1,1,0.56,0.5303,0.88,0.0896,22,105,127,127,True
3170,2011-05-16,2,0,5,23,0,1,1,1,0.56,0.5303,0.88,0.0896,18,39,57,57,True
3171,2011-05-17,2,0,5,0,0,2,1,2,0.56,0.5303,0.88,0.0,13,18,31,31,True
3172,2011-05-17,2,0,5,1,0,2,1,3,0.56,0.5303,0.88,0.0,7,6,13,13,True
3173,2011-05-17,2,0,5,2,0,2,1,3,0.56,0.5303,0.88,0.0,4,4,8,8,True
3174,2011-05-17,2,0,5,3,0,2,1,3,0.54,0.5152,0.94,0.2537,1,3,4,4,True
3175,2011-05-17,2,0,5,4,0,2,1,3,0.54,0.5152,0.94,0.2537,2,2,4,4,True
3176,2011-05-17,2,0,5,5,0,2,1,3,0.52,0.5,0.94,0.2537,0,22,22,22,True
3177,2011-05-17,2,0,5,6,0,2,1,3,0.52,0.5,0.94,0.2537,0,49,49,49,True
3178,2011-05-17,2,0,5,7,0,2,1,2,0.52,0.5,0.94,0.2537,13,138,151,151,True
3179,2011-05-17,2,0,5,8,0,2,1,2,0.52,0.5,0.94,0.2985,22,325,347,347,True
3180,2011-05-17,2,0,5,9,0,2,1,2,0.54,0.5152,0.88,0.2537,17,190,207,207,True
3181,2011-05-17,2,0,5,10,0,2,1,3,0.54,0.5152,0.88,0.2537,31,73,104,104,True
3182,2011-05-17,2,0,5,11,0,2,1,2,0.56,0.5303,0.83,0.4179,26,104,130,130,True
3183,2011-05-17,2,0,5,12,0,2,1,3,0.56,0.5303,0.83,0.4179,38,115,153,153,True
3184,2011-05-17,2,0,5,13,0,2,1,2,0.56,0.5303,0.88,0.3284,31,141,172,172,True
3185,2011-05-17,2,0,5,14,0,2,1,1,0.62,0.5909,0.73,0.4627,61,123,184,184,True
3186,2011-05-17,2,0,5,15,0,2,1,1,0.62,0.6061,0.69,0.4478,79,131,210,210,True
3187,2011-05-17,2,0,5,16,0,2,1,1,0.62,0.6061,0.61,0.3284,73,217,290,290,True
3188,2011-05-17,2,0,5,17,0,2,1,1,0.62,0.6061,0.65,0.4179,83,499,582,582,True
3189,2011-05-17,2,0,5,18,0,2,1,1,0.6,0.5909,0.69,0.2985,54,426,480,480,True
3190,2011-05-17,2,0,5,19,0,2,1,1,0.6,0.5909,0.69,0.2537,51,298,349,349,True
3191,2011-05-17,2,0,5,20,0,2,1,1,0.58,0.5455,0.83,0.4179,30,253,283,283,True
3192,2011-05-17,2,0,5,21,0,2,1,1,0.54,0.5152,0.88,0.2537,23,151,174,174,True
3193,2011-05-17,2,0,5,22,0,2,1,2,0.54,0.5152,0.88,0.2836,12,86,98,98,True
3194,2011-05-17,2,0,5,23,0,2,1,2,0.54,0.5152,0.88,0.2537,7,49,56,56,True
3195,2011-05-18,2,0,5,0,0,3,1,2,0.54,0.5152,0.88,0.2239,8,15,23,23,True
3196,2011-05-18,2,0,5,1,0,3,1,2,0.54,0.5152,0.88,0.2537,3,9,12,12,True
3197,2011-05-18,2,0,5,2,0,3,1,3,0.52,0.5,0.94,0.2239,1,5,6,6,True
3198,2011-05-18,2,0,5,3,0,3,1,3,0.52,0.5,0.94,0.2985,6,3,9,9,True
3199,2011-05-18,2,0,5,4,0,3,1,3,0.52,0.5,0.94,0.2985,1,2,3,3,True
3200,2011-05-18,2,0,5,5,0,3,1,1,0.52,0.5,1.0,0.2239,0,9,9,9,True
3201,2011-05-18,2,0,5,6,0,3,1,1,0.52,0.5,1.0,0.1343,2,99,101,101,True
3202,2011-05-18,2,0,5,7,0,3,1,1,0.54,0.5152,0.88,0.194,14,260,274,274,True
3203,2011-05-18,2,0,5,8,0,3,1,1,0.56,0.5303,0.88,0.2836,25,428,453,453,True
3204,2011-05-18,2,0,5,9,0,3,1,3,0.56,0.5303,0.83,0.2537,26,176,202,202,True
3205,2011-05-18,2,0,5,10,0,3,1,3,0.54,0.5152,0.88,0.2836,33,73,106,106,True
3206,2011-05-18,2,0,5,11,0,3,1,2,0.54,0.5152,0.94,0.0896,6,17,23,23,True
3207,2011-05-18,2,0,5,12,0,3,1,1,0.56,0.5303,0.94,0.2985,12,42,54,54,True
3208,2011-05-18,2,0,5,13,0,3,1,2,0.56,0.5303,0.83,0.3284,30,92,122,122,True
3209,2011-05-18,2,0,5,14,0,3,1,2,0.58,0.5455,0.78,0.2836,44,94,138,138,True
3210,2011-05-18,2,0,5,15,0,3,1,1,0.6,0.5758,0.78,0.2537,34,133,167,167,True
3211,2011-05-18,2,0,5,16,0,3,1,1,0.6,0.5909,0.73,0.194,53,241,294,294,True
3212,2011-05-18,2,0,5,17,0,3,1,1,0.6,0.5909,0.69,0.1343,78,487,565,565,True
3213,2011-05-18,2,0,5,18,0,3,1,1,0.6,0.5909,0.73,0.2239,58,431,489,489,True
3214,2011-05-18,2,0,5,19,0,3,1,3,0.56,0.5303,0.88,0.1343,43,288,331,331,True
3215,2011-05-18,2,0,5,20,0,3,1,3,0.56,0.5303,0.88,0.1343,24,189,213,213,True
3216,2011-05-18,2,0,5,21,0,3,1,1,0.52,0.5,0.88,0.0,11,74,85,85,True
3217,2011-05-18,2,0,5,22,0,3,1,1,0.52,0.5,0.83,0.0,14,103,117,117,True
3218,2011-05-18,2,0,5,23,0,3,1,1,0.52,0.5,0.94,0.0896,10,49,59,59,True
3219,2011-05-19,2,0,5,0,0,4,1,1,0.52,0.5,0.94,0.1045,6,23,29,29,True
3220,2011-05-19,2,0,5,1,0,4,1,1,0.5,0.4848,0.94,0.0,2,4,6,6,True
3221,2011-05-19,2,0,5,2,0,4,1,1,0.5,0.4848,0.94,0.0,3,12,15,15,True
3222,2011-05-19,2,0,5,3,0,4,1,1,0.48,0.4697,1.0,0.0,1,3,4,4,True
3223,2011-05-19,2,0,5,4,0,4,1,1,0.48,0.4697,0.94,0.0,2,3,5,5,True
3224,2011-05-19,2,0,5,5,0,4,1,1,0.48,0.4697,0.94,0.0,2,24,26,26,True
3225,2011-05-19,2,0,5,6,0,4,1,2,0.5,0.4848,0.94,0.0,17,86,103,103,True
3226,2011-05-19,2,0,5,7,0,4,1,2,0.5,0.4848,1.0,0.0,18,239,257,257,True
3227,2011-05-19,2,0,5,8,0,4,1,2,0.52,0.5,0.88,0.0,34,453,487,487,True
3228,2011-05-19,2,0,5,9,0,4,1,2,0.54,0.5152,0.88,0.0896,40,176,216,216,True
3229,2011-05-19,2,0,5,10,0,4,1,2,0.54,0.5152,0.83,0.0,35,95,130,130,True
3230,2011-05-19,2,0,5,11,0,4,1,3,0.54,0.5152,0.88,0.1642,53,111,164,164,True
3231,2011-05-19,2,0,5,12,0,4,1,2,0.58,0.5455,0.78,0.1045,38,130,168,168,True
3232,2011-05-19,2,0,5,13,0,4,1,3,0.58,0.5455,0.64,0.2537,44,139,183,183,True
3233,2011-05-19,2,0,5,14,0,4,1,3,0.54,0.5152,0.73,0.194,43,137,180,180,True
3234,2011-05-19,2,0,5,15,0,4,1,1,0.56,0.5303,0.78,0.1642,63,125,188,188,True
3235,2011-05-19,2,0,5,16,0,4,1,1,0.58,0.5455,0.64,0.194,55,247,302,302,True
3236,2011-05-19,2,0,5,17,0,4,1,1,0.56,0.5303,0.78,0.1642,60,487,547,547,True
3237,2011-05-19,2,0,5,18,0,4,1,1,0.6,0.6212,0.55,0.1642,59,454,513,513,True
3238,2011-05-19,2,0,5,19,0,4,1,1,0.58,0.5455,0.6,0.1343,65,345,410,410,True
3239,2011-05-19,2,0,5,20,0,4,1,1,0.54,0.5152,0.77,0.2836,46,236,282,282,True
3240,2011-05-19,2,0,5,21,0,4,1,1,0.54,0.5152,0.77,0.2836,29,180,209,209,True
3241,2011-05-19,2,0,5,22,0,4,1,3,0.5,0.4848,0.82,0.2985,11,68,79,79,True
3242,2011-05-19,2,0,5,23,0,4,1,1,0.48,0.4697,0.94,0.0,9,63,72,72,True
3243,2011-05-20,2,0,5,0,0,5,1,1,0.46,0.4545,0.94,0.0896,15,33,48,48,True
3244,2011-05-20,2,0,5,1,0,5,1,1,0.46,0.4545,1.0,0.0,8,17,25,25,True
3245,2011-05-20,2,0,5,2,0,5,1,1,0.44,0.4394,1.0,0.0896,4,4,8,8,True
3246,2011-05-20,2,0,5,3,0,5,1,1,0.44,0.4394,1.0,0.0,1,4,5,5,True
3247,2011-05-20,2,0,5,4,0,5,1,1,0.44,0.4394,0.94,0.0896,1,4,5,5,True
3248,2011-05-20,2,0,5,5,0,5,1,1,0.44,0.4394,0.94,0.1045,0,28,28,28,True
3249,2011-05-20,2,0,5,6,0,5,1,1,0.46,0.4545,0.88,0.1045,15,102,117,117,True
3250,2011-05-20,2,0,5,7,0,5,1,1,0.5,0.4848,0.77,0.1642,30,289,319,319,True
3251,2011-05-20,2,0,5,8,0,5,1,1,0.54,0.5152,0.68,0.0,41,476,517,517,True
3252,2011-05-20,2,0,5,9,0,5,1,1,0.54,0.5152,0.68,0.2239,35,199,234,234,True
3253,2011-05-20,2,0,5,10,0,5,1,1,0.56,0.5303,0.64,0.194,44,104,148,148,True
3254,2011-05-20,2,0,5,11,0,5,1,2,0.58,0.5455,0.6,0.194,63,133,196,196,True
3255,2011-05-20,2,0,5,12,0,5,1,2,0.6,0.6212,0.56,0.2537,69,186,255,255,True
3256,2011-05-20,2,0,5,13,0,5,1,3,0.6,0.6212,0.56,0.2836,60,172,232,232,True
3257,2011-05-20,2,0,5,14,0,5,1,1,0.62,0.6212,0.53,0.2239,66,131,197,197,True
3258,2011-05-20,2,0,5,15,0,5,1,2,0.6,0.6212,0.56,0.194,74,168,242,242,True
3259,2011-05-20,2,0,5,16,0,5,1,2,0.6,0.6212,0.53,0.1642,61,269,330,330,True
3260,2011-05-20,2,0,5,17,0,5,1,1,0.62,0.6212,0.53,0.0,71,483,554,554,True
3261,2011-05-20,2,0,5,18,0,5,1,1,0.6,0.6212,0.56,0.1642,79,394,473,473,True
3262,2011-05-20,2,0,5,19,0,5,1,1,0.58,0.5455,0.64,0.0896,49,253,302,302,True
3263,2011-05-20,2,0,5,20,0,5,1,1,0.58,0.5455,0.64,0.1045,40,180,220,220,True
3264,2011-05-20,2,0,5,21,0,5,1,1,0.56,0.5303,0.64,0.1045,40,155,195,195,True
3265,2011-05-20,2,0,5,22,0,5,1,1,0.54,0.5152,0.73,0.0,28,124,152,152,True
3266,2011-05-20,2,0,5,23,0,5,1,1,0.52,0.5,0.72,0.1642,15,100,115,115,True
3267,2011-05-21,2,0,5,0,0,6,0,1,0.52,0.5,0.77,0.1045,20,78,98,98,True
3268,2011-05-21,2,0,5,1,0,6,0,1,0.52,0.5,0.72,0.0,8,64,72,72,True
3269,2011-05-21,2,0,5,2,0,6,0,1,0.52,0.5,0.72,0.1045,5,35,40,40,True
3270,2011-05-21,2,0,5,3,0,6,0,1,0.48,0.4697,0.82,0.1045,7,12,19,19,True
3271,2011-05-21,2,0,5,4,0,6,0,1,0.46,0.4545,0.88,0.1343,1,6,7,7,True
3272,2011-05-21,2,0,5,5,0,6,0,1,0.46,0.4545,0.88,0.1045,1,4,5,5,True
3273,2011-05-21,2,0,5,6,0,6,0,1,0.5,0.4848,0.82,0.1343,6,22,28,28,True
3274,2011-05-21,2,0,5,7,0,6,0,1,0.54,0.5152,0.73,0.1343,10,33,43,43,True
3275,2011-05-21,2,0,5,8,0,6,0,1,0.56,0.5303,0.68,0.2836,29,97,126,126,True
3276,2011-05-21,2,0,5,9,0,6,0,1,0.6,0.6061,0.64,0.2239,60,165,225,225,True
3277,2011-05-21,2,0,5,10,0,6,0,1,0.62,0.6061,0.61,0.1045,114,201,315,315,True
3278,2011-05-21,2,0,5,11,0,6,0,1,0.64,0.6212,0.53,0.1343,114,245,359,359,True
3279,2011-05-21,2,0,5,12,0,6,0,1,0.66,0.6212,0.5,0.0,114,271,385,385,True
3280,2011-05-21,2,0,5,13,0,6,0,1,0.7,0.6364,0.45,0.0,114,271,385,385,True
3281,2011-05-21,2,0,5,14,0,6,0,1,0.72,0.6515,0.42,0.0,114,269,383,383,True
3282,2011-05-21,2,0,5,15,0,6,0,1,0.72,0.6515,0.45,0.2537,114,274,388,388,True
3283,2011-05-21,2,0,5,16,0,6,0,2,0.72,0.6515,0.39,0.2537,114,267,381,381,True
3284,2011-05-21,2,0,5,17,0,6,0,2,0.72,0.6515,0.42,0.1642,114,253,367,367,True
3285,2011-05-21,2,0,5,18,0,6,0,2,0.7,0.6364,0.45,0.1642,114,253,367,367,True
3286,2011-05-21,2,0,5,19,0,6,0,1,0.68,0.6364,0.47,0.1642,114,184,298,298,True
3287,2011-05-21,2,0,5,20,0,6,0,1,0.62,0.6061,0.61,0.0,84,164,248,248,True
3288,2011-05-21,2,0,5,21,0,6,0,1,0.62,0.6061,0.61,0.1045,77,150,227,227,True
3289,2011-05-21,2,0,5,22,0,6,0,1,0.6,0.5909,0.69,0.1343,78,126,204,204,True
3290,2011-05-21,2,0,5,23,0,6,0,1,0.58,0.5455,0.78,0.0896,42,103,145,145,True
3291,2011-05-22,2,0,5,0,0,0,0,1,0.54,0.5152,0.88,0.1642,31,100,131,131,True
3292,2011-05-22,2,0,5,1,0,0,0,1,0.52,0.5,0.94,0.1343,17,81,98,98,True
3293,2011-05-22,2,0,5,2,0,0,0,1,0.52,0.5,0.94,0.1045,18,50,68,68,True
3294,2011-05-22,2,0,5,3,0,0,0,1,0.5,0.4848,1.0,0.1045,10,23,33,33,True
3295,2011-05-22,2,0,5,4,0,0,0,1,0.5,0.4848,1.0,0.0,3,9,12,12,True
3296,2011-05-22,2,0,5,5,0,0,0,1,0.5,0.4848,1.0,0.1045,1,5,6,6,True
3297,2011-05-22,2,0,5,6,0,0,0,1,0.52,0.5,0.94,0.1045,5,13,18,18,True
3298,2011-05-22,2,0,5,7,0,0,0,1,0.54,0.5152,0.88,0.1045,13,27,40,40,True
3299,2011-05-22,2,0,5,8,0,0,0,1,0.6,0.5909,0.73,0.0896,29,65,94,94,True
3300,2011-05-22,2,0,5,9,0,0,0,1,0.62,0.6061,0.69,0.1045,59,130,189,189,True
3301,2011-05-22,2,0,5,10,0,0,0,1,0.64,0.6061,0.65,0.1343,114,170,284,284,True
3302,2011-05-22,2,0,5,11,0,0,0,1,0.7,0.6515,0.54,0.194,114,209,323,323,True
3303,2011-05-22,2,0,5,12,0,0,0,2,0.72,0.6667,0.51,0.194,114,255,369,369,True
3304,2011-05-22,2,0,5,13,0,0,0,2,0.66,0.6212,0.54,0.2239,114,275,389,389,True
3305,2011-05-22,2,0,5,14,0,0,0,3,0.62,0.6061,0.69,0.194,114,191,305,305,True
3306,2011-05-22,2,0,5,15,0,0,0,2,0.66,0.6212,0.61,0.1642,110,221,331,331,True
3307,2011-05-22,2,0,5,16,0,0,0,1,0.68,0.6364,0.61,0.1343,72,201,273,273,True
3308,2011-05-22,2,0,5,17,0,0,0,1,0.7,0.6515,0.58,0.2537,93,213,306,306,True
3309,2011-05-22,2,0,5,18,0,0,0,1,0.66,0.6212,0.61,0.2239,114,238,352,352,True
3310,2011-05-22,2,0,5,19,0,0,0,1,0.66,0.6212,0.61,0.194,107,193,300,300,True
3311,2011-05-22,2,0,5,20,0,0,0,1,0.64,0.6061,0.65,0.1642,57,174,231,231,True
3312,2011-05-22,2,0,5,21,0,0,0,1,0.62,0.5909,0.73,0.194,27,109,136,136,True
3313,2011-05-22,2,0,5,22,0,0,0,1,0.6,0.5606,0.83,0.1343,35,86,121,121,True
3314,2011-05-22,2,0,5,23,0,0,0,2,0.58,0.5455,0.83,0.1343,19,46,65,65,True
3315,2011-05-23,2,0,5,0,0,1,1,2,0.56,0.5303,0.88,0.1343,23,18,41,41,True
3316,2011-05-23,2,0,5,1,0,1,1,1,0.56,0.5303,0.88,0.1045,4,5,9,9,True
3317,2011-05-23,2,0,5,2,0,1,1,3,0.56,0.5303,0.88,0.1642,2,3,5,5,True
3318,2011-05-23,2,0,5,3,0,1,1,3,0.54,0.5152,0.94,0.1642,0,4,4,4,True
3319,2011-05-23,2,0,5,4,0,1,1,2,0.54,0.5152,0.94,0.0,2,2,4,4,True
3320,2011-05-23,2,0,5,5,0,1,1,2,0.54,0.5152,0.94,0.0,0,11,11,11,True
3321,2011-05-23,2,0,5,6,0,1,1,2,0.54,0.5152,1.0,0.0,4,92,96,96,True
3322,2011-05-23,2,0,5,7,0,1,1,2,0.56,0.5303,0.94,0.1045,13,223,236,236,True
3323,2011-05-23,2,0,5,8,0,1,1,1,0.6,0.5455,0.88,0.194,50,359,409,409,True
3324,2011-05-23,2,0,5,9,0,1,1,1,0.6,0.5455,0.88,0.2239,36,131,167,167,True
3325,2011-05-23,2,0,5,10,0,1,1,1,0.66,0.6212,0.74,0.2985,49,72,121,121,True
3326,2011-05-23,2,0,5,11,0,1,1,1,0.68,0.6364,0.69,0.3881,73,107,180,180,True
3327,2011-05-23,2,0,5,12,0,1,1,1,0.68,0.6364,0.69,0.3881,65,139,204,204,True
3328,2011-05-23,2,0,5,13,0,1,1,2,0.74,0.6818,0.58,0.4179,49,155,204,204,True
3329,2011-05-23,2,0,5,14,0,1,1,2,0.72,0.6818,0.62,0.4775,57,130,187,187,True
3330,2011-05-23,2,0,5,15,0,1,1,2,0.72,0.6818,0.62,0.4478,57,119,176,176,True
3331,2011-05-23,2,0,5,16,0,1,1,2,0.72,0.6818,0.62,0.2985,56,223,279,279,True
3332,2011-05-23,2,0,5,17,0,1,1,3,0.72,0.6818,0.7,0.3881,56,373,429,429,True
3333,2011-05-23,2,0,5,18,0,1,1,1,0.7,0.6667,0.74,0.2836,68,385,453,453,True
3334,2011-05-23,2,0,5,19,0,1,1,1,0.7,0.6667,0.74,0.2239,56,302,358,358,True
3335,2011-05-23,2,0,5,20,0,1,1,1,0.64,0.5758,0.83,0.2239,39,271,310,310,True
3336,2011-05-23,2,0,5,21,0,1,1,1,0.64,0.5758,0.89,0.2239,33,155,188,188,True
3337,2011-05-23,2,0,5,22,0,1,1,1,0.62,0.5455,0.94,0.2239,25,106,131,131,True
3338,2011-05-23,2,0,5,23,0,1,1,2,0.62,0.5606,0.88,0.194,19,53,72,72,True
3339,2011-05-24,2,0,5,0,0,2,1,2,0.6,0.5152,0.94,0.194,12,23,35,35,True
3340,2011-05-24,2,0,5,1,0,2,1,2,0.6,0.5152,0.94,0.1642,6,9,15,15,True
3341,2011-05-24,2,0,5,2,0,2,1,2,0.6,0.5152,0.94,0.194,2,8,10,10,True
3342,2011-05-24,2,0,5,3,0,2,1,2,0.58,0.5455,0.94,0.1045,0,2,2,2,True
3343,2011-05-24,2,0,5,4,0,2,1,1,0.6,0.5455,0.88,0.1045,1,3,4,4,True
3344,2011-05-24,2,0,5,5,0,2,1,2,0.58,0.5455,0.94,0.2537,2,22,24,24,True
3345,2011-05-24,2,0,5,6,0,2,1,2,0.58,0.5455,0.94,0.194,10,102,112,112,True
3346,2011-05-24,2,0,5,7,0,2,1,3,0.64,0.5909,0.78,0.194,26,288,314,314,True
3347,2011-05-24,2,0,5,8,0,2,1,3,0.62,0.5758,0.83,0.2239,31,403,434,434,True
3348,2011-05-24,2,0,5,9,0,2,1,2,0.64,0.6061,0.73,0.194,27,111,138,138,True
3349,2011-05-24,2,0,5,10,0,2,1,1,0.7,0.6515,0.61,0.3284,18,90,108,108,True
3350,2011-05-24,2,0,5,11,0,2,1,1,0.74,0.6667,0.51,0.2239,33,142,175,175,True
3351,2011-05-24,2,0,5,12,0,2,1,1,0.76,0.6818,0.45,0.3881,41,129,170,170,True
3352,2011-05-24,2,0,5,13,0,2,1,1,0.78,0.697,0.46,0.2537,38,152,190,190,True
3353,2011-05-24,2,0,5,14,0,2,1,1,0.78,0.697,0.46,0.2836,27,126,153,153,True
3354,2011-05-24,2,0,5,15,0,2,1,3,0.74,0.6818,0.55,0.4179,59,129,188,188,True
3355,2011-05-24,2,0,5,16,0,2,1,1,0.66,0.6212,0.69,0.194,52,225,277,277,True
3356,2011-05-24,2,0,5,17,0,2,1,1,0.7,0.6515,0.61,0.1045,56,492,548,548,True
3357,2011-05-24,2,0,5,18,0,2,1,1,0.7,0.6515,0.7,0.194,74,490,564,564,True
3358,2011-05-24,2,0,5,19,0,2,1,1,0.66,0.6212,0.74,0.194,45,310,355,355,True
3359,2011-05-24,2,0,5,20,0,2,1,1,0.66,0.6212,0.74,0.0896,39,241,280,280,True
3360,2011-05-24,2,0,5,21,0,2,1,1,0.64,0.5909,0.78,0.0896,21,168,189,189,True
3361,2011-05-24,2,0,5,22,0,2,1,3,0.62,0.5606,0.88,0.2239,26,115,141,141,True
3362,2011-05-24,2,0,5,23,0,2,1,3,0.66,0.6212,0.74,0.1642,13,53,66,66,True
3363,2011-05-25,2,0,5,0,0,3,1,3,0.6,0.5606,0.83,0.2239,3,32,35,35,True
3364,2011-05-25,2,0,5,1,0,3,1,3,0.58,0.5455,0.83,0.194,6,2,8,8,True
3365,2011-05-25,2,0,5,2,0,3,1,2,0.56,0.5303,0.94,0.0,0,8,8,8,True
3366,2011-05-25,2,0,5,3,0,3,1,1,0.54,0.5152,1.0,0.1343,0,9,9,9,True
3367,2011-05-25,2,0,5,4,0,3,1,1,0.54,0.5152,1.0,0.1045,0,3,3,3,True
3368,2011-05-25,2,0,5,5,0,3,1,1,0.56,0.5303,0.88,0.0896,2,23,25,25,True
3369,2011-05-25,2,0,5,6,0,3,1,1,0.56,0.5303,0.94,0.0896,4,113,117,117,True
3370,2011-05-25,2,0,5,7,0,3,1,1,0.62,0.5909,0.73,0.1343,29,284,313,313,True
3371,2011-05-25,2,0,5,8,0,3,1,1,0.64,0.6061,0.69,0.2239,36,495,531,531,True
3372,2011-05-25,2,0,5,9,0,3,1,1,0.68,0.6364,0.65,0.0896,27,207,234,234,True
3373,2011-05-25,2,0,5,10,0,3,1,1,0.7,0.6515,0.61,0.0896,30,105,135,135,True
3374,2011-05-25,2,0,5,11,0,3,1,1,0.74,0.6667,0.51,0.0896,36,104,140,140,True
3375,2011-05-25,2,0,5,12,0,3,1,1,0.74,0.6818,0.55,0.1343,32,178,210,210,True
3376,2011-05-25,2,0,5,13,0,3,1,1,0.74,0.6818,0.55,0.1343,39,163,202,202,True
3377,2011-05-25,2,0,5,14,0,3,1,1,0.74,0.6818,0.55,0.1642,47,121,168,168,True
3378,2011-05-25,2,0,5,15,0,3,1,1,0.76,0.697,0.52,0.2537,37,145,182,182,True
3379,2011-05-25,2,0,5,16,0,3,1,1,0.74,0.6667,0.51,0.2836,61,238,299,299,True
3380,2011-05-25,2,0,5,17,0,3,1,1,0.74,0.6667,0.51,0.2239,77,499,576,576,True
3381,2011-05-25,2,0,5,18,0,3,1,1,0.72,0.6667,0.58,0.2239,66,451,517,517,True
3382,2011-05-25,2,0,5,19,0,3,1,1,0.7,0.6515,0.61,0.1343,73,332,405,405,True
3383,2011-05-25,2,0,5,20,0,3,1,1,0.7,0.6515,0.61,0.1642,56,284,340,340,True
3384,2011-05-25,2,0,5,21,0,3,1,1,0.66,0.6212,0.69,0.1343,33,203,236,236,True
3385,2011-05-25,2,0,5,22,0,3,1,1,0.66,0.6212,0.69,0.2537,34,140,174,174,True
3386,2011-05-25,2,0,5,23,0,3,1,1,0.64,0.6061,0.73,0.1343,12,74,86,86,True
3387,2011-05-26,2,0,5,0,0,4,1,1,0.64,0.6061,0.73,0.1343,11,34,45,45,True
3388,2011-05-26,2,0,5,1,0,4,1,1,0.64,0.6061,0.73,0.1343,3,13,16,16,True
3389,2011-05-26,2,0,5,2,0,4,1,1,0.62,0.5758,0.83,0.1045,7,7,14,14,True
3390,2011-05-26,2,0,5,3,0,4,1,1,0.6,0.5455,0.88,0.0896,0,4,4,4,True
3391,2011-05-26,2,0,5,4,0,4,1,1,0.6,0.5455,0.88,0.0,0,2,2,2,True
3392,2011-05-26,2,0,5,5,0,4,1,2,0.6,0.5455,0.88,0.0896,2,25,27,27,True
3393,2011-05-26,2,0,5,6,0,4,1,2,0.6,0.5,1.0,0.0896,4,94,98,98,True
3394,2011-05-26,2,0,5,7,0,4,1,2,0.62,0.5455,0.94,0.2537,16,270,286,286,True
3395,2011-05-26,2,0,5,8,0,4,1,2,0.66,0.6061,0.83,0.1642,31,458,489,489,True
3396,2011-05-26,2,0,5,9,0,4,1,1,0.72,0.6818,0.7,0.1642,22,194,216,216,True
3397,2011-05-26,2,0,5,10,0,4,1,1,0.7,0.6667,0.74,0.2836,49,94,143,143,True
3398,2011-05-26,2,0,5,11,0,4,1,1,0.74,0.697,0.66,0.2239,36,124,160,160,True
3399,2011-05-26,2,0,5,12,0,4,1,1,0.78,0.7424,0.59,0.3284,53,141,194,194,True
3400,2011-05-26,2,0,5,13,0,4,1,1,0.82,0.7727,0.52,0.2836,52,145,197,197,True
3401,2011-05-26,2,0,5,14,0,4,1,1,0.82,0.7727,0.52,0.2836,44,145,189,189,True
3402,2011-05-26,2,0,5,15,0,4,1,2,0.82,0.7576,0.46,0.2836,40,101,141,141,True
3403,2011-05-26,2,0,5,16,0,4,1,2,0.8,0.7424,0.49,0.3582,58,233,291,291,True
3404,2011-05-26,2,0,5,17,0,4,1,1,0.8,0.7273,0.46,0.2836,49,445,494,494,True
3405,2011-05-26,2,0,5,18,0,4,1,1,0.8,0.7273,0.46,0.3284,74,404,478,478,True
3406,2011-05-26,2,0,5,19,0,4,1,1,0.78,0.697,0.46,0.3284,67,311,378,378,True
3407,2011-05-26,2,0,5,20,0,4,1,1,0.72,0.6667,0.58,0.1642,55,267,322,322,True
3408,2011-05-26,2,0,5,21,0,4,1,1,0.72,0.6818,0.62,0.0896,45,178,223,223,True
3409,2011-05-26,2,0,5,22,0,4,1,1,0.7,0.6515,0.65,0.1343,23,157,180,180,True
3410,2011-05-26,2,0,5,23,0,4,1,1,0.7,0.6515,0.65,0.194,17,73,90,90,True
3411,2011-05-27,2,0,5,0,0,5,1,1,0.68,0.6364,0.69,0.2537,14,55,69,69,True
3412,2011-05-27,2,0,5,1,0,5,1,1,0.7,0.6515,0.58,0.2985,14,36,50,50,True
3413,2011-05-27,2,0,5,2,0,5,1,1,0.68,0.6364,0.61,0.2239,6,12,18,18,True
3414,2011-05-27,2,0,5,3,0,5,1,1,0.66,0.6212,0.65,0.0896,1,11,12,12,True
3415,2011-05-27,2,0,5,4,0,5,1,1,0.64,0.6061,0.69,0.1343,2,5,7,7,True
3416,2011-05-27,2,0,5,5,0,5,1,1,0.64,0.6061,0.65,0.2836,2,29,31,31,True
3417,2011-05-27,2,0,5,6,0,5,1,1,0.64,0.6061,0.69,0.0896,8,73,81,81,True
3418,2011-05-27,2,0,5,7,0,5,1,1,0.64,0.6061,0.73,0.1642,20,229,249,249,True
3419,2011-05-27,2,0,5,8,0,5,1,1,0.66,0.6212,0.74,0.2836,25,393,418,418,True
3420,2011-05-27,2,0,5,9,0,5,1,1,0.7,0.6515,0.65,0.2836,37,190,227,227,True
3421,2011-05-27,2,0,5,10,0,5,1,1,0.72,0.6667,0.54,0.3881,42,111,153,153,True
3422,2011-05-27,2,0,5,11,0,5,1,2,0.74,0.6818,0.55,0.3284,40,126,166,166,True
3423,2011-05-27,2,0,5,12,0,5,1,2,0.76,0.697,0.55,0.2985,53,190,243,243,True
3424,2011-05-27,2,0,5,13,0,5,1,1,0.74,0.6818,0.58,0.194,51,158,209,209,True
3425,2011-05-27,2,0,5,14,0,5,1,1,0.76,0.697,0.55,0.2537,51,188,239,239,True
3426,2011-05-27,2,0,5,15,0,5,1,1,0.78,0.7121,0.49,0.2836,98,258,356,356,True
3427,2011-05-27,2,0,5,16,0,5,1,2,0.76,0.697,0.55,0.3881,63,356,419,419,True
3428,2011-05-27,2,0,5,17,0,5,1,1,0.74,0.6818,0.58,0.3881,77,414,491,491,True
3429,2011-05-27,2,0,5,18,0,5,1,2,0.72,0.6818,0.62,0.2985,89,310,399,399,True
3430,2011-05-27,2,0,5,19,0,5,1,3,0.6,0.5758,0.78,0.2537,69,210,279,279,True
3431,2011-05-27,2,0,5,20,0,5,1,2,0.62,0.5909,0.73,0.2239,24,120,144,144,True
3432,2011-05-27,2,0,5,21,0,5,1,1,0.6,0.5606,0.83,0.1045,37,114,151,151,True
3433,2011-05-27,2,0,5,22,0,5,1,1,0.6,0.5758,0.78,0.1343,25,116,141,141,True
3434,2011-05-27,2,0,5,23,0,5,1,1,0.58,0.5455,0.88,0.1343,23,104,127,127,True
3435,2011-05-28,2,0,5,0,0,6,0,1,0.58,0.5455,0.88,0.1343,15,79,94,94,True
3436,2011-05-28,2,0,5,1,0,6,0,1,0.58,0.5455,0.88,0.194,8,47,55,55,True
3437,2011-05-28,2,0,5,2,0,6,0,1,0.56,0.5303,0.94,0.194,13,35,48,48,True
3438,2011-05-28,2,0,5,3,0,6,0,1,0.56,0.5303,0.88,0.2239,2,13,15,15,True
3439,2011-05-28,2,0,5,4,0,6,0,1,0.56,0.5303,0.88,0.2537,0,4,4,4,True
3440,2011-05-28,2,0,5,5,0,6,0,1,0.56,0.5303,0.88,0.2239,4,3,7,7,True
3441,2011-05-28,2,0,5,6,0,6,0,1,0.58,0.5455,0.83,0.2537,3,16,19,19,True
3442,2011-05-28,2,0,5,7,0,6,0,1,0.6,0.5606,0.83,0.2537,17,33,50,50,True
3443,2011-05-28,2,0,5,8,0,6,0,1,0.62,0.5909,0.78,0.194,27,75,102,102,True
3444,2011-05-28,2,0,5,9,0,6,0,1,0.64,0.6061,0.73,0.2537,61,116,177,177,True
3445,2011-05-28,2,0,5,10,0,6,0,1,0.7,0.6515,0.65,0.2239,110,166,276,276,True
3446,2011-05-28,2,0,5,11,0,6,0,1,0.7,0.6515,0.65,0.2239,114,178,292,292,True
3447,2011-05-28,2,0,5,12,0,6,0,1,0.72,0.6667,0.58,0.2537,114,213,327,327,True
3448,2011-05-28,2,0,5,13,0,6,0,1,0.72,0.6818,0.62,0.2239,114,217,331,331,True
3449,2011-05-28,2,0,5,14,0,6,0,1,0.74,0.6818,0.58,0.2239,114,210,324,324,True
3450,2011-05-28,2,0,5,15,0,6,0,1,0.74,0.6818,0.55,0.2239,114,187,301,301,True
3451,2011-05-28,2,0,5,16,0,6,0,1,0.76,0.697,0.55,0.2836,114,201,315,315,True
3452,2011-05-28,2,0,5,17,0,6,0,1,0.74,0.6818,0.55,0.2985,114,161,275,275,True
3453,2011-05-28,2,0,5,18,0,6,0,1,0.72,0.6818,0.62,0.2537,114,212,326,326,True
3454,2011-05-28,2,0,5,19,0,6,0,1,0.7,0.6515,0.65,0.194,99,153,252,252,True
3455,2011-05-28,2,0,5,20,0,6,0,1,0.7,0.6515,0.65,0.2239,68,128,196,196,True
3456,2011-05-28,2,0,5,21,0,6,0,1,0.66,0.6212,0.74,0.2985,87,114,201,201,True
3457,2011-05-28,2,0,5,22,0,6,0,1,0.66,0.6061,0.78,0.2239,46,115,161,161,True
3458,2011-05-28,2,0,5,23,0,6,0,1,0.64,0.5758,0.83,0.194,44,81,125,125,True
3459,2011-05-29,2,0,5,0,0,0,0,1,0.64,0.5758,0.83,0.2239,32,51,83,83,True
3460,2011-05-29,2,0,5,1,0,0,0,1,0.62,0.5606,0.88,0.1642,17,49,66,66,True
3461,2011-05-29,2,0,5,2,0,0,0,1,0.62,0.5606,0.88,0.1045,12,49,61,61,True
3462,2011-05-29,2,0,5,3,0,0,0,1,0.62,0.5606,0.88,0.1045,2,24,26,26,True
3463,2011-05-29,2,0,5,4,0,0,0,1,0.6,0.5455,0.88,0.0896,13,10,23,23,True
3464,2011-05-29,2,0,5,5,0,0,0,1,0.6,0.5152,0.94,0.1642,3,3,6,6,True
3465,2011-05-29,2,0,5,6,0,0,0,2,0.62,0.5606,0.88,0.194,5,10,15,15,True
3466,2011-05-29,2,0,5,7,0,0,0,2,0.62,0.5606,0.88,0.2537,13,17,30,30,True
3467,2011-05-29,2,0,5,8,0,0,0,2,0.62,0.5606,0.88,0.2239,34,62,96,96,True
3468,2011-05-29,2,0,5,9,0,0,0,2,0.62,0.5455,0.94,0.2537,74,78,152,152,True
3469,2011-05-29,2,0,5,10,0,0,0,2,0.66,0.6061,0.83,0.2239,114,121,235,235,True
3470,2011-05-29,2,0,5,11,0,0,0,2,0.66,0.6061,0.83,0.2836,114,180,294,294,True
3471,2011-05-29,2,0,5,12,0,0,0,2,0.7,0.6667,0.74,0.2239,114,186,300,300,True
3472,2011-05-29,2,0,5,13,0,0,0,1,0.72,0.6818,0.7,0.2836,114,181,295,295,True
3473,2011-05-29,2,0,5,14,0,0,0,1,0.74,0.697,0.7,0.2836,114,168,282,282,True
3474,2011-05-29,2,0,5,15,0,0,0,1,0.74,0.697,0.7,0.2985,114,155,269,269,True
3475,2011-05-29,2,0,5,16,0,0,0,1,0.74,0.697,0.7,0.2836,114,167,281,281,True
3476,2011-05-29,2,0,5,17,0,0,0,1,0.74,0.697,0.7,0.2836,114,169,283,283,True
3477,2011-05-29,2,0,5,18,0,0,0,1,0.72,0.697,0.74,0.2836,114,177,291,291,True
3478,2011-05-29,2,0,5,19,0,0,0,1,0.72,0.697,0.74,0.2537,114,146,260,260,True
3479,2011-05-29,2,0,5,20,0,0,0,1,0.7,0.6667,0.79,0.194,91,128,219,219,True
3480,2011-05-29,2,0,5,21,0,0,0,1,0.68,0.6364,0.83,0.1642,107,122,229,229,True
3481,2011-05-29,2,0,5,22,0,0,0,1,0.66,0.5909,0.89,0.1343,78,93,171,171,True
3482,2011-05-29,2,0,5,23,0,0,0,1,0.66,0.5909,0.89,0.1642,48,87,135,135,True
3483,2011-05-30,2,0,5,0,1,1,0,1,0.64,0.5606,0.94,0.194,38,65,103,103,True
3484,2011-05-30,2,0,5,1,1,1,0,1,0.64,0.5606,0.94,0.1343,26,53,79,79,True
3485,2011-05-30,2,0,5,2,1,1,0,1,0.64,0.5606,0.94,0.194,17,28,45,45,True
3486,2011-05-30,2,0,5,3,1,1,0,1,0.64,0.5606,0.94,0.194,10,8,18,18,True
3487,2011-05-30,2,0,5,4,1,1,0,1,0.62,0.5455,0.94,0.1642,2,4,6,6,True
3488,2011-05-30,2,0,5,5,1,1,0,2,0.62,0.5455,0.94,0.1045,1,6,7,7,True
3489,2011-05-30,2,0,5,6,1,1,0,2,0.64,0.5606,0.94,0.0896,6,10,16,16,True
3490,2011-05-30,2,0,5,7,1,1,0,2,0.64,0.5606,0.94,0.0,12,19,31,31,True
3491,2011-05-30,2,0,5,8,1,1,0,2,0.66,0.5909,0.89,0.1045,36,58,94,94,True
3492,2011-05-30,2,0,5,9,1,1,0,1,0.72,0.697,0.74,0.0896,47,81,128,128,True
3493,2011-05-30,2,0,5,10,1,1,0,1,0.8,0.7576,0.55,0.2537,114,153,267,267,True
3494,2011-05-30,2,0,5,11,1,1,0,1,0.82,0.7727,0.52,0.0,114,168,282,282,True
3495,2011-05-30,2,0,5,12,1,1,0,1,0.86,0.803,0.47,0.1045,114,187,301,301,True
3496,2011-05-30,2,0,5,13,1,1,0,1,0.86,0.7879,0.44,0.0896,114,217,331,331,True
3497,2011-05-30,2,0,5,14,1,1,0,1,0.88,0.803,0.39,0.0,114,185,299,299,True
3498,2011-05-30,2,0,5,15,1,1,0,1,0.88,0.803,0.39,0.2537,114,179,293,293,True
3499,2011-05-30,2,0,5,16,1,1,0,1,0.88,0.7879,0.37,0.2836,101,208,309,309,True
3500,2011-05-30,2,0,5,17,1,1,0,1,0.86,0.7879,0.41,0.2239,102,202,304,304,True
3501,2011-05-30,2,0,5,18,1,1,0,1,0.86,0.7879,0.41,0.1642,77,172,249,249,True
3502,2011-05-30,2,0,5,19,1,1,0,2,0.52,0.5,0.48,0.1045,68,157,225,225,True
3503,2011-05-30,2,0,5,20,1,1,0,1,0.76,0.7121,0.58,0.0,69,168,237,237,True
3504,2011-05-30,2,0,5,21,1,1,0,1,0.74,0.697,0.7,0.1343,42,107,149,149,True
3505,2011-05-30,2,0,5,22,1,1,0,1,0.72,0.697,0.74,0.1642,26,80,106,106,True
3506,2011-05-30,2,0,5,23,1,1,0,1,0.7,0.6667,0.84,0.1045,14,34,48,48,True
3507,2011-05-31,2,0,5,0,0,2,1,1,0.7,0.6667,0.79,0.0896,9,20,29,29,True
3508,2011-05-31,2,0,5,1,0,2,1,1,0.68,0.6364,0.89,0.0896,8,9,17,17,True
3509,2011-05-31,2,0,5,2,0,2,1,2,0.66,0.5909,0.94,0.1343,5,7,12,12,True
3510,2011-05-31,2,0,5,3,0,2,1,2,0.64,0.5606,0.94,0.0,1,3,4,4,True
3511,2011-05-31,2,0,5,4,0,2,1,1,0.66,0.6061,0.83,0.0896,0,3,3,3,True
3512,2011-05-31,2,0,5,5,0,2,1,1,0.66,0.6061,0.83,0.0896,0,26,26,26,True
3513,2011-05-31,2,0,5,6,0,2,1,1,0.68,0.6364,0.79,0.0896,11,98,109,109,True
3514,2011-05-31,2,0,5,7,0,2,1,1,0.74,0.697,0.66,0.1045,16,219,235,235,True
3515,2011-05-31,2,0,5,8,0,2,1,1,0.78,0.7424,0.59,0.1343,34,372,406,406,True
3516,2011-05-31,2,0,5,9,0,2,1,1,0.8,0.7576,0.55,0.1343,22,153,175,175,True
3517,2011-05-31,2,0,5,10,0,2,1,1,0.82,0.7879,0.56,0.1343,37,72,109,109,True
3518,2011-05-31,2,0,5,11,0,2,1,1,0.86,0.803,0.47,0.0,28,78,106,106,True
3519,2011-05-31,2,0,5,12,0,2,1,1,0.86,0.803,0.47,0.1343,37,125,162,162,True
3520,2011-05-31,2,0,5,13,0,2,1,1,0.9,0.8333,0.39,0.1642,37,110,147,147,True
3521,2011-05-31,2,0,5,14,0,2,1,1,0.9,0.8182,0.37,0.0,41,99,140,140,True
3522,2011-05-31,2,0,5,15,0,2,1,1,0.9,0.8182,0.37,0.1642,42,133,175,175,True
3523,2011-05-31,2,0,5,16,0,2,1,1,0.9,0.8333,0.39,0.1343,44,205,249,249,True
3524,2011-05-31,2,0,5,17,0,2,1,1,0.84,0.803,0.53,0.2239,67,428,495,495,True
3525,2011-05-31,2,0,5,18,0,2,1,1,0.84,0.803,0.53,0.194,55,362,417,417,True
3526,2011-05-31,2,0,5,19,0,2,1,1,0.78,0.7424,0.62,0.1045,39,246,285,285,True
3527,2011-05-31,2,0,5,20,0,2,1,1,0.78,0.7424,0.62,0.1045,38,213,251,251,True
3528,2011-05-31,2,0,5,21,0,2,1,1,0.76,0.7273,0.66,0.1045,45,165,210,210,True
3529,2011-05-31,2,0,5,22,0,2,1,1,0.74,0.697,0.7,0.1642,42,117,159,159,True
3530,2011-05-31,2,0,5,23,0,2,1,1,0.72,0.697,0.79,0.0896,15,46,61,61,True
3531,2011-06-01,2,0,6,0,0,3,1,1,0.7,0.6667,0.79,0.1642,9,25,34,34,True
3532,2011-06-01,2,0,6,1,0,3,1,1,0.7,0.6667,0.84,0.2537,8,9,17,17,True
3533,2011-06-01,2,0,6,2,0,3,1,1,0.7,0.6667,0.79,0.1642,0,3,3,3,True
3534,2011-06-01,2,0,6,3,0,3,1,1,0.68,0.6364,0.89,0.194,0,6,6,6,True
3535,2011-06-01,2,0,6,4,0,3,1,2,0.68,0.6364,0.89,0.2239,0,4,4,4,True
3536,2011-06-01,2,0,6,5,0,3,1,2,0.66,0.5909,0.89,0.0896,2,19,21,21,True
3537,2011-06-01,2,0,6,6,0,3,1,2,0.68,0.6364,0.89,0.0896,7,121,128,128,True
3538,2011-06-01,2,0,6,7,0,3,1,2,0.7,0.6667,0.79,0.1642,19,265,284,284,True
3539,2011-06-01,2,0,6,8,0,3,1,2,0.72,0.697,0.79,0.194,37,417,454,454,True
3540,2011-06-01,2,0,6,9,0,3,1,2,0.74,0.7121,0.74,0.2239,34,173,207,207,True
3541,2011-06-01,2,0,6,10,0,3,1,2,0.76,0.7424,0.75,0.2537,31,84,115,115,True
3542,2011-06-01,2,0,6,11,0,3,1,2,0.82,0.803,0.59,0.2239,26,86,112,112,True
3543,2011-06-01,2,0,6,12,0,3,1,1,0.86,0.8333,0.53,0.0,32,137,169,169,True
3544,2011-06-01,2,0,6,13,0,3,1,1,0.9,0.8182,0.37,0.194,29,125,154,154,True
3545,2011-06-01,2,0,6,14,0,3,1,1,0.9,0.8182,0.37,0.2537,40,105,145,145,True
3546,2011-06-01,2,0,6,15,0,3,1,1,0.9,0.8333,0.39,0.2985,25,127,152,152,True
3547,2011-06-01,2,0,6,16,0,3,1,1,0.86,0.803,0.47,0.2985,39,227,266,266,True
3548,2011-06-01,2,0,6,17,0,3,1,1,0.86,0.803,0.47,0.2985,52,434,486,486,True
3549,2011-06-01,2,0,6,18,0,3,1,3,0.82,0.7879,0.56,0.3881,31,278,309,309,True
3550,2011-06-01,2,0,6,19,0,3,1,2,0.74,0.7121,0.79,0.1642,16,248,264,264,True
3551,2011-06-01,2,0,6,20,0,3,1,2,0.74,0.7121,0.79,0.2537,23,233,256,256,True
3552,2011-06-01,2,0,6,21,0,3,1,1,0.74,0.697,0.7,0.2836,29,161,190,190,True
3553,2011-06-01,2,0,6,22,0,3,1,1,0.74,0.697,0.66,0.1343,14,115,129,129,True
3554,2011-06-01,2,0,6,23,0,3,1,1,0.74,0.6667,0.51,0.1642,10,59,69,69,True
3555,2011-06-02,2,0,6,0,0,4,1,1,0.74,0.6515,0.4,0.3582,11,31,42,42,True
3556,2011-06-02,2,0,6,1,0,4,1,1,0.72,0.6515,0.38,0.1045,3,12,15,15,True
3557,2011-06-02,2,0,6,2,0,4,1,1,0.7,0.6364,0.39,0.0,0,6,6,6,True
3558,2011-06-02,2,0,6,3,0,4,1,1,0.66,0.6212,0.44,0.1045,0,4,4,4,True
3559,2011-06-02,2,0,6,4,0,4,1,1,0.66,0.6212,0.41,0.194,0,3,3,3,True
3560,2011-06-02,2,0,6,5,0,4,1,1,0.66,0.6212,0.39,0.2239,3,28,31,31,True
3561,2011-06-02,2,0,6,6,0,4,1,1,0.66,0.6212,0.39,0.1343,7,106,113,113,True
3562,2011-06-02,2,0,6,7,0,4,1,1,0.7,0.6364,0.34,0.2537,19,285,304,304,True
3563,2011-06-02,2,0,6,8,0,4,1,1,0.7,0.6364,0.32,0.2985,25,442,467,467,True
3564,2011-06-02,2,0,6,9,0,4,1,1,0.72,0.6364,0.26,0.3582,28,197,225,225,True
3565,2011-06-02,2,0,6,10,0,4,1,1,0.72,0.6515,0.28,0.4775,33,106,139,139,True
3566,2011-06-02,2,0,6,11,0,4,1,1,0.74,0.6515,0.28,0.3881,42,123,165,165,True
3567,2011-06-02,2,0,6,12,0,4,1,1,0.76,0.6667,0.25,0.4627,39,193,232,232,True
3568,2011-06-02,2,0,6,13,0,4,1,1,0.8,0.6818,0.24,0.3582,35,168,203,203,True
3569,2011-06-02,2,0,6,14,0,4,1,1,0.78,0.6667,0.24,0.3284,43,142,185,185,True
3570,2011-06-02,2,0,6,15,0,4,1,1,0.8,0.6818,0.21,0.3881,44,144,188,188,True
3571,2011-06-02,2,0,6,16,0,4,1,1,0.8,0.6818,0.22,0.4775,63,255,318,318,True
3572,2011-06-02,2,0,6,17,0,4,1,1,0.76,0.6515,0.2,0.4775,88,484,572,572,True
3573,2011-06-02,2,0,6,18,0,4,1,1,0.74,0.6515,0.22,0.3881,74,451,525,525,True
3574,2011-06-02,2,0,6,19,0,4,1,1,0.72,0.6364,0.23,0.2985,58,321,379,379,True
3575,2011-06-02,2,0,6,20,0,4,1,1,0.7,0.6364,0.24,0.194,51,286,337,337,True
3576,2011-06-02,2,0,6,21,0,4,1,1,0.66,0.6212,0.31,0.194,33,215,248,248,True
3577,2011-06-02,2,0,6,22,0,4,1,1,0.64,0.6212,0.33,0.2537,14,141,155,155,True
3578,2011-06-02,2,0,6,23,0,4,1,1,0.62,0.6212,0.35,0.2239,23,89,112,112,True
3579,2011-06-03,2,0,6,0,0,5,1,1,0.62,0.6212,0.38,0.2836,15,53,68,68,True
3580,2011-06-03,2,0,6,1,0,5,1,1,0.6,0.6212,0.38,0.3582,7,15,22,22,True
3581,2011-06-03,2,0,6,2,0,5,1,1,0.56,0.5303,0.43,0.2239,0,12,12,12,True
3582,2011-06-03,2,0,6,3,0,5,1,1,0.54,0.5152,0.49,0.2239,0,5,5,5,True
3583,2011-06-03,2,0,6,4,0,5,1,1,0.52,0.5,0.48,0.3284,1,5,6,6,True
3584,2011-06-03,2,0,6,5,0,5,1,1,0.52,0.5,0.48,0.3582,4,24,28,28,True
3585,2011-06-03,2,0,6,6,0,5,1,1,0.54,0.5152,0.45,0.2985,8,98,106,106,True
3586,2011-06-03,2,0,6,7,0,5,1,1,0.54,0.5152,0.45,0.2537,25,252,277,277,True
3587,2011-06-03,2,0,6,8,0,5,1,2,0.56,0.5303,0.43,0.3284,31,471,502,502,True
3588,2011-06-03,2,0,6,9,0,5,1,1,0.58,0.5455,0.4,0.1642,36,194,230,230,True
3589,2011-06-03,2,0,6,10,0,5,1,1,0.62,0.6212,0.33,0.2537,54,107,161,161,True
3590,2011-06-03,2,0,6,11,0,5,1,1,0.64,0.6212,0.31,0.3284,57,135,192,192,True
3591,2011-06-03,2,0,6,12,0,5,1,1,0.66,0.6212,0.27,0.2836,51,208,259,259,True
3592,2011-06-03,2,0,6,13,0,5,1,1,0.68,0.6212,0.26,0.2537,58,190,248,248,True
3593,2011-06-03,2,0,6,14,0,5,1,1,0.7,0.6364,0.28,0.2836,66,174,240,240,True
3594,2011-06-03,2,0,6,15,0,5,1,1,0.7,0.6364,0.28,0.2836,56,156,212,212,True
3595,2011-06-03,2,0,6,16,0,5,1,1,0.72,0.6364,0.26,0.3284,63,286,349,349,True
3596,2011-06-03,2,0,6,17,0,5,1,1,0.72,0.6364,0.25,0.2836,73,485,558,558,True
3597,2011-06-03,2,0,6,18,0,5,1,1,0.7,0.6364,0.24,0.2985,76,488,564,564,True
3598,2011-06-03,2,0,6,19,0,5,1,1,0.68,0.6212,0.26,0.2836,53,338,391,391,True
3599,2011-06-03,2,0,6,20,0,5,1,1,0.64,0.6212,0.29,0.1642,57,236,293,293,True
3600,2011-06-03,2,0,6,21,0,5,1,1,0.64,0.6212,0.29,0.1045,51,196,247,247,True
3601,2011-06-03,2,0,6,22,0,5,1,1,0.62,0.6212,0.35,0.0,26,145,171,171,True
3602,2011-06-03,2,0,6,23,0,5,1,1,0.58,0.5455,0.46,0.1045,30,141,171,171,True
3603,2011-06-04,2,0,6,0,0,6,0,1,0.56,0.5303,0.52,0.0,24,69,93,93,True
3604,2011-06-04,2,0,6,1,0,6,0,1,0.54,0.5152,0.64,0.1045,14,80,94,94,True
3605,2011-06-04,2,0,6,2,0,6,0,1,0.54,0.5152,0.56,0.194,18,41,59,59,True
3606,2011-06-04,2,0,6,3,0,6,0,1,0.52,0.5,0.59,0.1045,8,10,18,18,True
3607,2011-06-04,2,0,6,4,0,6,0,1,0.52,0.5,0.59,0.0896,4,11,15,15,True
3608,2011-06-04,2,0,6,5,0,6,0,1,0.5,0.4848,0.64,0.0,3,5,8,8,True
3609,2011-06-04,2,0,6,6,0,6,0,1,0.54,0.5152,0.6,0.0,11,17,28,28,True
3610,2011-06-04,2,0,6,7,0,6,0,1,0.56,0.5303,0.56,0.0,27,60,87,87,True
3611,2011-06-04,2,0,6,8,0,6,0,1,0.6,0.6212,0.46,0.0896,29,96,125,125,True
3612,2011-06-04,2,0,6,9,0,6,0,1,0.62,0.6212,0.43,0.1343,55,169,224,224,True
3613,2011-06-04,2,0,6,10,0,6,0,1,0.64,0.6212,0.38,0.1045,114,202,316,316,True
3614,2011-06-04,2,0,6,11,0,6,0,1,0.66,0.6212,0.36,0.1343,114,249,363,363,True
3615,2011-06-04,2,0,6,12,0,6,0,1,0.7,0.6364,0.32,0.1642,114,270,384,384,True
3616,2011-06-04,2,0,6,13,0,6,0,1,0.74,0.6515,0.28,0.1343,114,268,382,382,True
3617,2011-06-04,2,0,6,14,0,6,0,1,0.74,0.6515,0.33,0.2239,114,258,372,372,True
3618,2011-06-04,2,0,6,15,0,6,0,2,0.74,0.6515,0.27,0.4179,114,224,338,338,True
3619,2011-06-04,2,0,6,16,0,6,0,2,0.72,0.6515,0.3,0.1343,114,272,386,386,True
3620,2011-06-04,2,0,6,17,0,6,0,2,0.72,0.6515,0.34,0.2537,114,202,316,316,True
3621,2011-06-04,2,0,6,18,0,6,0,2,0.74,0.6515,0.3,0.1642,114,214,328,328,True
3622,2011-06-04,2,0,6,19,0,6,0,2,0.7,0.6364,0.39,0.0896,79,206,285,285,True
3623,2011-06-04,2,0,6,20,0,6,0,2,0.7,0.6515,0.48,0.0896,90,149,239,239,True
3624,2011-06-04,2,0,6,21,0,6,0,2,0.66,0.6212,0.47,0.1045,46,139,185,185,True
3625,2011-06-04,2,0,6,22,0,6,0,1,0.64,0.6212,0.57,0.2239,49,141,190,190,True
3626,2011-06-04,2,0,6,23,0,6,0,2,0.64,0.6212,0.57,0.0,29,121,150,150,True
3627,2011-06-05,2,0,6,0,0,0,0,1,0.64,0.6212,0.57,0.0896,23,90,113,113,True
3628,2011-06-05,2,0,6,1,0,0,0,2,0.64,0.6212,0.61,0.1642,26,70,96,96,True
3629,2011-06-05,2,0,6,2,0,0,0,2,0.64,0.6212,0.61,0.1642,16,48,64,64,True
3630,2011-06-05,2,0,6,3,0,0,0,2,0.62,0.6061,0.65,0.1642,22,25,47,47,True
3631,2011-06-05,2,0,6,4,0,0,0,2,0.62,0.6061,0.65,0.1642,4,8,12,12,True
3632,2011-06-05,2,0,6,5,0,0,0,2,0.62,0.6061,0.61,0.1343,1,5,6,6,True
3633,2011-06-05,2,0,6,6,0,0,0,2,0.62,0.6061,0.61,0.1045,10,11,21,21,True
3634,2011-06-05,2,0,6,7,0,0,0,2,0.6,0.5909,0.73,0.2537,8,19,27,27,True
3635,2011-06-05,2,0,6,8,0,0,0,2,0.6,0.5909,0.73,0.2537,24,74,98,98,True
3636,2011-06-05,2,0,6,9,0,0,0,2,0.6,0.5758,0.78,0.194,53,111,164,164,True
3637,2011-06-05,2,0,6,10,0,0,0,2,0.62,0.5909,0.73,0.0896,83,168,251,251,True
3638,2011-06-05,2,0,6,11,0,0,0,2,0.64,0.6061,0.69,0.1045,114,214,328,328,True
3639,2011-06-05,2,0,6,12,0,0,0,2,0.64,0.6061,0.69,0.1045,114,212,326,326,True
3640,2011-06-05,2,0,6,13,0,0,0,1,0.66,0.6212,0.65,0.1045,114,213,327,327,True
3641,2011-06-05,2,0,6,14,0,0,0,1,0.7,0.6515,0.58,0.1642,114,224,338,338,True
3642,2011-06-05,2,0,6,15,0,0,0,1,0.7,0.6515,0.54,0.0,114,256,370,370,True
3643,2011-06-05,2,0,6,16,0,0,0,1,0.72,0.6667,0.51,0.0896,114,260,374,374,True
3644,2011-06-05,2,0,6,17,0,0,0,1,0.74,0.6667,0.51,0.0,114,264,378,378,True
3645,2011-06-05,2,0,6,18,0,0,0,1,0.7,0.6515,0.58,0.1045,114,239,353,353,True
3646,2011-06-05,2,0,6,19,0,0,0,1,0.68,0.6364,0.65,0.1642,108,249,357,357,True
3647,2011-06-05,2,0,6,20,0,0,0,1,0.66,0.6212,0.69,0.194,84,195,279,279,True
3648,2011-06-05,2,0,6,21,0,0,0,1,0.64,0.6061,0.73,0.1642,54,111,165,165,True
3649,2011-06-05,2,0,6,22,0,0,0,1,0.64,0.5909,0.78,0.2239,36,94,130,130,True
3650,2011-06-05,2,0,6,23,0,0,0,1,0.62,0.5909,0.78,0.1343,25,61,86,86,True
3651,2011-06-06,2,0,6,0,0,1,1,1,0.62,0.5909,0.78,0.1343,11,18,29,29,True
3652,2011-06-06,2,0,6,1,0,1,1,1,0.6,0.5606,0.83,0.1343,9,5,14,14,True
3653,2011-06-06,2,0,6,2,0,1,1,1,0.58,0.5455,0.88,0.1045,4,4,8,8,True
3654,2011-06-06,2,0,6,3,0,1,1,1,0.58,0.5455,0.88,0.0,2,3,5,5,True
3655,2011-06-06,2,0,6,4,0,1,1,1,0.56,0.5303,0.94,0.1045,4,4,8,8,True
3656,2011-06-06,2,0,6,5,0,1,1,1,0.56,0.5303,0.88,0.0896,7,24,31,31,True
3657,2011-06-06,2,0,6,6,0,1,1,1,0.58,0.5455,0.88,0.0,11,101,112,112,True
3658,2011-06-06,2,0,6,7,0,1,1,1,0.62,0.5909,0.78,0.1045,18,281,299,299,True
3659,2011-06-06,2,0,6,8,0,1,1,1,0.64,0.6061,0.73,0.0896,28,410,438,438,True
3660,2011-06-06,2,0,6,9,0,1,1,1,0.7,0.6515,0.58,0.1642,26,162,188,188,True
3661,2011-06-06,2,0,6,10,0,1,1,1,0.72,0.6667,0.51,0.2239,31,64,95,95,True
3662,2011-06-06,2,0,6,11,0,1,1,1,0.74,0.6667,0.42,0.1343,39,72,111,111,True
3663,2011-06-06,2,0,6,12,0,1,1,1,0.76,0.6667,0.37,0.1642,25,128,153,153,True
3664,2011-06-06,2,0,6,13,0,1,1,1,0.78,0.6818,0.35,0.0,28,152,180,180,True
3665,2011-06-06,2,0,6,14,0,1,1,1,0.78,0.6818,0.31,0.1343,46,99,145,145,True
3666,2011-06-06,2,0,6,15,0,1,1,1,0.8,0.697,0.29,0.194,38,127,165,165,True
3667,2011-06-06,2,0,6,16,0,1,1,1,0.76,0.6667,0.33,0.1343,34,233,267,267,True
3668,2011-06-06,2,0,6,17,0,1,1,1,0.78,0.6818,0.33,0.2836,63,499,562,562,True
3669,2011-06-06,2,0,6,18,0,1,1,1,0.76,0.6667,0.31,0.1343,56,499,555,555,True
3670,2011-06-06,2,0,6,19,0,1,1,1,0.72,0.6667,0.54,0.194,64,343,407,407,True
3671,2011-06-06,2,0,6,20,0,1,1,1,0.68,0.6364,0.61,0.1343,59,277,336,336,True
3672,2011-06-06,2,0,6,21,0,1,1,1,0.66,0.6212,0.57,0.0896,29,160,189,189,True
3673,2011-06-06,2,0,6,22,0,1,1,1,0.66,0.6212,0.61,0.0896,36,137,173,173,True
3674,2011-06-06,2,0,6,23,0,1,1,1,0.64,0.6061,0.69,0.0896,5,55,60,60,True
3675,2011-06-07,2,0,6,0,0,2,1,1,0.64,0.6061,0.65,0.0896,5,15,20,20,True
3676,2011-06-07,2,0,6,1,0,2,1,1,0.62,0.6061,0.69,0.1343,2,2,4,4,True
3677,2011-06-07,2,0,6,2,0,2,1,1,0.6,0.5909,0.73,0.0896,3,2,5,5,True
3678,2011-06-07,2,0,6,3,0,2,1,1,0.6,0.5909,0.73,0.0896,1,1,2,2,True
3679,2011-06-07,2,0,6,4,0,2,1,1,0.58,0.5455,0.83,0.1343,2,3,5,5,True
3680,2011-06-07,2,0,6,5,0,2,1,1,0.58,0.5455,0.88,0.1642,2,30,32,32,True
3681,2011-06-07,2,0,6,6,0,2,1,1,0.6,0.5758,0.78,0.1343,10,116,126,126,True
3682,2011-06-07,2,0,6,7,0,2,1,2,0.64,0.6061,0.69,0.194,23,311,334,334,True
3683,2011-06-07,2,0,6,8,0,2,1,2,0.68,0.6364,0.61,0.1343,45,432,477,477,True
3684,2011-06-07,2,0,6,9,0,2,1,2,0.72,0.6667,0.58,0.2239,27,190,217,217,True
3685,2011-06-07,2,0,6,10,0,2,1,2,0.76,0.6818,0.48,0.194,37,86,123,123,True
3686,2011-06-07,2,0,6,11,0,2,1,2,0.76,0.697,0.52,0.2537,38,113,151,151,True
3687,2011-06-07,2,0,6,12,0,2,1,2,0.8,0.7273,0.46,0.2836,42,141,183,183,True
3688,2011-06-07,2,0,6,13,0,2,1,2,0.8,0.7273,0.43,0.2537,55,141,196,196,True
3689,2011-06-07,2,0,6,14,0,2,1,2,0.8,0.7273,0.43,0.2836,34,112,146,146,True
3690,2011-06-07,2,0,6,15,0,2,1,2,0.82,0.7424,0.41,0.3284,56,127,183,183,True
3691,2011-06-07,2,0,6,16,0,2,1,1,0.8,0.7121,0.38,0.2239,55,253,308,308,True
3692,2011-06-07,2,0,6,17,0,2,1,1,0.8,0.7273,0.43,0.2537,64,475,539,539,True
3693,2011-06-07,2,0,6,18,0,2,1,1,0.78,0.697,0.46,0.2836,72,479,551,551,True
3694,2011-06-07,2,0,6,19,0,2,1,1,0.76,0.6818,0.48,0.2537,69,355,424,424,True
3695,2011-06-07,2,0,6,20,0,2,1,1,0.74,0.6818,0.56,0.1343,45,301,346,346,True
3696,2011-06-07,2,0,6,21,0,2,1,1,0.72,0.6818,0.7,0.1343,31,187,218,218,True
3697,2011-06-07,2,0,6,22,0,2,1,1,0.7,0.6515,0.65,0.1343,27,126,153,153,True
3698,2011-06-07,2,0,6,23,0,2,1,1,0.68,0.6364,0.79,0.1045,18,72,90,90,True
3699,2011-06-08,2,0,6,0,0,3,1,1,0.66,0.5909,0.89,0.1343,12,29,41,41,True
3700,2011-06-08,2,0,6,1,0,3,1,1,0.66,0.6061,0.78,0.0,3,20,23,23,True
3701,2011-06-08,2,0,6,2,0,3,1,1,0.64,0.5758,0.89,0.0896,0,7,7,7,True
3702,2011-06-08,2,0,6,3,0,3,1,1,0.64,0.5758,0.89,0.0896,2,1,3,3,True
3703,2011-06-08,2,0,6,4,0,3,1,1,0.62,0.5758,0.83,0.0,0,6,6,6,True
3704,2011-06-08,2,0,6,5,0,3,1,1,0.62,0.5606,0.88,0.0,0,21,21,21,True
3705,2011-06-08,2,0,6,6,0,3,1,1,0.64,0.5758,0.89,0.1343,13,103,116,116,True
3706,2011-06-08,2,0,6,7,0,3,1,1,0.66,0.6212,0.74,0.1045,24,329,353,353,True
3707,2011-06-08,2,0,6,8,0,3,1,1,0.76,0.7121,0.58,0.1642,46,435,481,481,True
3708,2011-06-08,2,0,6,9,0,3,1,1,0.76,0.7121,0.58,0.1642,34,168,202,202,True
3709,2011-06-08,2,0,6,10,0,3,1,1,0.82,0.7424,0.43,0.2239,27,63,90,90,True
3710,2011-06-08,2,0,6,11,0,3,1,1,0.84,0.7576,0.41,0.194,28,106,134,134,True
3711,2011-06-08,2,0,6,12,0,3,1,1,0.88,0.8182,0.42,0.1343,15,134,149,149,True
3712,2011-06-08,2,0,6,13,0,3,1,1,0.9,0.8485,0.42,0.0,20,116,136,136,True
3713,2011-06-08,2,0,6,14,0,3,1,1,0.92,0.8788,0.4,0.2537,44,111,155,155,True
3714,2011-06-08,2,0,6,15,0,3,1,1,0.92,0.8788,0.4,0.1642,28,100,128,128,True
3715,2011-06-08,2,0,6,16,0,3,1,1,0.92,0.8788,0.4,0.2239,34,199,233,233,True
3716,2011-06-08,2,0,6,17,0,3,1,1,0.92,0.8485,0.35,0.2239,80,426,506,506,True
3717,2011-06-08,2,0,6,18,0,3,1,1,0.9,0.8182,0.37,0.2239,61,398,459,459,True
3718,2011-06-08,2,0,6,19,0,3,1,1,0.82,0.803,0.59,0.1343,61,323,384,384,True
3719,2011-06-08,2,0,6,20,0,3,1,1,0.8,0.7879,0.63,0.1343,55,225,280,280,True
3720,2011-06-08,2,0,6,21,0,3,1,1,0.8,0.803,0.66,0.1343,34,168,202,202,True
3721,2011-06-08,2,0,6,22,0,3,1,1,0.76,0.7424,0.75,0.1642,37,139,176,176,True
3722,2011-06-08,2,0,6,23,0,3,1,1,0.76,0.7424,0.75,0.194,18,98,116,116,True
3723,2011-06-09,2,0,6,0,0,4,1,2,0.74,0.7121,0.79,0.1343,7,40,47,47,True
3724,2011-06-09,2,0,6,1,0,4,1,1,0.74,0.7121,0.79,0.1045,3,13,16,16,True
3725,2011-06-09,2,0,6,2,0,4,1,2,0.72,0.7121,0.84,0.1642,0,6,6,6,True
3726,2011-06-09,2,0,6,3,0,4,1,2,0.72,0.7121,0.84,0.1045,0,2,2,2,True
3727,2011-06-09,2,0,6,4,0,4,1,2,0.72,0.697,0.79,0.0896,2,4,6,6,True
3728,2011-06-09,2,0,6,5,0,4,1,2,0.7,0.6667,0.84,0.0,1,19,20,20,True
3729,2011-06-09,2,0,6,6,0,4,1,2,0.72,0.7121,0.84,0.0896,13,105,118,118,True
3730,2011-06-09,2,0,6,7,0,4,1,2,0.72,0.697,0.79,0.1343,31,283,314,314,True
3731,2011-06-09,2,0,6,8,0,4,1,2,0.76,0.7273,0.7,0.1045,32,400,432,432,True
3732,2011-06-09,2,0,6,9,0,4,1,1,0.84,0.7879,0.49,0.0,20,148,168,168,True
3733,2011-06-09,2,0,6,10,0,4,1,1,0.86,0.8182,0.5,0.2836,20,74,94,94,True
3734,2011-06-09,2,0,6,11,0,4,1,1,0.9,0.8485,0.42,0.2239,36,82,118,118,True
3735,2011-06-09,2,0,6,12,0,4,1,1,0.92,0.8485,0.35,0.194,40,100,140,140,True
3736,2011-06-09,2,0,6,13,0,4,1,1,0.9,0.8182,0.37,0.0896,18,118,136,136,True
3737,2011-06-09,2,0,6,14,0,4,1,1,0.92,0.8788,0.4,0.194,25,93,118,118,True
3738,2011-06-09,2,0,6,15,0,4,1,1,0.94,0.8333,0.31,0.1642,18,86,104,104,True
3739,2011-06-09,2,0,6,16,0,4,1,1,0.92,0.8333,0.33,0.1343,30,170,200,200,True
3740,2011-06-09,2,0,6,17,0,4,1,1,0.9,0.8182,0.37,0.2537,54,355,409,409,True
3741,2011-06-09,2,0,6,18,0,4,1,1,0.88,0.803,0.39,0.2836,52,414,466,466,True
3742,2011-06-09,2,0,6,19,0,4,1,2,0.84,0.7424,0.39,0.3284,55,271,326,326,True
3743,2011-06-09,2,0,6,20,0,4,1,2,0.8,0.7273,0.43,0.194,40,214,254,254,True
3744,2011-06-09,2,0,6,21,0,4,1,3,0.76,0.697,0.52,0.0,29,142,171,171,True
3745,2011-06-09,2,0,6,22,0,4,1,2,0.74,0.6818,0.58,0.1642,22,131,153,153,True
3746,2011-06-09,2,0,6,23,0,4,1,2,0.74,0.697,0.57,0.1642,15,82,97,97,True
3747,2011-06-10,2,0,6,0,0,5,1,3,0.7,0.6515,0.65,0.2239,8,61,69,69,True
3748,2011-06-10,2,0,6,1,0,5,1,3,0.7,0.6515,0.65,0.2239,5,18,23,23,True
3749,2011-06-10,2,0,6,2,0,5,1,1,0.68,0.6364,0.69,0.1642,6,7,13,13,True
3750,2011-06-10,2,0,6,3,0,5,1,1,0.68,0.6364,0.69,0.1642,3,3,6,6,True
3751,2011-06-10,2,0,6,4,0,5,1,1,0.66,0.6061,0.78,0.1642,0,4,4,4,True
3752,2011-06-10,2,0,6,5,0,5,1,1,0.66,0.6061,0.78,0.1642,0,28,28,28,True
3753,2011-06-10,2,0,6,6,0,5,1,1,0.66,0.6061,0.78,0.0896,10,94,104,104,True
3754,2011-06-10,2,0,6,7,0,5,1,1,0.72,0.6818,0.66,0.1045,25,242,267,267,True
3755,2011-06-10,2,0,6,8,0,5,1,1,0.74,0.6818,0.58,0.1343,29,423,452,452,True
3756,2011-06-10,2,0,6,9,0,5,1,1,0.76,0.697,0.55,0.0,37,176,213,213,True
3757,2011-06-10,2,0,6,10,0,5,1,1,0.78,0.7121,0.52,0.0,23,88,111,111,True
3758,2011-06-10,2,0,6,11,0,5,1,1,0.82,0.7576,0.46,0.0,46,107,153,153,True
3759,2011-06-10,2,0,6,12,0,5,1,1,0.84,0.7576,0.44,0.1343,40,167,207,207,True
3760,2011-06-10,2,0,6,13,0,5,1,1,0.84,0.7576,0.44,0.1045,40,149,189,189,True
3761,2011-06-10,2,0,6,14,0,5,1,1,0.86,0.7727,0.39,0.0,44,121,165,165,True
3762,2011-06-10,2,0,6,15,0,5,1,1,0.84,0.7576,0.44,0.1045,49,163,212,212,True
3763,2011-06-10,2,0,6,16,0,5,1,1,0.82,0.7879,0.56,0.2985,46,239,285,285,True
3764,2011-06-10,2,0,6,17,0,5,1,1,0.82,0.7727,0.52,0.2239,63,454,517,517,True
3765,2011-06-10,2,0,6,18,0,5,1,1,0.8,0.7727,0.59,0.2239,96,367,463,463,True
3766,2011-06-10,2,0,6,19,0,5,1,1,0.78,0.7424,0.59,0.194,61,245,306,306,True
3767,2011-06-10,2,0,6,20,0,5,1,1,0.76,0.7121,0.62,0.1045,53,197,250,250,True
3768,2011-06-10,2,0,6,21,0,5,1,1,0.76,0.7273,0.66,0.1343,55,163,218,218,True
3769,2011-06-10,2,0,6,22,0,5,1,1,0.72,0.697,0.74,0.2537,40,145,185,185,True
3770,2011-06-10,2,0,6,23,0,5,1,1,0.72,0.697,0.74,0.1642,36,110,146,146,True
3771,2011-06-11,2,0,6,0,0,6,0,1,0.7,0.6667,0.79,0.1343,28,89,117,117,True
3772,2011-06-11,2,0,6,1,0,6,0,1,0.7,0.6667,0.79,0.0896,10,67,77,77,True
3773,2011-06-11,2,0,6,2,0,6,0,1,0.7,0.6667,0.79,0.1045,10,50,60,60,True
3774,2011-06-11,2,0,6,3,0,6,0,1,0.68,0.6364,0.83,0.0896,10,18,28,28,True
3775,2011-06-11,2,0,6,4,0,6,0,1,0.68,0.6364,0.79,0.0896,4,9,13,13,True
3776,2011-06-11,2,0,6,5,0,6,0,1,0.68,0.6364,0.74,0.1343,4,12,16,16,True
3777,2011-06-11,2,0,6,6,0,6,0,1,0.7,0.6515,0.61,0.1343,9,31,40,40,True
3778,2011-06-11,2,0,6,7,0,6,0,1,0.72,0.6667,0.58,0.194,18,50,68,68,True
3779,2011-06-11,2,0,6,8,0,6,0,1,0.74,0.6818,0.58,0.194,32,111,143,143,True
3780,2011-06-11,2,0,6,9,0,6,0,1,0.74,0.6818,0.62,0.1343,59,171,230,230,True
3781,2011-06-11,2,0,6,10,0,6,0,1,0.74,0.6818,0.58,0.1642,91,173,264,264,True
3782,2011-06-11,2,0,6,11,0,6,0,1,0.76,0.7121,0.62,0.1343,110,215,325,325,True
3783,2011-06-11,2,0,6,12,0,6,0,1,0.8,0.7576,0.55,0.2239,112,235,347,347,True
3784,2011-06-11,2,0,6,13,0,6,0,1,0.8,0.7576,0.55,0.194,114,237,351,351,True
3785,2011-06-11,2,0,6,14,0,6,0,1,0.82,0.7727,0.49,0.1045,114,232,346,346,True
3786,2011-06-11,2,0,6,15,0,6,0,1,0.82,0.7727,0.49,0.1045,114,232,346,346,True
3787,2011-06-11,2,0,6,16,0,6,0,2,0.8,0.7273,0.46,0.194,114,225,339,339,True
3788,2011-06-11,2,0,6,17,0,6,0,2,0.74,0.6818,0.58,0.1642,114,190,304,304,True
3789,2011-06-11,2,0,6,18,0,6,0,2,0.72,0.6818,0.62,0.1343,114,155,269,269,True
3790,2011-06-11,2,0,6,19,0,6,0,1,0.7,0.6515,0.65,0.194,97,167,264,264,True
3791,2011-06-11,2,0,6,20,0,6,0,1,0.68,0.6364,0.74,0.2537,95,180,275,275,True
3792,2011-06-11,2,0,6,21,0,6,0,1,0.66,0.6212,0.74,0.2239,76,144,220,220,True
3793,2011-06-11,2,0,6,22,0,6,0,1,0.66,0.6061,0.78,0.2239,53,137,190,190,True
3794,2011-06-11,2,0,6,23,0,6,0,1,0.66,0.6212,0.74,0.1045,24,107,131,131,True
3795,2011-06-12,2,0,6,0,0,0,0,1,0.66,0.6061,0.78,0.2239,19,100,119,119,True
3796,2011-06-12,2,0,6,1,0,0,0,1,0.64,0.5758,0.83,0.1045,19,74,93,93,True
3797,2011-06-12,2,0,6,2,0,0,0,1,0.64,0.5758,0.89,0.2537,9,57,66,66,True
3798,2011-06-12,2,0,6,3,0,0,0,1,0.64,0.5758,0.89,0.2836,8,20,28,28,True
3799,2011-06-12,2,0,6,4,0,0,0,1,0.62,0.5606,0.88,0.1642,8,6,14,14,True
3800,2011-06-12,2,0,6,5,0,0,0,1,0.62,0.5606,0.88,0.2239,5,5,10,10,True
3801,2011-06-12,2,0,6,6,0,0,0,1,0.62,0.5606,0.88,0.1045,5,9,14,14,True
3802,2011-06-12,2,0,6,7,0,0,0,1,0.64,0.5909,0.78,0.1045,7,27,34,34,True
3803,2011-06-12,2,0,6,8,0,0,0,1,0.7,0.6667,0.74,0.0,28,64,92,92,True
3804,2011-06-12,2,0,6,9,0,0,0,1,0.72,0.6818,0.66,0.0,75,107,182,182,True
3805,2011-06-12,2,0,6,10,0,0,0,1,0.76,0.7121,0.58,0.0896,114,191,305,305,True
3806,2011-06-12,2,0,6,11,0,0,0,1,0.78,0.7273,0.55,0.1045,114,236,350,350,True
3807,2011-06-12,2,0,6,12,0,0,0,1,0.82,0.7576,0.46,0.0,114,244,358,358,True
3808,2011-06-12,2,0,6,13,0,0,0,1,0.78,0.7424,0.59,0.2836,109,264,373,373,True
3809,2011-06-12,2,0,6,14,0,0,0,1,0.82,0.7879,0.56,0.2537,96,219,315,315,True
3810,2011-06-12,2,0,6,15,0,0,0,1,0.8,0.7727,0.59,0.2985,114,218,332,332,True
3811,2011-06-12,2,0,6,16,0,0,0,3,0.68,0.6364,0.83,0.2836,114,235,349,349,True
3812,2011-06-12,2,0,6,17,0,0,0,3,0.68,0.6364,0.83,0.2836,94,158,252,252,True
3813,2011-06-12,2,0,6,18,0,0,0,1,0.7,0.6667,0.74,0.1642,69,187,256,256,True
3814,2011-06-12,2,0,6,19,0,0,0,1,0.7,0.6667,0.74,0.1045,67,156,223,223,True
3815,2011-06-12,2,0,6,20,0,0,0,1,0.66,0.6061,0.83,0.1642,62,144,206,206,True
3816,2011-06-12,2,0,6,21,0,0,0,1,0.66,0.6061,0.83,0.1045,39,101,140,140,True
3817,2011-06-12,2,0,6,22,0,0,0,1,0.64,0.5758,0.83,0.1343,31,97,128,128,True
3818,2011-06-12,2,0,6,23,0,0,0,1,0.64,0.5909,0.78,0.194,33,74,107,107,True
3819,2011-06-13,2,0,6,0,0,1,1,1,0.64,0.5909,0.78,0.1343,8,20,28,28,True
3820,2011-06-13,2,0,6,1,0,1,1,1,0.64,0.6061,0.73,0.2239,6,10,16,16,True
3821,2011-06-13,2,0,6,2,0,1,1,1,0.62,0.5909,0.73,0.2836,2,8,10,10,True
3822,2011-06-13,2,0,6,3,0,1,1,1,0.6,0.6061,0.6,0.4775,1,6,7,7,True
3823,2011-06-13,2,0,6,4,0,1,1,1,0.56,0.5303,0.64,0.2985,1,3,4,4,True
3824,2011-06-13,2,0,6,5,0,1,1,1,0.54,0.5152,0.64,0.3881,2,27,29,29,True
3825,2011-06-13,2,0,6,6,0,1,1,1,0.54,0.5152,0.64,0.4179,7,98,105,105,True
3826,2011-06-13,2,0,6,7,0,1,1,1,0.56,0.5303,0.56,0.3582,26,302,328,328,True
3827,2011-06-13,2,0,6,8,0,1,1,1,0.58,0.5455,0.49,0.4478,44,432,476,476,True
3828,2011-06-13,2,0,6,9,0,1,1,1,0.62,0.6212,0.46,0.3582,35,189,224,224,True
3829,2011-06-13,2,0,6,10,0,1,1,1,0.64,0.6212,0.41,0.3284,38,80,118,118,True
3830,2011-06-13,2,0,6,11,0,1,1,1,0.66,0.6212,0.41,0.2985,53,106,159,159,True
3831,2011-06-13,2,0,6,12,0,1,1,1,0.66,0.6212,0.41,0.2836,35,161,196,196,True
3832,2011-06-13,2,0,6,13,0,1,1,1,0.7,0.6364,0.37,0.0,53,174,227,227,True
3833,2011-06-13,2,0,6,14,0,1,1,1,0.7,0.6364,0.34,0.2537,55,145,200,200,True
3834,2011-06-13,2,0,6,15,0,1,1,1,0.7,0.6364,0.37,0.4478,58,127,185,185,True
3835,2011-06-13,2,0,6,16,0,1,1,1,0.7,0.6364,0.37,0.4179,64,262,326,326,True
3836,2011-06-13,2,0,6,17,0,1,1,1,0.7,0.6364,0.39,0.3284,72,499,571,571,True
3837,2011-06-13,2,0,6,18,0,1,1,1,0.7,0.6364,0.37,0.3582,76,499,575,575,True
3838,2011-06-13,2,0,6,19,0,1,1,1,0.66,0.6212,0.39,0.2836,75,348,423,423,True
3839,2011-06-13,2,0,6,20,0,1,1,1,0.64,0.6212,0.44,0.2537,78,253,331,331,True
3840,2011-06-13,2,0,6,21,0,1,1,1,0.64,0.6212,0.41,0.2537,40,178,218,218,True
3841,2011-06-13,2,0,6,22,0,1,1,1,0.62,0.6212,0.46,0.2239,20,114,134,134,True
3842,2011-06-13,2,0,6,23,0,1,1,1,0.62,0.6212,0.46,0.194,14,75,89,89,True
3843,2011-06-14,2,0,6,0,0,2,1,1,0.6,0.6212,0.49,0.194,13,18,31,31,True
3844,2011-06-14,2,0,6,1,0,2,1,1,0.6,0.6212,0.49,0.2537,3,10,13,13,True
3845,2011-06-14,2,0,6,2,0,2,1,1,0.6,0.6212,0.49,0.2836,2,8,10,10,True
3846,2011-06-14,2,0,6,3,0,2,1,1,0.58,0.5455,0.53,0.3284,1,1,2,2,True
3847,2011-06-14,2,0,6,4,0,2,1,1,0.54,0.5152,0.6,0.2537,0,3,3,3,True
3848,2011-06-14,2,0,6,5,0,2,1,1,0.54,0.5152,0.56,0.3284,3,23,26,26,True
3849,2011-06-14,2,0,6,6,0,2,1,1,0.54,0.5152,0.56,0.2985,6,107,113,113,True
3850,2011-06-14,2,0,6,7,0,2,1,1,0.56,0.5303,0.52,0.4179,19,346,365,365,True
3851,2011-06-14,2,0,6,8,0,2,1,1,0.58,0.5455,0.49,0.3881,45,441,486,486,True
3852,2011-06-14,2,0,6,9,0,2,1,1,0.62,0.6212,0.46,0.194,19,174,193,193,True
3853,2011-06-14,2,0,6,10,0,2,1,1,0.62,0.6212,0.46,0.2239,33,97,130,130,True
3854,2011-06-14,2,0,6,11,0,2,1,1,0.64,0.6212,0.41,0.2836,40,103,143,143,True
3855,2011-06-14,2,0,6,12,0,2,1,1,0.64,0.6212,0.41,0.3582,30,139,169,169,True
3856,2011-06-14,2,0,6,13,0,2,1,1,0.64,0.6212,0.44,0.2239,33,176,209,209,True
3857,2011-06-14,2,0,6,14,0,2,1,2,0.64,0.6212,0.47,0.194,41,118,159,159,True
3858,2011-06-14,2,0,6,15,0,2,1,1,0.64,0.6212,0.47,0.1642,42,136,178,178,True
3859,2011-06-14,2,0,6,16,0,2,1,1,0.68,0.6364,0.41,0.194,51,279,330,330,True
3860,2011-06-14,2,0,6,17,0,2,1,3,0.64,0.6212,0.5,0.2836,85,484,569,569,True
3861,2011-06-14,2,0,6,18,0,2,1,1,0.62,0.6212,0.51,0.3284,65,473,538,538,True
3862,2011-06-14,2,0,6,19,0,2,1,1,0.64,0.6212,0.5,0.3582,51,335,386,386,True
3863,2011-06-14,2,0,6,20,0,2,1,1,0.6,0.6212,0.56,0.1642,60,237,297,297,True
3864,2011-06-14,2,0,6,21,0,2,1,1,0.6,0.6212,0.56,0.2985,37,206,243,243,True
3865,2011-06-14,2,0,6,22,0,2,1,1,0.58,0.5455,0.6,0.2239,29,159,188,188,True
3866,2011-06-14,2,0,6,23,0,2,1,1,0.56,0.5303,0.68,0.2239,19,91,110,110,True
3867,2011-06-15,2,0,6,0,0,3,1,1,0.56,0.5303,0.64,0.3582,8,44,52,52,True
3868,2011-06-15,2,0,6,1,0,3,1,1,0.54,0.5152,0.64,0.2836,0,14,14,14,True
3869,2011-06-15,2,0,6,2,0,3,1,1,0.52,0.5,0.63,0.2239,0,9,9,9,True
3870,2011-06-15,2,0,6,3,0,3,1,1,0.5,0.4848,0.68,0.2537,0,1,1,1,True
3871,2011-06-15,2,0,6,4,0,3,1,1,0.5,0.4848,0.63,0.2836,0,4,4,4,True
3872,2011-06-15,2,0,6,5,0,3,1,1,0.48,0.4697,0.67,0.2836,1,20,21,21,True
3873,2011-06-15,2,0,6,6,0,3,1,1,0.5,0.4848,0.63,0.2537,11,110,121,121,True
3874,2011-06-15,2,0,6,7,0,3,1,1,0.54,0.5152,0.6,0.1343,22,348,370,370,True
3875,2011-06-15,2,0,6,8,0,3,1,1,0.58,0.5455,0.53,0.1343,53,445,498,498,True
3876,2011-06-15,2,0,6,9,0,3,1,1,0.6,0.6212,0.49,0.0,22,185,207,207,True
3877,2011-06-15,2,0,6,10,0,3,1,1,0.64,0.6212,0.47,0.1642,27,108,135,135,True
3878,2011-06-15,2,0,6,11,0,3,1,1,0.68,0.6364,0.36,0.0,49,115,164,164,True
3879,2011-06-15,2,0,6,12,0,3,1,1,0.7,0.6364,0.34,0.2239,33,178,211,211,True
3880,2011-06-15,2,0,6,13,0,3,1,1,0.74,0.6515,0.28,0.2836,43,146,189,189,True
3881,2011-06-15,2,0,6,14,0,3,1,1,0.74,0.6515,0.28,0.0,50,128,178,178,True
3882,2011-06-15,2,0,6,15,0,3,1,1,0.76,0.6667,0.27,0.0,33,131,164,164,True
3883,2011-06-15,2,0,6,16,0,3,1,1,0.76,0.6667,0.27,0.1343,47,265,312,312,True
3884,2011-06-15,2,0,6,17,0,3,1,1,0.74,0.6515,0.28,0.1045,83,499,582,582,True
3885,2011-06-15,2,0,6,18,0,3,1,1,0.72,0.6515,0.32,0.1343,80,499,579,579,True
3886,2011-06-15,2,0,6,19,0,3,1,1,0.7,0.6364,0.37,0.2836,54,362,416,416,True
3887,2011-06-15,2,0,6,20,0,3,1,1,0.66,0.6212,0.44,0.1642,57,273,330,330,True
3888,2011-06-15,2,0,6,21,0,3,1,1,0.64,0.6212,0.47,0.2239,48,209,257,257,True
3889,2011-06-15,2,0,6,22,0,3,1,1,0.62,0.6212,0.5,0.1045,31,144,175,175,True
3890,2011-06-15,2,0,6,23,0,3,1,1,0.62,0.6212,0.53,0.0,17,90,107,107,True
3891,2011-06-16,2,0,6,0,0,4,1,1,0.6,0.6212,0.56,0.1045,9,38,47,47,True
3892,2011-06-16,2,0,6,1,0,4,1,1,0.58,0.5455,0.6,0.0,4,13,17,17,True
3893,2011-06-16,2,0,6,2,0,4,1,1,0.6,0.6212,0.56,0.0896,1,4,5,5,True
3894,2011-06-16,2,0,6,3,0,4,1,2,0.56,0.5303,0.73,0.0896,0,4,4,4,True
3895,2011-06-16,2,0,6,4,0,4,1,2,0.56,0.5303,0.68,0.1045,0,6,6,6,True
3896,2011-06-16,2,0,6,5,0,4,1,1,0.6,0.6061,0.64,0.194,7,18,25,25,True
3897,2011-06-16,2,0,6,6,0,4,1,3,0.58,0.5455,0.73,0.1642,8,104,112,112,True
3898,2011-06-16,2,0,6,7,0,4,1,3,0.56,0.5303,0.78,0.1642,16,172,188,188,True
3899,2011-06-16,2,0,6,8,0,4,1,2,0.6,0.5909,0.69,0.1343,24,364,388,388,True
3900,2011-06-16,2,0,6,9,0,4,1,2,0.62,0.6061,0.65,0.194,29,232,261,261,True
3901,2011-06-16,2,0,6,10,0,4,1,2,0.66,0.6212,0.61,0.2537,18,103,121,121,True
3902,2011-06-16,2,0,6,11,0,4,1,2,0.68,0.6364,0.61,0.2985,33,117,150,150,True
3903,2011-06-16,2,0,6,12,0,4,1,1,0.72,0.6667,0.54,0.3881,41,165,206,206,True
3904,2011-06-16,2,0,6,13,0,4,1,2,0.72,0.6667,0.54,0.2537,37,114,151,151,True
3905,2011-06-16,2,0,6,14,0,4,1,2,0.72,0.6667,0.54,0.3284,39,114,153,153,True
3906,2011-06-16,2,0,6,15,0,4,1,2,0.7,0.6515,0.61,0.2985,32,127,159,159,True
3907,2011-06-16,2,0,6,16,0,4,1,3,0.66,0.6212,0.69,0.194,36,258,294,294,True
3908,2011-06-16,2,0,6,17,0,4,1,2,0.64,0.5909,0.78,0.1045,42,230,272,272,True
3909,2011-06-16,2,0,6,18,0,4,1,1,0.64,0.5758,0.83,0.2239,26,299,325,325,True
3910,2011-06-16,2,0,6,19,0,4,1,1,0.62,0.5758,0.83,0.2836,58,269,327,327,True
3911,2011-06-16,2,0,6,20,0,4,1,1,0.62,0.5758,0.83,0.3284,25,176,201,201,True
3912,2011-06-16,2,0,6,21,0,4,1,3,0.62,0.5758,0.83,0.2537,34,154,188,188,True
3913,2011-06-16,2,0,6,22,0,4,1,3,0.62,0.5758,0.83,0.2537,24,127,151,151,True
3914,2011-06-16,2,0,6,23,0,4,1,3,0.6,0.5606,0.83,0.2537,2,14,16,16,True
3915,2011-06-17,2,0,6,0,0,5,1,1,0.56,0.5303,0.88,0.0896,3,21,24,24,True
3916,2011-06-17,2,0,6,1,0,5,1,1,0.56,0.5303,0.94,0.1343,4,19,23,23,True
3917,2011-06-17,2,0,6,2,0,5,1,1,0.56,0.5303,0.94,0.1045,2,11,13,13,True
3918,2011-06-17,2,0,6,3,0,5,1,1,0.56,0.5303,0.94,0.1045,1,5,6,6,True
3919,2011-06-17,2,0,6,4,0,5,1,1,0.54,0.5152,0.94,0.1343,1,5,6,6,True
3920,2011-06-17,2,0,6,5,0,5,1,1,0.54,0.5152,1.0,0.0,1,12,13,13,True
3921,2011-06-17,2,0,6,6,0,5,1,1,0.56,0.5303,0.94,0.0,8,89,97,97,True
3922,2011-06-17,2,0,6,7,0,5,1,1,0.6,0.5606,0.83,0.0,25,225,250,250,True
3923,2011-06-17,2,0,6,8,0,5,1,2,0.6,0.5606,0.83,0.0,28,426,454,454,True
3924,2011-06-17,2,0,6,9,0,5,1,1,0.7,0.6515,0.58,0.194,28,196,224,224,True
3925,2011-06-17,2,0,6,10,0,5,1,1,0.7,0.6515,0.58,0.194,44,126,170,170,True
3926,2011-06-17,2,0,6,11,0,5,1,1,0.68,0.6364,0.69,0.2537,43,138,181,181,True
3927,2011-06-17,2,0,6,12,0,5,1,1,0.7,0.6515,0.65,0.2537,49,194,243,243,True
3928,2011-06-17,2,0,6,13,0,5,1,1,0.74,0.6818,0.62,0.2836,48,156,204,204,True
3929,2011-06-17,2,0,6,14,0,5,1,1,0.76,0.697,0.52,0.194,73,142,215,215,True
3930,2011-06-17,2,0,6,15,0,5,1,1,0.78,0.697,0.43,0.2239,62,181,243,243,True
3931,2011-06-17,2,0,6,16,0,5,1,1,0.76,0.6818,0.45,0.1642,69,286,355,355,True
3932,2011-06-17,2,0,6,17,0,5,1,3,0.76,0.6818,0.4,0.194,85,467,552,552,True
3933,2011-06-17,2,0,6,18,0,5,1,3,0.76,0.6818,0.4,0.194,62,388,450,450,True
3934,2011-06-17,2,0,6,19,0,5,1,3,0.64,0.5758,0.83,0.2537,53,275,328,328,True
3935,2011-06-17,2,0,6,20,0,5,1,1,0.64,0.5909,0.78,0.1045,40,192,232,232,True
3936,2011-06-17,2,0,6,21,0,5,1,1,0.64,0.5909,0.78,0.0896,49,159,208,208,True
3937,2011-06-17,2,0,6,22,0,5,1,1,0.62,0.5606,0.88,0.1343,48,127,175,175,True
3938,2011-06-17,2,0,6,23,0,5,1,1,0.62,0.5758,0.83,0.1343,37,141,178,178,True
3939,2011-06-18,2,0,6,0,0,6,0,1,0.62,0.5606,0.88,0.1343,21,83,104,104,True
3940,2011-06-18,2,0,6,1,0,6,0,1,0.62,0.5758,0.83,0.1045,15,80,95,95,True
3941,2011-06-18,2,0,6,2,0,6,0,1,0.6,0.5455,0.88,0.0,16,37,53,53,True
3942,2011-06-18,2,0,6,3,0,6,0,1,0.6,0.5455,0.88,0.0896,4,16,20,20,True
3943,2011-06-18,2,0,6,4,0,6,0,1,0.6,0.5455,0.88,0.0896,1,4,5,5,True
3944,2011-06-18,2,0,6,5,0,6,0,1,0.62,0.5758,0.83,0.0,1,6,7,7,True
3945,2011-06-18,2,0,6,6,0,6,0,1,0.62,0.5758,0.83,0.1045,9,18,27,27,True
3946,2011-06-18,2,0,6,7,0,6,0,1,0.64,0.5909,0.78,0.1343,12,45,57,57,True
3947,2011-06-18,2,0,6,8,0,6,0,1,0.66,0.6061,0.78,0.0896,28,103,131,131,True
3948,2011-06-18,2,0,6,9,0,6,0,1,0.7,0.6515,0.61,0.2239,62,156,218,218,True
3949,2011-06-18,2,0,6,10,0,6,0,1,0.72,0.6818,0.62,0.194,68,176,244,244,True
3950,2011-06-18,2,0,6,11,0,6,0,1,0.72,0.6818,0.62,0.1343,114,270,384,384,True
3951,2011-06-18,2,0,6,12,0,6,0,1,0.74,0.697,0.66,0.0896,114,258,372,372,True
3952,2011-06-18,2,0,6,13,0,6,0,1,0.76,0.697,0.55,0.0,114,192,306,306,True
3953,2011-06-18,2,0,6,14,0,6,0,2,0.8,0.7273,0.46,0.2836,114,196,310,310,True
3954,2011-06-18,2,0,6,15,0,6,0,2,0.82,0.7576,0.46,0.1343,114,214,328,328,True
3955,2011-06-18,2,0,6,16,0,6,0,2,0.76,0.697,0.52,0.2239,114,275,389,389,True
3956,2011-06-18,2,0,6,17,0,6,0,2,0.76,0.6818,0.48,0.1642,114,239,353,353,True
3957,2011-06-18,2,0,6,18,0,6,0,2,0.74,0.6818,0.55,0.194,114,263,377,377,True
3958,2011-06-18,2,0,6,19,0,6,0,2,0.74,0.6667,0.51,0.1045,99,227,326,326,True
3959,2011-06-18,2,0,6,20,0,6,0,2,0.72,0.6667,0.58,0.1343,61,127,188,188,True
3960,2011-06-18,2,0,6,21,0,6,0,2,0.72,0.6818,0.66,0.1045,58,125,183,183,True
3961,2011-06-18,2,0,6,22,0,6,0,2,0.72,0.6818,0.62,0.1343,56,105,161,161,True
3962,2011-06-18,2,0,6,23,0,6,0,2,0.72,0.6818,0.62,0.0,53,97,150,150,True
3963,2011-06-19,2,0,6,0,0,0,0,1,0.7,0.6515,0.65,0.0,18,71,89,89,True
3964,2011-06-19,2,0,6,1,0,0,0,2,0.7,0.6515,0.65,0.0896,17,59,76,76,True
3965,2011-06-19,2,0,6,2,0,0,0,1,0.68,0.6364,0.74,0.0896,13,59,72,72,True
3966,2011-06-19,2,0,6,3,0,0,0,2,0.66,0.6061,0.78,0.1343,14,16,30,30,True
3967,2011-06-19,2,0,6,4,0,0,0,2,0.66,0.6212,0.74,0.1343,7,10,17,17,True
3968,2011-06-19,2,0,6,5,0,0,0,2,0.66,0.6061,0.78,0.0,7,12,19,19,True
3969,2011-06-19,2,0,6,6,0,0,0,2,0.66,0.6061,0.78,0.1642,11,22,33,33,True
3970,2011-06-19,2,0,6,7,0,0,0,2,0.66,0.6061,0.78,0.1642,35,36,71,71,True
3971,2011-06-19,2,0,6,8,0,0,0,3,0.68,0.6364,0.74,0.1045,25,59,84,84,True
3972,2011-06-19,2,0,6,9,0,0,0,2,0.68,0.6364,0.74,0.1045,58,111,169,169,True
3973,2011-06-19,2,0,6,10,0,0,0,2,0.7,0.6515,0.61,0.1045,86,158,244,244,True
3974,2011-06-19,2,0,6,11,0,0,0,2,0.72,0.6667,0.58,0.0896,114,236,350,350,True
3975,2011-06-19,2,0,6,12,0,0,0,2,0.74,0.6818,0.55,0.0896,114,255,369,369,True
3976,2011-06-19,2,0,6,13,0,0,0,2,0.74,0.6667,0.51,0.0,114,214,328,328,True
3977,2011-06-19,2,0,6,14,0,0,0,3,0.74,0.6818,0.58,0.1045,114,193,307,307,True
3978,2011-06-19,2,0,6,15,0,0,0,2,0.74,0.6818,0.55,0.1045,114,216,330,330,True
3979,2011-06-19,2,0,6,16,0,0,0,2,0.76,0.6818,0.48,0.0,114,257,371,371,True
3980,2011-06-19,2,0,6,17,0,0,0,1,0.74,0.6667,0.51,0.0,114,238,352,352,True
3981,2011-06-19,2,0,6,18,0,0,0,2,0.74,0.6818,0.58,0.0896,78,218,296,296,True
3982,2011-06-19,2,0,6,19,0,0,0,1,0.72,0.6818,0.62,0.1343,94,217,311,311,True
3983,2011-06-19,2,0,6,20,0,0,0,1,0.7,0.6515,0.7,0.194,86,146,232,232,True
3984,2011-06-19,2,0,6,21,0,0,0,1,0.68,0.6364,0.79,0.1343,57,110,167,167,True
3985,2011-06-19,2,0,6,22,0,0,0,1,0.66,0.6061,0.78,0.2239,38,114,152,152,True
3986,2011-06-19,2,0,6,23,0,0,0,1,0.66,0.6061,0.78,0.194,14,78,92,92,True
3987,2011-06-20,2,0,6,0,0,1,1,1,0.66,0.6061,0.83,0.1642,7,19,26,26,True
3988,2011-06-20,2,0,6,1,0,1,1,1,0.64,0.5758,0.89,0.0896,9,3,12,12,True
3989,2011-06-20,2,0,6,2,0,1,1,1,0.64,0.5758,0.89,0.0896,2,0,2,2,True
3990,2011-06-20,2,0,6,3,0,1,1,3,0.64,0.5758,0.89,0.0,1,0,1,1,True
3991,2011-06-20,2,0,6,4,0,1,1,3,0.62,0.5606,0.88,0.1642,1,2,3,3,True
3992,2011-06-20,2,0,6,5,0,1,1,3,0.62,0.5758,0.83,0.1343,0,3,3,3,True
3993,2011-06-20,2,0,6,6,0,1,1,3,0.6,0.5758,0.78,0.1343,1,25,26,26,True
3994,2011-06-20,2,0,6,7,0,1,1,3,0.56,0.5303,0.88,0.194,0,46,46,46,True
3995,2011-06-20,2,0,6,8,0,1,1,3,0.56,0.5303,0.83,0.194,12,209,221,221,True
3996,2011-06-20,2,0,6,9,0,1,1,2,0.6,0.5758,0.78,0.2537,19,200,219,219,True
3997,2011-06-20,2,0,6,10,0,1,1,2,0.6,0.5758,0.78,0.2537,33,58,91,91,True
3998,2011-06-20,2,0,6,11,0,1,1,2,0.6,0.5758,0.78,0.1045,27,67,94,94,True
3999,2011-06-20,2,0,6,12,0,1,1,2,0.62,0.6061,0.69,0.1045,33,129,162,162,True
4000,2011-06-20,2,0,6,13,0,1,1,1,0.64,0.6061,0.65,0.1045,50,129,179,179,True
4001,2011-06-20,2,0,6,14,0,1,1,1,0.66,0.6212,0.61,0.1045,45,130,175,175,True
4002,2011-06-20,2,0,6,15,0,1,1,1,0.66,0.6212,0.61,0.1343,66,139,205,205,True
4003,2011-06-20,2,0,6,16,0,1,1,1,0.7,0.6515,0.58,0.1642,61,238,299,299,True
4004,2011-06-20,2,0,6,17,0,1,1,1,0.7,0.6515,0.54,0.0,81,484,565,565,True
4005,2011-06-20,2,0,6,18,0,1,1,1,0.7,0.6515,0.61,0.2537,64,474,538,538,True
4006,2011-06-20,2,0,6,19,0,1,1,1,0.66,0.6212,0.65,0.2239,62,369,431,431,True
4007,2011-06-20,2,0,6,20,0,1,1,1,0.66,0.6212,0.69,0.2239,52,264,316,316,True
4008,2011-06-20,2,0,6,21,0,1,1,1,0.64,0.6061,0.73,0.1642,39,167,206,206,True
4009,2011-06-20,2,0,6,22,0,1,1,2,0.64,0.6061,0.73,0.2239,24,106,130,130,True
4010,2011-06-20,2,0,6,23,0,1,1,1,0.62,0.5909,0.78,0.2537,10,50,60,60,True
4011,2011-06-21,3,0,6,0,0,2,1,1,0.62,0.5909,0.78,0.1642,10,23,33,33,True
4012,2011-06-21,3,0,6,1,0,2,1,3,0.62,0.5909,0.78,0.1642,2,12,14,14,True
4013,2011-06-21,3,0,6,2,0,2,1,3,0.62,0.5758,0.83,0.1642,1,5,6,6,True
4014,2011-06-21,3,0,6,3,0,2,1,3,0.62,0.5758,0.83,0.1642,0,2,2,2,True
4015,2011-06-21,3,0,6,4,0,2,1,2,0.6,0.5455,0.88,0.1045,2,7,9,9,True
4016,2011-06-21,3,0,6,5,0,2,1,2,0.6,0.5455,0.88,0.1343,3,22,25,25,True
4017,2011-06-21,3,0,6,6,0,2,1,2,0.6,0.5455,0.88,0.1343,8,107,115,115,True
4018,2011-06-21,3,0,6,7,0,2,1,2,0.6,0.5152,0.94,0.0,21,288,309,309,True
4019,2011-06-21,3,0,6,8,0,2,1,2,0.62,0.5606,0.88,0.1045,33,368,401,401,True
4020,2011-06-21,3,0,6,9,0,2,1,2,0.62,0.5606,0.88,0.2537,32,243,275,275,True
4021,2011-06-21,3,0,6,10,0,2,1,2,0.64,0.5758,0.83,0.194,41,120,161,161,True
4022,2011-06-21,3,0,6,11,0,2,1,1,0.66,0.6061,0.83,0.1642,52,119,171,171,True
4023,2011-06-21,3,0,6,12,0,2,1,1,0.7,0.6667,0.74,0.1642,40,149,189,189,True
4024,2011-06-21,3,0,6,13,0,2,1,1,0.74,0.697,0.66,0.1642,49,158,207,207,True
4025,2011-06-21,3,0,6,14,0,2,1,1,0.76,0.7121,0.62,0.2239,44,108,152,152,True
4026,2011-06-21,3,0,6,15,0,2,1,1,0.78,0.7424,0.59,0.2537,42,128,170,170,True
4027,2011-06-21,3,0,6,16,0,2,1,1,0.8,0.7727,0.59,0.2239,62,273,335,335,True
4028,2011-06-21,3,0,6,17,0,2,1,1,0.78,0.7576,0.66,0.2239,65,499,564,564,True
4029,2011-06-21,3,0,6,18,0,2,1,2,0.76,0.7273,0.7,0.2537,67,469,536,536,True
4030,2011-06-21,3,0,6,19,0,2,1,2,0.74,0.7121,0.74,0.2239,67,358,425,425,True
4031,2011-06-21,3,0,6,20,0,2,1,3,0.74,0.697,0.7,0.2239,72,254,326,326,True
4032,2011-06-21,3,0,6,21,0,2,1,1,0.72,0.697,0.74,0.194,38,191,229,229,True
4033,2011-06-21,3,0,6,22,0,2,1,1,0.7,0.6667,0.79,0.1045,12,97,109,109,True
4034,2011-06-21,3,0,6,23,0,2,1,1,0.7,0.6667,0.74,0.1045,11,53,64,64,True
4035,2011-06-22,3,0,6,0,0,3,1,1,0.66,0.6061,0.78,0.194,15,18,33,33,True
4036,2011-06-22,3,0,6,1,0,3,1,1,0.66,0.6061,0.78,0.1343,2,19,21,21,True
4037,2011-06-22,3,0,6,2,0,3,1,1,0.66,0.6061,0.78,0.0,2,5,7,7,True
4038,2011-06-22,3,0,6,3,0,3,1,1,0.66,0.6061,0.78,0.1343,0,7,7,7,True
4039,2011-06-22,3,0,6,4,0,3,1,1,0.64,0.5758,0.83,0.0,3,8,11,11,True
4040,2011-06-22,3,0,6,5,0,3,1,1,0.64,0.5758,0.89,0.0,2,21,23,23,True
4041,2011-06-22,3,0,6,6,0,3,1,1,0.66,0.6061,0.83,0.0,12,110,122,122,True
4042,2011-06-22,3,0,6,7,0,3,1,1,0.7,0.6667,0.79,0.0,23,288,311,311,True
4043,2011-06-22,3,0,6,8,0,3,1,1,0.72,0.697,0.74,0.1045,27,396,423,423,True
4044,2011-06-22,3,0,6,9,0,3,1,1,0.72,0.697,0.79,0.1642,14,205,219,219,True
4045,2011-06-22,3,0,6,10,0,3,1,1,0.74,0.697,0.7,0.2537,31,104,135,135,True
4046,2011-06-22,3,0,6,11,0,3,1,1,0.74,0.697,0.7,0.1642,37,108,145,145,True
4047,2011-06-22,3,0,6,12,0,3,1,2,0.8,0.7727,0.59,0.2239,44,144,188,188,True
4048,2011-06-22,3,0,6,13,0,3,1,2,0.82,0.7879,0.56,0.2537,34,113,147,147,True
4049,2011-06-22,3,0,6,14,0,3,1,2,0.82,0.7727,0.52,0.2836,32,113,145,145,True
4050,2011-06-22,3,0,6,15,0,3,1,2,0.82,0.7879,0.56,0.2836,32,114,146,146,True
4051,2011-06-22,3,0,6,16,0,3,1,2,0.82,0.803,0.59,0.3284,34,224,258,258,True
4052,2011-06-22,3,0,6,17,0,3,1,2,0.8,0.7576,0.55,0.3881,67,462,529,529,True
4053,2011-06-22,3,0,6,18,0,3,1,2,0.8,0.7727,0.59,0.2537,66,447,513,513,True
4054,2011-06-22,3,0,6,19,0,3,1,2,0.8,0.7424,0.52,0.2537,62,280,342,342,True
4055,2011-06-22,3,0,6,20,0,3,1,1,0.74,0.7121,0.74,0.1343,52,230,282,282,True
4056,2011-06-22,3,0,6,21,0,3,1,1,0.74,0.7121,0.79,0.1642,31,216,247,247,True
4057,2011-06-22,3,0,6,22,0,3,1,2,0.72,0.697,0.79,0.194,25,123,148,148,True
4058,2011-06-22,3,0,6,23,0,3,1,2,0.72,0.697,0.79,0.2239,14,91,105,105,True
4059,2011-06-23,3,0,6,0,0,4,1,1,0.72,0.697,0.79,0.2239,5,44,49,49,True
4060,2011-06-23,3,0,6,1,0,4,1,1,0.72,0.697,0.74,0.2239,5,26,31,31,True
4061,2011-06-23,3,0,6,2,0,4,1,1,0.72,0.697,0.74,0.2239,0,4,4,4,True
4062,2011-06-23,3,0,6,3,0,4,1,2,0.72,0.697,0.74,0.1642,1,4,5,5,True
4063,2011-06-23,3,0,6,4,0,4,1,2,0.7,0.6667,0.79,0.1343,0,7,7,7,True
4064,2011-06-23,3,0,6,5,0,4,1,1,0.72,0.697,0.74,0.1642,2,22,24,24,True
4065,2011-06-23,3,0,6,6,0,4,1,1,0.72,0.697,0.74,0.1642,8,92,100,100,True
4066,2011-06-23,3,0,6,7,0,4,1,2,0.72,0.697,0.74,0.1343,26,301,327,327,True
4067,2011-06-23,3,0,6,8,0,4,1,2,0.74,0.697,0.7,0.194,20,412,432,432,True
4068,2011-06-23,3,0,6,9,0,4,1,2,0.74,0.697,0.7,0.1343,33,194,227,227,True
4069,2011-06-23,3,0,6,10,0,4,1,2,0.76,0.7273,0.66,0.1343,39,88,127,127,True
4070,2011-06-23,3,0,6,11,0,4,1,3,0.76,0.7273,0.66,0.2537,28,108,136,136,True
4071,2011-06-23,3,0,6,12,0,4,1,2,0.76,0.7273,0.66,0.2836,30,130,160,160,True
4072,2011-06-23,3,0,6,13,0,4,1,2,0.76,0.7121,0.62,0.2836,37,149,186,186,True
4073,2011-06-23,3,0,6,14,0,4,1,2,0.76,0.7273,0.66,0.2985,46,103,149,149,True
4074,2011-06-23,3,0,6,15,0,4,1,2,0.76,0.697,0.52,0.3582,62,127,189,189,True
4075,2011-06-23,3,0,6,16,0,4,1,2,0.74,0.6818,0.62,0.2985,58,217,275,275,True
4076,2011-06-23,3,0,6,17,0,4,1,2,0.72,0.6818,0.7,0.3582,74,495,569,569,True
4077,2011-06-23,3,0,6,18,0,4,1,1,0.72,0.6818,0.7,0.4179,57,483,540,540,True
4078,2011-06-23,3,0,6,19,0,4,1,1,0.72,0.6818,0.7,0.3582,56,344,400,400,True
4079,2011-06-23,3,0,6,20,0,4,1,1,0.7,0.6667,0.74,0.2239,75,277,352,352,True
4080,2011-06-23,3,0,6,21,0,4,1,1,0.7,0.6667,0.74,0.194,46,188,234,234,True
4081,2011-06-23,3,0,6,22,0,4,1,2,0.7,0.6667,0.74,0.2239,23,139,162,162,True
4082,2011-06-23,3,0,6,23,0,4,1,1,0.7,0.6667,0.74,0.2836,15,90,105,105,True
4083,2011-06-24,3,0,6,0,0,5,1,1,0.68,0.6364,0.79,0.194,10,53,63,63,True
4084,2011-06-24,3,0,6,1,0,5,1,1,0.66,0.6061,0.83,0.3284,8,20,28,28,True
4085,2011-06-24,3,0,6,2,0,5,1,1,0.66,0.6061,0.83,0.3284,4,10,14,14,True
4086,2011-06-24,3,0,6,3,0,5,1,1,0.66,0.6061,0.83,0.1642,1,4,5,5,True
4087,2011-06-24,3,0,6,4,0,5,1,1,0.66,0.6061,0.83,0.0896,1,8,9,9,True
4088,2011-06-24,3,0,6,5,0,5,1,1,0.64,0.5758,0.89,0.0896,2,18,20,20,True
4089,2011-06-24,3,0,6,6,0,5,1,1,0.66,0.6061,0.83,0.1343,4,87,91,91,True
4090,2011-06-24,3,0,6,7,0,5,1,2,0.66,0.6061,0.83,0.2239,21,247,268,268,True
4091,2011-06-24,3,0,6,8,0,5,1,1,0.7,0.6667,0.74,0.2239,27,439,466,466,True
4092,2011-06-24,3,0,6,9,0,5,1,1,0.74,0.6818,0.62,0.1343,28,203,231,231,True
4093,2011-06-24,3,0,6,10,0,5,1,1,0.8,0.7273,0.43,0.2836,43,102,145,145,True
4094,2011-06-24,3,0,6,11,0,5,1,1,0.8,0.7121,0.38,0.3284,56,147,203,203,True
4095,2011-06-24,3,0,6,12,0,5,1,1,0.8,0.7121,0.41,0.2836,51,150,201,201,True
4096,2011-06-24,3,0,6,13,0,5,1,1,0.8,0.7121,0.36,0.2239,43,178,221,221,True
4097,2011-06-24,3,0,6,14,0,5,1,1,0.78,0.697,0.43,0.2836,67,162,229,229,True
4098,2011-06-24,3,0,6,15,0,5,1,1,0.82,0.7273,0.34,0.3881,69,147,216,216,True
4099,2011-06-24,3,0,6,16,0,5,1,1,0.8,0.697,0.33,0.4179,80,247,327,327,True
4100,2011-06-24,3,0,6,17,0,5,1,1,0.76,0.6667,0.37,0.2537,85,472,557,557,True
4101,2011-06-24,3,0,6,18,0,5,1,1,0.76,0.6667,0.37,0.2985,87,365,452,452,True
4102,2011-06-24,3,0,6,19,0,5,1,1,0.74,0.6515,0.4,0.2239,92,293,385,385,True
4103,2011-06-24,3,0,6,20,0,5,1,1,0.72,0.6515,0.45,0.1642,66,222,288,288,True
4104,2011-06-24,3,0,6,21,0,5,1,1,0.7,0.6515,0.48,0.1343,50,183,233,233,True
4105,2011-06-24,3,0,6,22,0,5,1,1,0.7,0.6515,0.48,0.0,41,126,167,167,True
4106,2011-06-24,3,0,6,23,0,5,1,1,0.68,0.6364,0.51,0.1343,33,139,172,172,True
4107,2011-06-25,3,0,6,0,0,6,0,1,0.68,0.6364,0.47,0.1642,19,97,116,116,True
4108,2011-06-25,3,0,6,1,0,6,0,1,0.66,0.6212,0.5,0.1642,20,75,95,95,True
4109,2011-06-25,3,0,6,2,0,6,0,2,0.66,0.6212,0.5,0.194,8,51,59,59,True
4110,2011-06-25,3,0,6,3,0,6,0,1,0.64,0.6212,0.57,0.194,18,21,39,39,True
4111,2011-06-25,3,0,6,4,0,6,0,1,0.64,0.6212,0.57,0.194,7,4,11,11,True
4112,2011-06-25,3,0,6,5,0,6,0,1,0.62,0.6061,0.61,0.1343,6,8,14,14,True
4113,2011-06-25,3,0,6,6,0,6,0,1,0.64,0.6212,0.57,0.2239,12,17,29,29,True
4114,2011-06-25,3,0,6,7,0,6,0,1,0.64,0.6212,0.57,0.2836,7,35,42,42,True
4115,2011-06-25,3,0,6,8,0,6,0,1,0.7,0.6515,0.48,0.2537,27,85,112,112,True
4116,2011-06-25,3,0,6,9,0,6,0,1,0.72,0.6515,0.45,0.2537,47,139,186,186,True
4117,2011-06-25,3,0,6,10,0,6,0,1,0.72,0.6515,0.45,0.194,99,203,302,302,True
4118,2011-06-25,3,0,6,11,0,6,0,1,0.74,0.6667,0.42,0.0,114,209,323,323,True
4119,2011-06-25,3,0,6,12,0,6,0,1,0.74,0.6515,0.4,0.2836,114,252,366,366,True
4120,2011-06-25,3,0,6,13,0,6,0,1,0.74,0.6515,0.4,0.2836,114,231,345,345,True
4121,2011-06-25,3,0,6,14,0,6,0,1,0.74,0.6667,0.45,0.2985,114,232,346,346,True
4122,2011-06-25,3,0,6,15,0,6,0,1,0.74,0.6667,0.45,0.0,114,235,349,349,True
4123,2011-06-25,3,0,6,16,0,6,0,1,0.76,0.6818,0.43,0.2985,114,235,349,349,True
4124,2011-06-25,3,0,6,17,0,6,0,1,0.74,0.6667,0.42,0.2239,114,247,361,361,True
4125,2011-06-25,3,0,6,18,0,6,0,1,0.72,0.6515,0.45,0.2537,108,199,307,307,True
4126,2011-06-25,3,0,6,19,0,6,0,1,0.72,0.6667,0.48,0.2836,114,254,368,368,True
4127,2011-06-25,3,0,6,20,0,6,0,1,0.7,0.6515,0.48,0.194,74,195,269,269,True
4128,2011-06-25,3,0,6,21,0,6,0,1,0.68,0.6364,0.51,0.1642,62,140,202,202,True
4129,2011-06-25,3,0,6,22,0,6,0,1,0.68,0.6364,0.47,0.194,61,126,187,187,True
4130,2011-06-25,3,0,6,23,0,6,0,2,0.66,0.6212,0.5,0.2985,49,130,179,179,True
4131,2011-06-26,3,0,6,0,0,0,0,1,0.64,0.6212,0.53,0.0,30,85,115,115,True
4132,2011-06-26,3,0,6,1,0,0,0,1,0.64,0.6212,0.53,0.1045,17,73,90,90,True
4133,2011-06-26,3,0,6,2,0,0,0,1,0.62,0.6212,0.57,0.1045,17,70,87,87,True
4134,2011-06-26,3,0,6,3,0,0,0,1,0.6,0.6061,0.64,0.1045,12,22,34,34,True
4135,2011-06-26,3,0,6,4,0,0,0,1,0.6,0.6061,0.64,0.0896,3,8,11,11,True
4136,2011-06-26,3,0,6,5,0,0,0,1,0.6,0.6061,0.64,0.0,3,9,12,12,True
4137,2011-06-26,3,0,6,6,0,0,0,1,0.6,0.6061,0.64,0.0,7,13,20,20,True
4138,2011-06-26,3,0,6,7,0,0,0,1,0.62,0.6061,0.61,0.0,24,27,51,51,True
4139,2011-06-26,3,0,6,8,0,0,0,1,0.64,0.6212,0.61,0.194,29,78,107,107,True
4140,2011-06-26,3,0,6,9,0,0,0,1,0.66,0.6212,0.54,0.0896,75,131,206,206,True
4141,2011-06-26,3,0,6,10,0,0,0,1,0.72,0.6667,0.48,0.1045,114,196,310,310,True
4142,2011-06-26,3,0,6,11,0,0,0,1,0.72,0.6515,0.45,0.1343,114,219,333,333,True
4143,2011-06-26,3,0,6,12,0,0,0,1,0.74,0.6515,0.4,0.1642,114,268,382,382,True
4144,2011-06-26,3,0,6,13,0,0,0,1,0.74,0.6515,0.4,0.0,114,245,359,359,True
4145,2011-06-26,3,0,6,14,0,0,0,1,0.74,0.6515,0.4,0.1343,114,246,360,360,True
4146,2011-06-26,3,0,6,15,0,0,0,1,0.74,0.6515,0.4,0.0,114,229,343,343,True
4147,2011-06-26,3,0,6,16,0,0,0,1,0.74,0.6667,0.42,0.194,114,278,392,392,True
4148,2011-06-26,3,0,6,17,0,0,0,2,0.72,0.6515,0.42,0.1642,114,243,357,357,True
4149,2011-06-26,3,0,6,18,0,0,0,2,0.72,0.6515,0.45,0.2537,114,265,379,379,True
4150,2011-06-26,3,0,6,19,0,0,0,2,0.72,0.6667,0.48,0.1343,89,228,317,317,True
4151,2011-06-26,3,0,6,20,0,0,0,2,0.7,0.6515,0.48,0.1045,55,158,213,213,True
4152,2011-06-26,3,0,6,21,0,0,0,2,0.7,0.6515,0.54,0.1045,48,135,183,183,True
4153,2011-06-26,3,0,6,22,0,0,0,1,0.7,0.6515,0.51,0.0,19,95,114,114,True
4154,2011-06-26,3,0,6,23,0,0,0,1,0.7,0.6515,0.54,0.0896,14,64,78,78,True
4155,2011-06-27,3,0,6,0,0,1,1,3,0.64,0.6061,0.73,0.2836,7,25,32,32,True
4156,2011-06-27,3,0,6,1,0,1,1,2,0.62,0.5909,0.78,0.1343,4,11,15,15,True
4157,2011-06-27,3,0,6,2,0,1,1,3,0.62,0.5909,0.78,0.1343,3,3,6,6,True
4158,2011-06-27,3,0,6,3,0,1,1,3,0.62,0.5909,0.78,0.1343,0,2,2,2,True
4159,2011-06-27,3,0,6,4,0,1,1,2,0.6,0.5606,0.83,0.1642,1,8,9,9,True
4160,2011-06-27,3,0,6,5,0,1,1,2,0.62,0.5758,0.83,0.1642,1,21,22,22,True
4161,2011-06-27,3,0,6,6,0,1,1,2,0.62,0.5909,0.78,0.1642,4,90,94,94,True
4162,2011-06-27,3,0,6,7,0,1,1,2,0.64,0.6061,0.73,0.2239,14,247,261,261,True
4163,2011-06-27,3,0,6,8,0,1,1,1,0.66,0.6212,0.74,0.194,29,418,447,447,True
4164,2011-06-27,3,0,6,9,0,1,1,2,0.72,0.6667,0.54,0.0,37,150,187,187,True
4165,2011-06-27,3,0,6,10,0,1,1,2,0.72,0.6667,0.54,0.1343,55,95,150,150,True
4166,2011-06-27,3,0,6,11,0,1,1,2,0.7,0.6515,0.58,0.0,55,95,150,150,True
4167,2011-06-27,3,0,6,12,0,1,1,2,0.72,0.6667,0.54,0.0,40,130,170,170,True
4168,2011-06-27,3,0,6,13,0,1,1,2,0.72,0.6667,0.58,0.2239,37,127,164,164,True
4169,2011-06-27,3,0,6,14,0,1,1,2,0.72,0.6667,0.58,0.0896,58,100,158,158,True
4170,2011-06-27,3,0,6,15,0,1,1,2,0.74,0.6818,0.55,0.0,76,126,202,202,True
4171,2011-06-27,3,0,6,16,0,1,1,1,0.74,0.6818,0.55,0.1045,53,222,275,275,True
4172,2011-06-27,3,0,6,17,0,1,1,1,0.74,0.6818,0.55,0.1343,90,499,589,589,True
4173,2011-06-27,3,0,6,18,0,1,1,1,0.74,0.6667,0.51,0.0,79,499,578,578,True
4174,2011-06-27,3,0,6,19,0,1,1,1,0.72,0.6818,0.62,0.194,56,340,396,396,True
4175,2011-06-27,3,0,6,20,0,1,1,1,0.7,0.6515,0.65,0.1045,54,251,305,305,True
4176,2011-06-27,3,0,6,21,0,1,1,1,0.7,0.6515,0.65,0.0,52,190,242,242,True
4177,2011-06-27,3,0,6,22,0,1,1,1,0.68,0.6364,0.69,0.0,33,112,145,145,True
4178,2011-06-27,3,0,6,23,0,1,1,1,0.68,0.6364,0.69,0.0,16,65,81,81,True
4179,2011-06-28,3,0,6,0,0,2,1,2,0.66,0.6061,0.78,0.1343,5,25,30,30,True
4180,2011-06-28,3,0,6,1,0,2,1,1,0.66,0.6212,0.74,0.0,5,8,13,13,True
4181,2011-06-28,3,0,6,2,0,2,1,2,0.66,0.6212,0.74,0.0,2,9,11,11,True
4182,2011-06-28,3,0,6,3,0,2,1,2,0.66,0.6212,0.74,0.0,0,2,2,2,True
4183,2011-06-28,3,0,6,4,0,2,1,1,0.66,0.6212,0.74,0.0,1,7,8,8,True
4184,2011-06-28,3,0,6,5,0,2,1,1,0.66,0.6061,0.78,0.0,1,20,21,21,True
4185,2011-06-28,3,0,6,6,0,2,1,1,0.66,0.6061,0.83,0.1642,7,117,124,124,True
4186,2011-06-28,3,0,6,7,0,2,1,1,0.68,0.6364,0.83,0.194,27,320,347,347,True
4187,2011-06-28,3,0,6,8,0,2,1,1,0.7,0.6667,0.79,0.1642,39,417,456,456,True
4188,2011-06-28,3,0,6,9,0,2,1,1,0.74,0.697,0.7,0.0,38,208,246,246,True
4189,2011-06-28,3,0,6,10,0,2,1,1,0.8,0.7424,0.49,0.1642,45,112,157,157,True
4190,2011-06-28,3,0,6,11,0,2,1,1,0.82,0.7576,0.46,0.0,49,118,167,167,True
4191,2011-06-28,3,0,6,12,0,2,1,1,0.84,0.7727,0.47,0.2239,41,161,202,202,True
4192,2011-06-28,3,0,6,13,0,2,1,1,0.84,0.7576,0.44,0.0,33,156,189,189,True
4193,2011-06-28,3,0,6,14,0,2,1,1,0.86,0.7879,0.44,0.2239,43,117,160,160,True
4194,2011-06-28,3,0,6,15,0,2,1,1,0.86,0.7879,0.41,0.0,39,127,166,166,True
4195,2011-06-28,3,0,6,16,0,2,1,1,0.86,0.803,0.47,0.2836,41,220,261,261,True
4196,2011-06-28,3,0,6,17,0,2,1,3,0.82,0.7879,0.56,0.2836,70,499,569,569,True
4197,2011-06-28,3,0,6,18,0,2,1,3,0.8,0.7576,0.55,0.2985,68,436,504,504,True
4198,2011-06-28,3,0,6,19,0,2,1,2,0.74,0.6818,0.58,0.4627,44,255,299,299,True
4199,2011-06-28,3,0,6,20,0,2,1,1,0.74,0.6818,0.62,0.0,50,246,296,296,True
4200,2011-06-28,3,0,6,21,0,2,1,1,0.74,0.697,0.66,0.2836,31,164,195,195,True
4201,2011-06-28,3,0,6,22,0,2,1,1,0.7,0.6515,0.7,0.2985,30,104,134,134,True
4202,2011-06-28,3,0,6,23,0,2,1,1,0.7,0.6515,0.7,0.2836,23,58,81,81,True
4203,2011-06-29,3,0,6,0,0,3,1,2,0.68,0.6364,0.79,0.2836,11,25,36,36,True
4204,2011-06-29,3,0,6,1,0,3,1,1,0.68,0.6364,0.79,0.2985,10,18,28,28,True
4205,2011-06-29,3,0,6,2,0,3,1,1,0.66,0.6061,0.83,0.2239,7,9,16,16,True
4206,2011-06-29,3,0,6,3,0,3,1,2,0.66,0.6061,0.83,0.1045,2,3,5,5,True
4207,2011-06-29,3,0,6,4,0,3,1,1,0.66,0.6061,0.83,0.1045,0,5,5,5,True
4208,2011-06-29,3,0,6,5,0,3,1,1,0.64,0.5758,0.83,0.194,3,19,22,22,True
4209,2011-06-29,3,0,6,6,0,3,1,1,0.66,0.6212,0.69,0.2985,12,104,116,116,True
4210,2011-06-29,3,0,6,7,0,3,1,1,0.7,0.6515,0.54,0.2239,18,318,336,336,True
4211,2011-06-29,3,0,6,8,0,3,1,1,0.7,0.6515,0.48,0.2836,41,499,540,540,True
4212,2011-06-29,3,0,6,9,0,3,1,1,0.72,0.6515,0.45,0.3881,32,189,221,221,True
4213,2011-06-29,3,0,6,10,0,3,1,1,0.74,0.6667,0.42,0.2836,31,95,126,126,True
4214,2011-06-29,3,0,6,11,0,3,1,1,0.76,0.6667,0.35,0.2239,53,117,170,170,True
4215,2011-06-29,3,0,6,12,0,3,1,1,0.76,0.6667,0.35,0.2537,55,188,243,243,True
4216,2011-06-29,3,0,6,13,0,3,1,1,0.8,0.697,0.31,0.3284,45,186,231,231,True
4217,2011-06-29,3,0,6,14,0,3,1,1,0.8,0.697,0.31,0.194,50,138,188,188,True
4218,2011-06-29,3,0,6,15,0,3,1,1,0.82,0.7121,0.3,0.1642,43,146,189,189,True
4219,2011-06-29,3,0,6,16,0,3,1,1,0.82,0.7121,0.3,0.4179,60,268,328,328,True
4220,2011-06-29,3,0,6,17,0,3,1,1,0.82,0.7121,0.26,0.4179,78,492,570,570,True
4221,2011-06-29,3,0,6,18,0,3,1,1,0.8,0.697,0.29,0.2985,78,499,577,577,True
4222,2011-06-29,3,0,6,19,0,3,1,1,0.76,0.6667,0.35,0.3881,60,341,401,401,True
4223,2011-06-29,3,0,6,20,0,3,1,1,0.74,0.6515,0.37,0.2985,69,264,333,333,True
4224,2011-06-29,3,0,6,21,0,3,1,1,0.72,0.6515,0.39,0.2239,26,195,221,221,True
4225,2011-06-29,3,0,6,22,0,3,1,1,0.7,0.6364,0.42,0.194,32,151,183,183,True
4226,2011-06-29,3,0,6,23,0,3,1,1,0.68,0.6364,0.47,0.194,32,97,129,129,True
4227,2011-06-30,3,0,6,0,0,4,1,1,0.66,0.6212,0.5,0.1642,15,39,54,54,True
4228,2011-06-30,3,0,6,1,0,4,1,1,0.64,0.6212,0.53,0.1343,13,19,32,32,True
4229,2011-06-30,3,0,6,2,0,4,1,1,0.62,0.6212,0.57,0.1343,2,6,8,8,True
4230,2011-06-30,3,0,6,3,0,4,1,1,0.6,0.6061,0.6,0.1642,2,7,9,9,True
4231,2011-06-30,3,0,6,4,0,4,1,1,0.58,0.5455,0.64,0.1343,2,4,6,6,True
4232,2011-06-30,3,0,6,5,0,4,1,1,0.58,0.5455,0.64,0.2537,1,24,25,25,True
4233,2011-06-30,3,0,6,6,0,4,1,1,0.6,0.6061,0.64,0.2537,4,119,123,123,True
4234,2011-06-30,3,0,6,7,0,4,1,1,0.62,0.6061,0.61,0.2239,29,291,320,320,True
4235,2011-06-30,3,0,6,8,0,4,1,1,0.68,0.6364,0.47,0.2239,44,499,543,543,True
4236,2011-06-30,3,0,6,9,0,4,1,1,0.7,0.6364,0.42,0.2239,33,227,260,260,True
4237,2011-06-30,3,0,6,10,0,4,1,1,0.72,0.6515,0.42,0.194,35,97,132,132,True
4238,2011-06-30,3,0,6,11,0,4,1,1,0.74,0.6515,0.37,0.1343,47,122,169,169,True
4239,2011-06-30,3,0,6,12,0,4,1,1,0.76,0.6667,0.35,0.1642,50,183,233,233,True
4240,2011-06-30,3,0,6,13,0,4,1,1,0.76,0.6667,0.33,0.194,70,162,232,232,True
4241,2011-06-30,3,0,6,14,0,4,1,1,0.78,0.6818,0.31,0.194,46,117,163,163,True
4242,2011-06-30,3,0,6,15,0,4,1,1,0.78,0.6667,0.25,0.2537,64,176,240,240,True
4243,2011-06-30,3,0,6,16,0,4,1,1,0.8,0.697,0.26,0.1343,63,260,323,323,True
4244,2011-06-30,3,0,6,17,0,4,1,1,0.78,0.6818,0.27,0.3582,98,496,594,594,True
4245,2011-06-30,3,0,6,18,0,4,1,1,0.76,0.6667,0.29,0.2537,114,472,586,586,True
4246,2011-06-30,3,0,6,19,0,4,1,1,0.74,0.6515,0.33,0.194,89,366,455,455,True
4247,2011-06-30,3,0,6,20,0,4,1,1,0.74,0.6515,0.33,0.194,55,285,340,340,True
4248,2011-06-30,3,0,6,21,0,4,1,1,0.72,0.6515,0.37,0.1045,81,242,323,323,True
4249,2011-06-30,3,0,6,22,0,4,1,1,0.7,0.6364,0.42,0.1642,43,164,207,207,True
4250,2011-06-30,3,0,6,23,0,4,1,1,0.66,0.6212,0.5,0.0,27,99,126,126,True
4251,2011-07-01,3,0,7,0,0,5,1,1,0.66,0.6212,0.5,0.0,20,48,68,68,True
4252,2011-07-01,3,0,7,1,0,5,1,1,0.66,0.6212,0.5,0.0,15,16,31,31,True
4253,2011-07-01,3,0,7,2,0,5,1,1,0.62,0.6061,0.69,0.0,6,7,13,13,True
4254,2011-07-01,3,0,7,3,0,5,1,1,0.64,0.6212,0.53,0.0,5,6,11,11,True
4255,2011-07-01,3,0,7,4,0,5,1,1,0.62,0.6212,0.57,0.0,1,5,6,6,True
4256,2011-07-01,3,0,7,5,0,5,1,1,0.6,0.6061,0.64,0.1343,3,27,30,30,True
4257,2011-07-01,3,0,7,6,0,5,1,1,0.62,0.6061,0.61,0.1343,11,97,108,108,True
4258,2011-07-01,3,0,7,7,0,5,1,1,0.66,0.6212,0.54,0.1045,25,218,243,243,True
4259,2011-07-01,3,0,7,8,0,5,1,1,0.7,0.6364,0.42,0.1642,39,453,492,492,True
4260,2011-07-01,3,0,7,9,0,5,1,1,0.74,0.6515,0.35,0.1642,58,202,260,260,True
4261,2011-07-01,3,0,7,10,0,5,1,1,0.76,0.6667,0.33,0.1642,61,109,170,170,True
4262,2011-07-01,3,0,7,11,0,5,1,1,0.8,0.697,0.26,0.0,68,146,214,214,True
4263,2011-07-01,3,0,7,12,0,5,1,1,0.8,0.697,0.26,0.0,83,180,263,263,True
4264,2011-07-01,3,0,7,13,0,5,1,1,0.8,0.6818,0.24,0.0,83,209,292,292,True
4265,2011-07-01,3,0,7,14,0,5,1,1,0.82,0.697,0.23,0.194,78,225,303,303,True
4266,2011-07-01,3,0,7,15,0,5,1,1,0.82,0.697,0.21,0.2537,82,299,381,381,True
4267,2011-07-01,3,0,7,16,0,5,1,1,0.82,0.697,0.17,0.0,85,342,427,427,True
4268,2011-07-01,3,0,7,17,0,5,1,1,0.82,0.697,0.21,0.194,99,362,461,461,True
4269,2011-07-01,3,0,7,18,0,5,1,1,0.8,0.6818,0.24,0.2537,98,324,422,422,True
4270,2011-07-01,3,0,7,19,0,5,1,1,0.78,0.6667,0.25,0.194,80,238,318,318,True
4271,2011-07-01,3,0,7,20,0,5,1,1,0.72,0.6515,0.42,0.2239,84,185,269,269,True
4272,2011-07-01,3,0,7,21,0,5,1,1,0.7,0.6364,0.45,0.194,69,149,218,218,True
4273,2011-07-01,3,0,7,22,0,5,1,1,0.7,0.6364,0.42,0.0,49,173,222,222,True
4274,2011-07-01,3,0,7,23,0,5,1,1,0.68,0.6364,0.47,0.0896,44,96,140,140,True
4275,2011-07-02,3,0,7,0,0,6,0,1,0.68,0.6364,0.47,0.0896,31,84,115,115,True
4276,2011-07-02,3,0,7,1,0,6,0,1,0.66,0.6212,0.54,0.0,20,58,78,78,True
4277,2011-07-02,3,0,7,2,0,6,0,1,0.64,0.6212,0.53,0.0,9,43,52,52,True
4278,2011-07-02,3,0,7,3,0,6,0,1,0.64,0.6212,0.53,0.0,5,21,26,26,True
4279,2011-07-02,3,0,7,4,0,6,0,1,0.62,0.6061,0.61,0.0,3,8,11,11,True
4280,2011-07-02,3,0,7,5,0,6,0,1,0.58,0.5455,0.73,0.1045,1,13,14,14,True
4281,2011-07-02,3,0,7,6,0,6,0,1,0.62,0.6061,0.69,0.1045,11,21,32,32,True
4282,2011-07-02,3,0,7,7,0,6,0,1,0.64,0.6061,0.65,0.0,10,35,45,45,True
4283,2011-07-02,3,0,7,8,0,6,0,1,0.68,0.6364,0.57,0.0,38,94,132,132,True
4284,2011-07-02,3,0,7,9,0,6,0,1,0.74,0.6667,0.51,0.0896,55,124,179,179,True
4285,2011-07-02,3,0,7,10,0,6,0,1,0.8,0.7121,0.36,0.0,103,168,271,271,True
4286,2011-07-02,3,0,7,11,0,6,0,1,0.8,0.7121,0.36,0.0896,114,213,327,327,True
4287,2011-07-02,3,0,7,12,0,6,0,1,0.82,0.7121,0.3,0.1343,114,232,346,346,True
4288,2011-07-02,3,0,7,13,0,6,0,1,0.82,0.7121,0.3,0.1045,114,226,340,340,True
4289,2011-07-02,3,0,7,14,0,6,0,1,0.84,0.7121,0.2,0.0,114,215,329,329,True
4290,2011-07-02,3,0,7,15,0,6,0,1,0.86,0.7273,0.19,0.1642,114,163,277,277,True
4291,2011-07-02,3,0,7,16,0,6,0,1,0.88,0.7424,0.22,0.2239,114,192,306,306,True
4292,2011-07-02,3,0,7,17,0,6,0,1,0.84,0.7273,0.3,0.2239,114,170,284,284,True
4293,2011-07-02,3,0,7,18,0,6,0,1,0.82,0.7121,0.3,0.2836,114,190,304,304,True
4294,2011-07-02,3,0,7,19,0,6,0,1,0.8,0.697,0.33,0.2239,114,149,263,263,True
4295,2011-07-02,3,0,7,20,0,6,0,1,0.76,0.6818,0.45,0.2836,114,148,262,262,True
4296,2011-07-02,3,0,7,21,0,6,0,1,0.74,0.6667,0.48,0.194,95,137,232,232,True
4297,2011-07-02,3,0,7,22,0,6,0,1,0.72,0.6667,0.51,0.1642,78,123,201,201,True
4298,2011-07-02,3,0,7,23,0,6,0,1,0.72,0.6667,0.54,0.2836,66,88,154,154,True
4299,2011-07-03,3,0,7,0,0,0,0,1,0.7,0.6515,0.58,0.2239,47,97,144,144,True
4300,2011-07-03,3,0,7,1,0,0,0,2,0.7,0.6515,0.61,0.1642,23,55,78,78,True
4301,2011-07-03,3,0,7,2,0,0,0,1,0.7,0.6515,0.58,0.194,19,50,69,69,True
4302,2011-07-03,3,0,7,3,0,0,0,3,0.68,0.6364,0.65,0.0896,8,25,33,33,True
4303,2011-07-03,3,0,7,4,0,0,0,3,0.68,0.6364,0.65,0.0896,3,2,5,5,True
4304,2011-07-03,3,0,7,5,0,0,0,3,0.62,0.5758,0.83,0.194,0,1,1,1,True
4305,2011-07-03,3,0,7,6,0,0,0,2,0.62,0.5455,0.94,0.0896,0,3,3,3,True
4306,2011-07-03,3,0,7,7,0,0,0,2,0.64,0.5758,0.89,0.194,3,22,25,25,True
4307,2011-07-03,3,0,7,8,0,0,0,1,0.68,0.6364,0.79,0.2239,39,53,92,92,True
4308,2011-07-03,3,0,7,9,0,0,0,1,0.7,0.6667,0.74,0.2537,82,99,181,181,True
4309,2011-07-03,3,0,7,10,0,0,0,1,0.74,0.697,0.66,0.1642,114,133,247,247,True
4310,2011-07-03,3,0,7,11,0,0,0,1,0.76,0.7121,0.62,0.1045,114,175,289,289,True
4311,2011-07-03,3,0,7,12,0,0,0,1,0.8,0.7576,0.55,0.1045,114,206,320,320,True
4312,2011-07-03,3,0,7,13,0,0,0,1,0.8,0.7727,0.59,0.2239,114,173,287,287,True
4313,2011-07-03,3,0,7,14,0,0,0,1,0.82,0.7879,0.56,0.2537,114,150,264,264,True
4314,2011-07-03,3,0,7,15,0,0,0,1,0.84,0.803,0.53,0.2985,114,182,296,296,True
4315,2011-07-03,3,0,7,16,0,0,0,1,0.84,0.803,0.53,0.2985,114,219,333,333,True
4316,2011-07-03,3,0,7,17,0,0,0,3,0.8,0.7424,0.49,0.4775,114,177,291,291,True
4317,2011-07-03,3,0,7,18,0,0,0,3,0.8,0.7424,0.49,0.4775,74,107,181,181,True
4318,2011-07-03,3,0,7,19,0,0,0,2,0.66,0.6061,0.83,0.194,100,83,183,183,True
4319,2011-07-03,3,0,7,20,0,0,0,3,0.66,0.6061,0.83,0.0,83,93,176,176,True
4320,2011-07-03,3,0,7,21,0,0,0,2,0.66,0.6061,0.83,0.1642,75,92,167,167,True
4321,2011-07-03,3,0,7,22,0,0,0,2,0.66,0.6061,0.78,0.1045,69,93,162,162,True
4322,2011-07-03,3,0,7,23,0,0,0,1,0.64,0.5758,0.83,0.1642,70,77,147,147,True
4323,2011-07-04,3,0,7,0,1,1,0,1,0.64,0.5758,0.83,0.1343,63,77,140,140,True
4324,2011-07-04,3,0,7,1,1,1,0,1,0.64,0.5758,0.83,0.0896,43,76,119,119,True
4325,2011-07-04,3,0,7,2,1,1,0,1,0.64,0.5758,0.83,0.0,33,30,63,63,True
4326,2011-07-04,3,0,7,3,1,1,0,1,0.64,0.5909,0.78,0.0,13,13,26,26,True
4327,2011-07-04,3,0,7,4,1,1,0,2,0.66,0.6061,0.78,0.0896,8,4,12,12,True
4328,2011-07-04,3,0,7,5,1,1,0,2,0.64,0.5758,0.83,0.1343,1,3,4,4,True
4329,2011-07-04,3,0,7,6,1,1,0,1,0.64,0.5758,0.89,0.1642,5,11,16,16,True
4330,2011-07-04,3,0,7,7,1,1,0,1,0.66,0.6061,0.83,0.1343,17,19,36,36,True
4331,2011-07-04,3,0,7,8,1,1,0,1,0.7,0.6667,0.74,0.1045,42,44,86,86,True
4332,2011-07-04,3,0,7,9,1,1,0,2,0.72,0.6818,0.66,0.0896,114,96,210,210,True
4333,2011-07-04,3,0,7,10,1,1,0,2,0.76,0.697,0.55,0.0896,114,114,228,228,True
4334,2011-07-04,3,0,7,11,1,1,0,2,0.76,0.697,0.55,0.0896,114,172,286,286,True
4335,2011-07-04,3,0,7,12,1,1,0,2,0.78,0.7121,0.52,0.0,114,210,324,324,True
4336,2011-07-04,3,0,7,13,1,1,0,2,0.78,0.7121,0.49,0.0,114,181,295,295,True
4337,2011-07-04,3,0,7,14,1,1,0,1,0.8,0.7273,0.46,0.0,114,173,287,287,True
4338,2011-07-04,3,0,7,15,1,1,0,1,0.82,0.7424,0.43,0.0896,114,184,298,298,True
4339,2011-07-04,3,0,7,16,1,1,0,1,0.82,0.7424,0.41,0.0,114,216,330,330,True
4340,2011-07-04,3,0,7,17,1,1,0,1,0.8,0.7273,0.46,0.0,114,196,310,310,True
4341,2011-07-04,3,0,7,18,1,1,0,1,0.8,0.7273,0.46,0.1343,114,196,310,310,True
4342,2011-07-04,3,0,7,19,1,1,0,2,0.78,0.7121,0.49,0.1642,114,205,319,319,True
4343,2011-07-04,3,0,7,20,1,1,0,2,0.76,0.697,0.55,0.1045,114,191,305,305,True
4344,2011-07-04,3,0,7,21,1,1,0,2,0.74,0.6818,0.62,0.1045,114,262,376,376,True
4345,2011-07-04,3,0,7,22,1,1,0,2,0.74,0.6818,0.62,0.1343,114,211,325,325,True
4346,2011-07-04,3,0,7,23,1,1,0,2,0.72,0.6818,0.7,0.1045,44,94,138,138,True
4347,2011-07-05,3,0,7,0,0,2,1,2,0.7,0.6515,0.65,0.1642,19,36,55,55,True
4348,2011-07-05,3,0,7,1,0,2,1,1,0.7,0.6515,0.65,0.1045,15,24,39,39,True
4349,2011-07-05,3,0,7,2,0,2,1,1,0.66,0.6212,0.74,0.0896,8,5,13,13,True
4350,2011-07-05,3,0,7,3,0,2,1,1,0.66,0.6212,0.74,0.2239,1,7,8,8,True
4351,2011-07-05,3,0,7,4,0,2,1,1,0.66,0.6212,0.69,0.1642,1,4,5,5,True
4352,2011-07-05,3,0,7,5,0,2,1,1,0.66,0.6212,0.69,0.0,1,19,20,20,True
4353,2011-07-05,3,0,7,6,0,2,1,1,0.66,0.6212,0.74,0.0896,3,91,94,94,True
4354,2011-07-05,3,0,7,7,0,2,1,1,0.7,0.6515,0.65,0.0896,22,248,270,270,True
4355,2011-07-05,3,0,7,8,0,2,1,1,0.72,0.6818,0.62,0.1343,41,391,432,432,True
4356,2011-07-05,3,0,7,9,0,2,1,1,0.74,0.6818,0.58,0.1343,50,177,227,227,True
4357,2011-07-05,3,0,7,10,0,2,1,1,0.76,0.697,0.52,0.1045,55,84,139,139,True
4358,2011-07-05,3,0,7,11,0,2,1,1,0.78,0.697,0.46,0.1045,75,97,172,172,True
4359,2011-07-05,3,0,7,12,0,2,1,1,0.8,0.7273,0.43,0.1045,71,130,201,201,True
4360,2011-07-05,3,0,7,13,0,2,1,1,0.82,0.7424,0.43,0.1045,67,136,203,203,True
4361,2011-07-05,3,0,7,14,0,2,1,1,0.8,0.7424,0.49,0.1642,66,112,178,178,True
4362,2011-07-05,3,0,7,15,0,2,1,1,0.82,0.7424,0.43,0.0,51,111,162,162,True
4363,2011-07-05,3,0,7,16,0,2,1,1,0.82,0.7576,0.46,0.1045,79,202,281,281,True
4364,2011-07-05,3,0,7,17,0,2,1,1,0.82,0.7576,0.46,0.1045,79,466,545,545,True
4365,2011-07-05,3,0,7,18,0,2,1,1,0.8,0.7576,0.55,0.1642,70,426,496,496,True
4366,2011-07-05,3,0,7,19,0,2,1,1,0.8,0.7727,0.59,0.1343,71,297,368,368,True
4367,2011-07-05,3,0,7,20,0,2,1,1,0.76,0.7273,0.66,0.1045,59,225,284,284,True
4368,2011-07-05,3,0,7,21,0,2,1,1,0.78,0.7424,0.62,0.2537,77,168,245,245,True
4369,2011-07-05,3,0,7,22,0,2,1,1,0.76,0.7273,0.66,0.2239,31,124,155,155,True
4370,2011-07-05,3,0,7,23,0,2,1,1,0.74,0.697,0.66,0.1642,19,54,73,73,True
4371,2011-07-06,3,0,7,0,0,3,1,1,0.72,0.697,0.74,0.194,11,26,37,37,True
4372,2011-07-06,3,0,7,1,0,3,1,1,0.7,0.6667,0.74,0.1343,4,11,15,15,True
4373,2011-07-06,3,0,7,2,0,3,1,1,0.7,0.6667,0.79,0.0896,1,4,5,5,True
4374,2011-07-06,3,0,7,3,0,3,1,1,0.7,0.6667,0.79,0.0,0,6,6,6,True
4375,2011-07-06,3,0,7,4,0,3,1,2,0.68,0.6364,0.83,0.0896,0,6,6,6,True
4376,2011-07-06,3,0,7,5,0,3,1,1,0.68,0.6364,0.83,0.0896,5,30,35,35,True
4377,2011-07-06,3,0,7,6,0,3,1,1,0.7,0.6667,0.79,0.0896,9,112,121,121,True
4378,2011-07-06,3,0,7,7,0,3,1,2,0.72,0.697,0.79,0.0,24,288,312,312,True
4379,2011-07-06,3,0,7,8,0,3,1,2,0.72,0.697,0.74,0.1045,31,397,428,428,True
4380,2011-07-06,3,0,7,9,0,3,1,3,0.7,0.6667,0.79,0.194,31,158,189,189,True
4381,2011-07-06,3,0,7,10,0,3,1,3,0.7,0.6667,0.79,0.0896,13,30,43,43,True
4382,2011-07-06,3,0,7,11,0,3,1,2,0.72,0.697,0.74,0.0,24,103,127,127,True
4383,2011-07-06,3,0,7,12,0,3,1,2,0.74,0.697,0.66,0.0896,38,114,152,152,True
4384,2011-07-06,3,0,7,13,0,3,1,2,0.74,0.697,0.7,0.1045,33,107,140,140,True
4385,2011-07-06,3,0,7,14,0,3,1,1,0.76,0.7273,0.66,0.2836,50,113,163,163,True
4386,2011-07-06,3,0,7,15,0,3,1,1,0.76,0.7273,0.7,0.2836,55,130,185,185,True
4387,2011-07-06,3,0,7,16,0,3,1,1,0.76,0.7273,0.7,0.2537,57,218,275,275,True
4388,2011-07-06,3,0,7,17,0,3,1,1,0.78,0.7424,0.59,0.2239,79,499,578,578,True
4389,2011-07-06,3,0,7,18,0,3,1,1,0.76,0.7121,0.62,0.194,77,486,563,563,True
4390,2011-07-06,3,0,7,19,0,3,1,1,0.74,0.697,0.7,0.2239,71,323,394,394,True
4391,2011-07-06,3,0,7,20,0,3,1,1,0.72,0.697,0.74,0.2537,55,257,312,312,True
4392,2011-07-06,3,0,7,21,0,3,1,1,0.7,0.6667,0.79,0.194,66,175,241,241,True
4393,2011-07-06,3,0,7,22,0,3,1,1,0.7,0.6667,0.79,0.194,30,156,186,186,True
4394,2011-07-06,3,0,7,23,0,3,1,1,0.68,0.6364,0.83,0.2239,20,78,98,98,True
4395,2011-07-07,3,0,7,0,0,4,1,1,0.66,0.5909,0.89,0.1343,6,29,35,35,True
4396,2011-07-07,3,0,7,1,0,4,1,1,0.66,0.5909,0.89,0.194,2,14,16,16,True
4397,2011-07-07,3,0,7,2,0,4,1,1,0.66,0.5909,0.89,0.194,1,7,8,8,True
4398,2011-07-07,3,0,7,3,0,4,1,1,0.64,0.5606,0.94,0.1045,2,2,4,4,True
4399,2011-07-07,3,0,7,4,0,4,1,1,0.64,0.5758,0.89,0.1045,0,4,4,4,True
4400,2011-07-07,3,0,7,5,0,4,1,1,0.64,0.5758,0.89,0.1045,2,30,32,32,True
4401,2011-07-07,3,0,7,6,0,4,1,2,0.64,0.5758,0.89,0.1343,11,107,118,118,True
4402,2011-07-07,3,0,7,7,0,4,1,2,0.66,0.5909,0.89,0.1045,13,279,292,292,True
4403,2011-07-07,3,0,7,8,0,4,1,2,0.7,0.6667,0.79,0.194,28,415,443,443,True
4404,2011-07-07,3,0,7,9,0,4,1,1,0.74,0.697,0.7,0.1642,25,154,179,179,True
4405,2011-07-07,3,0,7,10,0,4,1,1,0.78,0.7424,0.62,0.0,29,72,101,101,True
4406,2011-07-07,3,0,7,11,0,4,1,1,0.82,0.7727,0.52,0.1343,30,112,142,142,True
4407,2011-07-07,3,0,7,12,0,4,1,1,0.84,0.7727,0.41,0.0,32,139,171,171,True
4408,2011-07-07,3,0,7,13,0,4,1,1,0.86,0.7879,0.41,0.0,48,107,155,155,True
4409,2011-07-07,3,0,7,14,0,4,1,1,0.86,0.7879,0.41,0.2537,39,121,160,160,True
4410,2011-07-07,3,0,7,15,0,4,1,1,0.86,0.7879,0.41,0.2537,47,119,166,166,True
4411,2011-07-07,3,0,7,16,0,4,1,1,0.86,0.7727,0.39,0.2239,47,218,265,265,True
4412,2011-07-07,3,0,7,17,0,4,1,1,0.86,0.7576,0.36,0.2537,80,489,569,569,True
4413,2011-07-07,3,0,7,18,0,4,1,1,0.84,0.7576,0.44,0.2985,70,492,562,562,True
4414,2011-07-07,3,0,7,19,0,4,1,1,0.82,0.7727,0.52,0.2836,79,286,365,365,True
4415,2011-07-07,3,0,7,20,0,4,1,1,0.76,0.7121,0.58,0.3582,61,224,285,285,True
4416,2011-07-07,3,0,7,21,0,4,1,1,0.74,0.6818,0.62,0.1642,39,170,209,209,True
4417,2011-07-07,3,0,7,22,0,4,1,1,0.74,0.6818,0.62,0.1642,32,150,182,182,True
4418,2011-07-07,3,0,7,23,0,4,1,1,0.72,0.6818,0.66,0.0,31,98,129,129,True
4419,2011-07-08,3,0,7,0,0,5,1,1,0.74,0.697,0.66,0.1045,6,41,47,47,True
4420,2011-07-08,3,0,7,1,0,5,1,1,0.72,0.697,0.79,0.0,9,25,34,34,True
4421,2011-07-08,3,0,7,2,0,5,1,2,0.7,0.6667,0.74,0.1642,10,12,22,22,True
4422,2011-07-08,3,0,7,3,0,5,1,1,0.68,0.6364,0.79,0.1045,2,4,6,6,True
4423,2011-07-08,3,0,7,4,0,5,1,1,0.7,0.6667,0.79,0.2537,7,4,11,11,True
4424,2011-07-08,3,0,7,5,0,5,1,1,0.68,0.6364,0.79,0.2537,3,24,27,27,True
4425,2011-07-08,3,0,7,6,0,5,1,1,0.7,0.6667,0.74,0.1045,11,91,102,102,True
4426,2011-07-08,3,0,7,7,0,5,1,2,0.7,0.6667,0.79,0.194,30,302,332,332,True
4427,2011-07-08,3,0,7,8,0,5,1,2,0.72,0.697,0.74,0.2537,36,421,457,457,True
4428,2011-07-08,3,0,7,9,0,5,1,2,0.76,0.7273,0.7,0.2985,30,211,241,241,True
4429,2011-07-08,3,0,7,10,0,5,1,2,0.74,0.697,0.7,0.3582,30,108,138,138,True
4430,2011-07-08,3,0,7,11,0,5,1,2,0.74,0.7121,0.74,0.2537,61,104,165,165,True
4431,2011-07-08,3,0,7,12,0,5,1,2,0.76,0.7273,0.7,0.2836,49,164,213,213,True
4432,2011-07-08,3,0,7,13,0,5,1,2,0.78,0.7576,0.66,0.2836,54,175,229,229,True
4433,2011-07-08,3,0,7,14,0,5,1,2,0.8,0.7879,0.63,0.3582,53,163,216,216,True
4434,2011-07-08,3,0,7,15,0,5,1,2,0.8,0.7879,0.63,0.3582,39,102,141,141,True
4435,2011-07-08,3,0,7,16,0,5,1,3,0.68,0.6364,0.83,0.4478,27,105,132,132,True
4436,2011-07-08,3,0,7,17,0,5,1,3,0.66,0.5909,0.89,0.4478,6,161,167,167,True
4437,2011-07-08,3,0,7,18,0,5,1,1,0.66,0.6061,0.83,0.0896,35,281,316,316,True
4438,2011-07-08,3,0,7,19,0,5,1,1,0.66,0.6061,0.83,0.0896,45,225,270,270,True
4439,2011-07-08,3,0,7,20,0,5,1,1,0.66,0.6061,0.83,0.1642,30,220,250,250,True
4440,2011-07-08,3,0,7,21,0,5,1,2,0.66,0.6061,0.83,0.2537,46,158,204,204,True
4441,2011-07-08,3,0,7,22,0,5,1,2,0.66,0.6061,0.78,0.194,33,136,169,169,True
4442,2011-07-08,3,0,7,23,0,5,1,2,0.66,0.6061,0.78,0.0896,40,111,151,151,True
4443,2011-07-09,3,0,7,0,0,6,0,2,0.66,0.6061,0.83,0.1343,31,90,121,121,True
4444,2011-07-09,3,0,7,1,0,6,0,2,0.64,0.5758,0.89,0.1045,5,48,53,53,True
4445,2011-07-09,3,0,7,2,0,6,0,1,0.64,0.5758,0.89,0.1642,12,43,55,55,True
4446,2011-07-09,3,0,7,3,0,6,0,1,0.64,0.5758,0.89,0.1343,7,23,30,30,True
4447,2011-07-09,3,0,7,4,0,6,0,1,0.64,0.5758,0.83,0.2239,2,4,6,6,True
4448,2011-07-09,3,0,7,5,0,6,0,2,0.62,0.5606,0.88,0.1642,4,11,15,15,True
4449,2011-07-09,3,0,7,6,0,6,0,2,0.64,0.5758,0.83,0.194,11,27,38,38,True
4450,2011-07-09,3,0,7,7,0,6,0,1,0.66,0.6061,0.78,0.194,21,50,71,71,True
4451,2011-07-09,3,0,7,8,0,6,0,1,0.7,0.6515,0.7,0.2537,68,114,182,182,True
4452,2011-07-09,3,0,7,9,0,6,0,1,0.74,0.6818,0.58,0.2836,77,170,247,247,True
4453,2011-07-09,3,0,7,10,0,6,0,1,0.76,0.697,0.52,0.1642,87,177,264,264,True
4454,2011-07-09,3,0,7,11,0,6,0,1,0.78,0.697,0.46,0.2985,101,189,290,290,True
4455,2011-07-09,3,0,7,12,0,6,0,1,0.8,0.7273,0.46,0.2537,114,221,335,335,True
4456,2011-07-09,3,0,7,13,0,6,0,1,0.82,0.7424,0.41,0.2239,114,249,363,363,True
4457,2011-07-09,3,0,7,14,0,6,0,1,0.84,0.7424,0.36,0.1343,114,215,329,329,True
4458,2011-07-09,3,0,7,15,0,6,0,1,0.84,0.7273,0.34,0.0896,114,220,334,334,True
4459,2011-07-09,3,0,7,16,0,6,0,1,0.82,0.7273,0.38,0.0,114,245,359,359,True
4460,2011-07-09,3,0,7,17,0,6,0,1,0.84,0.7273,0.32,0.0,114,241,355,355,True
4461,2011-07-09,3,0,7,18,0,6,0,1,0.82,0.7273,0.36,0.1045,114,246,360,360,True
4462,2011-07-09,3,0,7,19,0,6,0,1,0.76,0.697,0.55,0.1642,114,178,292,292,True
4463,2011-07-09,3,0,7,20,0,6,0,1,0.76,0.7121,0.58,0.2239,114,185,299,299,True
4464,2011-07-09,3,0,7,21,0,6,0,1,0.74,0.6818,0.58,0.1642,83,155,238,238,True
4465,2011-07-09,3,0,7,22,0,6,0,1,0.72,0.6818,0.62,0.1642,60,154,214,214,True
4466,2011-07-09,3,0,7,23,0,6,0,1,0.72,0.6667,0.58,0.194,47,93,140,140,True
4467,2011-07-10,3,0,7,0,0,0,0,1,0.7,0.6515,0.61,0.1642,42,112,154,154,True
4468,2011-07-10,3,0,7,1,0,0,0,1,0.7,0.6515,0.61,0.1343,19,94,113,113,True
4469,2011-07-10,3,0,7,2,0,0,0,1,0.68,0.6364,0.69,0.0896,28,68,96,96,True
4470,2011-07-10,3,0,7,3,0,0,0,1,0.66,0.6212,0.74,0.0896,6,19,25,25,True
4471,2011-07-10,3,0,7,4,0,0,0,1,0.66,0.6212,0.69,0.0896,0,5,5,5,True
4472,2011-07-10,3,0,7,5,0,0,0,1,0.66,0.6212,0.74,0.0,7,10,17,17,True
4473,2011-07-10,3,0,7,6,0,0,0,1,0.64,0.5909,0.78,0.0896,8,17,25,25,True
4474,2011-07-10,3,0,7,7,0,0,0,1,0.7,0.6515,0.7,0.0896,27,38,65,65,True
4475,2011-07-10,3,0,7,8,0,0,0,1,0.72,0.6818,0.66,0.0,27,65,92,92,True
4476,2011-07-10,3,0,7,9,0,0,0,1,0.74,0.697,0.66,0.0896,62,107,169,169,True
4477,2011-07-10,3,0,7,10,0,0,0,1,0.76,0.697,0.55,0.1343,95,173,268,268,True
4478,2011-07-10,3,0,7,11,0,0,0,1,0.78,0.7273,0.55,0.194,110,177,287,287,True
4479,2011-07-10,3,0,7,12,0,0,0,1,0.82,0.7576,0.46,0.2836,114,244,358,358,True
4480,2011-07-10,3,0,7,13,0,0,0,1,0.8,0.7273,0.46,0.2985,114,228,342,342,True
4481,2011-07-10,3,0,7,14,0,0,0,1,0.82,0.7424,0.41,0.3284,114,227,341,341,True
4482,2011-07-10,3,0,7,15,0,0,0,1,0.84,0.7424,0.39,0.2836,114,219,333,333,True
4483,2011-07-10,3,0,7,16,0,0,0,1,0.84,0.7576,0.41,0.2836,114,244,358,358,True
4484,2011-07-10,3,0,7,17,0,0,0,1,0.84,0.7424,0.36,0.2239,114,217,331,331,True
4485,2011-07-10,3,0,7,18,0,0,0,1,0.82,0.7424,0.43,0.2836,114,222,336,336,True
4486,2011-07-10,3,0,7,19,0,0,0,1,0.8,0.7424,0.49,0.3284,114,183,297,297,True
4487,2011-07-10,3,0,7,20,0,0,0,1,0.76,0.697,0.55,0.194,101,167,268,268,True
4488,2011-07-10,3,0,7,21,0,0,0,1,0.74,0.6818,0.62,0.2537,65,162,227,227,True
4489,2011-07-10,3,0,7,22,0,0,0,1,0.74,0.697,0.66,0.2239,56,87,143,143,True
4490,2011-07-10,3,0,7,23,0,0,0,1,0.72,0.6818,0.66,0.2537,19,53,72,72,True
4491,2011-07-11,3,0,7,0,0,1,1,1,0.7,0.6515,0.65,0.194,10,25,35,35,True
4492,2011-07-11,3,0,7,1,0,1,1,1,0.7,0.6515,0.61,0.2836,5,5,10,10,True
4493,2011-07-11,3,0,7,2,0,1,1,1,0.7,0.6515,0.61,0.2239,8,4,12,12,True
4494,2011-07-11,3,0,7,3,0,1,1,1,0.68,0.6364,0.65,0.1642,2,8,10,10,True
4495,2011-07-11,3,0,7,4,0,1,1,1,0.66,0.6212,0.74,0.2239,0,4,4,4,True
4496,2011-07-11,3,0,7,5,0,1,1,1,0.66,0.6212,0.74,0.1343,5,21,26,26,True
4497,2011-07-11,3,0,7,6,0,1,1,1,0.68,0.6364,0.74,0.194,19,102,121,121,True
4498,2011-07-11,3,0,7,7,0,1,1,1,0.7,0.6667,0.74,0.2537,28,289,317,317,True
4499,2011-07-11,3,0,7,8,0,1,1,1,0.74,0.697,0.66,0.2836,35,385,420,420,True
4500,2011-07-11,3,0,7,9,0,1,1,1,0.78,0.7424,0.59,0.2985,41,167,208,208,True
4501,2011-07-11,3,0,7,10,0,1,1,1,0.8,0.7576,0.55,0.3582,44,73,117,117,True
4502,2011-07-11,3,0,7,11,0,1,1,1,0.82,0.7879,0.56,0.2985,39,89,128,128,True
4503,2011-07-11,3,0,7,12,0,1,1,1,0.84,0.803,0.53,0.2836,40,108,148,148,True
4504,2011-07-11,3,0,7,13,0,1,1,1,0.86,0.8182,0.5,0.2537,22,119,141,141,True
4505,2011-07-11,3,0,7,14,0,1,1,1,0.86,0.8333,0.53,0.2836,40,94,134,134,True
4506,2011-07-11,3,0,7,15,0,1,1,1,0.86,0.8485,0.56,0.4179,38,108,146,146,True
4507,2011-07-11,3,0,7,16,0,1,1,1,0.86,0.8485,0.56,0.3881,57,182,239,239,True
4508,2011-07-11,3,0,7,17,0,1,1,1,0.86,0.8485,0.56,0.4179,59,455,514,514,True
4509,2011-07-11,3,0,7,18,0,1,1,1,0.86,0.8333,0.53,0.3881,57,415,472,472,True
4510,2011-07-11,3,0,7,19,0,1,1,1,0.84,0.8333,0.59,0.3284,80,293,373,373,True
4511,2011-07-11,3,0,7,20,0,1,1,1,0.72,0.697,0.74,0.4179,42,194,236,236,True
4512,2011-07-11,3,0,7,21,0,1,1,1,0.7,0.6667,0.79,0.4179,21,109,130,130,True
4513,2011-07-11,3,0,7,22,0,1,1,1,0.72,0.697,0.74,0.1343,20,70,90,90,True
4514,2011-07-11,3,0,7,23,0,1,1,1,0.7,0.6667,0.79,0.1343,11,44,55,55,True
4515,2011-07-12,3,0,7,0,0,2,1,1,0.7,0.6667,0.79,0.1343,3,19,22,22,True
4516,2011-07-12,3,0,7,1,0,2,1,1,0.7,0.6667,0.79,0.0896,6,8,14,14,True
4517,2011-07-12,3,0,7,2,0,2,1,1,0.7,0.6667,0.79,0.1045,2,7,9,9,True
4518,2011-07-12,3,0,7,3,0,2,1,2,0.7,0.6667,0.79,0.0,2,6,8,8,True
4519,2011-07-12,3,0,7,4,0,2,1,1,0.7,0.6667,0.79,0.1642,0,6,6,6,True
4520,2011-07-12,3,0,7,5,0,2,1,1,0.7,0.6667,0.79,0.0896,4,21,25,25,True
4521,2011-07-12,3,0,7,6,0,2,1,1,0.74,0.6818,0.58,0.2239,13,102,115,115,True
4522,2011-07-12,3,0,7,7,0,2,1,1,0.76,0.697,0.55,0.194,29,301,330,330,True
4523,2011-07-12,3,0,7,8,0,2,1,1,0.76,0.7121,0.58,0.2239,35,382,417,417,True
4524,2011-07-12,3,0,7,9,0,2,1,1,0.78,0.7273,0.55,0.4775,27,149,176,176,True
4525,2011-07-12,3,0,7,10,0,2,1,1,0.82,0.7727,0.52,0.1642,38,85,123,123,True
4526,2011-07-12,3,0,7,11,0,2,1,1,0.82,0.7727,0.52,0.1642,39,86,125,125,True
4527,2011-07-12,3,0,7,12,0,2,1,1,0.86,0.7879,0.44,0.2985,38,125,163,163,True
4528,2011-07-12,3,0,7,13,0,2,1,1,0.86,0.803,0.47,0.2239,32,104,136,136,True
4529,2011-07-12,3,0,7,14,0,2,1,1,0.9,0.8485,0.42,0.2985,33,91,124,124,True
4530,2011-07-12,3,0,7,15,0,2,1,1,0.9,0.8485,0.42,0.3582,37,111,148,148,True
4531,2011-07-12,3,0,7,16,0,2,1,1,0.86,0.7879,0.44,0.2836,25,177,202,202,True
4532,2011-07-12,3,0,7,17,0,2,1,1,0.88,0.8182,0.44,0.2836,48,380,428,428,True
4533,2011-07-12,3,0,7,18,0,2,1,1,0.86,0.803,0.47,0.2985,39,472,511,511,True
4534,2011-07-12,3,0,7,19,0,2,1,1,0.84,0.7576,0.44,0.2836,42,295,337,337,True
4535,2011-07-12,3,0,7,20,0,2,1,1,0.82,0.7424,0.43,0.194,57,251,308,308,True
4536,2011-07-12,3,0,7,21,0,2,1,1,0.82,0.7424,0.43,0.1045,49,209,258,258,True
4537,2011-07-12,3,0,7,22,0,2,1,1,0.8,0.7273,0.46,0.1343,44,150,194,194,True
4538,2011-07-12,3,0,7,23,0,2,1,1,0.78,0.7121,0.52,0.0,20,59,79,79,True
4539,2011-07-13,3,0,7,0,0,3,1,1,0.76,0.7121,0.62,0.0,9,37,46,46,True
4540,2011-07-13,3,0,7,1,0,3,1,1,0.76,0.697,0.55,0.0,1,11,12,12,True
4541,2011-07-13,3,0,7,2,0,3,1,1,0.76,0.697,0.55,0.0,2,3,5,5,True
4542,2011-07-13,3,0,7,3,0,3,1,1,0.74,0.6818,0.58,0.194,0,4,4,4,True
4543,2011-07-13,3,0,7,4,0,3,1,1,0.74,0.6818,0.58,0.2537,0,5,5,5,True
4544,2011-07-13,3,0,7,5,0,3,1,1,0.74,0.6818,0.58,0.194,4,22,26,26,True
4545,2011-07-13,3,0,7,6,0,3,1,1,0.74,0.6818,0.58,0.1642,18,103,121,121,True
4546,2011-07-13,3,0,7,7,0,3,1,1,0.76,0.697,0.55,0.2537,32,281,313,313,True
4547,2011-07-13,3,0,7,8,0,3,1,1,0.8,0.7424,0.49,0.2537,31,418,449,449,True
4548,2011-07-13,3,0,7,9,0,3,1,1,0.82,0.7424,0.41,0.194,23,163,186,186,True
4549,2011-07-13,3,0,7,10,0,3,1,1,0.82,0.7576,0.46,0.194,33,80,113,113,True
4550,2011-07-13,3,0,7,11,0,3,1,1,0.84,0.7424,0.39,0.1642,55,110,165,165,True
4551,2011-07-13,3,0,7,12,0,3,1,1,0.84,0.7576,0.41,0.2836,40,134,174,174,True
4552,2011-07-13,3,0,7,13,0,3,1,3,0.82,0.7576,0.46,0.1343,39,119,158,158,True
4553,2011-07-13,3,0,7,14,0,3,1,3,0.82,0.7576,0.46,0.1343,27,89,116,116,True
4554,2011-07-13,3,0,7,15,0,3,1,3,0.64,0.5606,0.94,0.1343,13,33,46,46,True
4555,2011-07-13,3,0,7,16,0,3,1,2,0.66,0.5909,0.89,0.0,23,118,141,141,True
4556,2011-07-13,3,0,7,17,0,3,1,1,0.7,0.6667,0.79,0.0,70,418,488,488,True
4557,2011-07-13,3,0,7,18,0,3,1,1,0.72,0.697,0.79,0.1343,51,412,463,463,True
4558,2011-07-13,3,0,7,19,0,3,1,1,0.7,0.6667,0.79,0.1045,79,340,419,419,True
4559,2011-07-13,3,0,7,20,0,3,1,1,0.7,0.6667,0.84,0.1642,61,281,342,342,True
4560,2011-07-13,3,0,7,21,0,3,1,1,0.7,0.6667,0.79,0.1045,56,194,250,250,True
4561,2011-07-13,3,0,7,22,0,3,1,1,0.68,0.6364,0.83,0.194,48,136,184,184,True
4562,2011-07-13,3,0,7,23,0,3,1,1,0.66,0.6061,0.83,0.2537,33,83,116,116,True
4563,2011-07-14,3,0,7,0,0,4,1,1,0.66,0.6212,0.69,0.2985,14,32,46,46,True
4564,2011-07-14,3,0,7,1,0,4,1,1,0.66,0.6212,0.61,0.2537,4,21,25,25,True
4565,2011-07-14,3,0,7,2,0,4,1,1,0.64,0.6212,0.57,0.2985,3,7,10,10,True
4566,2011-07-14,3,0,7,3,0,4,1,1,0.62,0.6212,0.57,0.2985,1,5,6,6,True
4567,2011-07-14,3,0,7,4,0,4,1,1,0.62,0.6212,0.53,0.2537,0,6,6,6,True
4568,2011-07-14,3,0,7,5,0,4,1,1,0.6,0.6212,0.56,0.2239,6,22,28,28,True
4569,2011-07-14,3,0,7,6,0,4,1,1,0.6,0.6061,0.6,0.2239,14,116,130,130,True
4570,2011-07-14,3,0,7,7,0,4,1,1,0.62,0.6212,0.53,0.2537,23,311,334,334,True
4571,2011-07-14,3,0,7,8,0,4,1,1,0.64,0.6212,0.5,0.3582,53,433,486,486,True
4572,2011-07-14,3,0,7,9,0,4,1,1,0.68,0.6364,0.47,0.2836,29,195,224,224,True
4573,2011-07-14,3,0,7,10,0,4,1,1,0.7,0.6364,0.42,0.2537,32,95,127,127,True
4574,2011-07-14,3,0,7,11,0,4,1,1,0.72,0.6515,0.37,0.2239,38,110,148,148,True
4575,2011-07-14,3,0,7,12,0,4,1,1,0.74,0.6515,0.35,0.2537,51,172,223,223,True
4576,2011-07-14,3,0,7,13,0,4,1,1,0.76,0.6667,0.33,0.3284,39,138,177,177,True
4577,2011-07-14,3,0,7,14,0,4,1,1,0.74,0.6515,0.35,0.2836,49,129,178,178,True
4578,2011-07-14,3,0,7,15,0,4,1,1,0.76,0.6667,0.33,0.2985,42,138,180,180,True
4579,2011-07-14,3,0,7,16,0,4,1,1,0.76,0.6667,0.33,0.1343,43,231,274,274,True
4580,2011-07-14,3,0,7,17,0,4,1,1,0.74,0.6515,0.37,0.1343,78,499,577,577,True
4581,2011-07-14,3,0,7,18,0,4,1,1,0.72,0.6515,0.42,0.194,94,484,578,578,True
4582,2011-07-14,3,0,7,19,0,4,1,1,0.72,0.6515,0.39,0.2239,67,333,400,400,True
4583,2011-07-14,3,0,7,20,0,4,1,1,0.7,0.6364,0.42,0.2239,81,267,348,348,True
4584,2011-07-14,3,0,7,21,0,4,1,1,0.66,0.6212,0.5,0.1343,58,203,261,261,True
4585,2011-07-14,3,0,7,22,0,4,1,1,0.64,0.6212,0.57,0.0896,42,134,176,176,True
4586,2011-07-14,3,0,7,23,0,4,1,1,0.64,0.6061,0.65,0.2537,27,97,124,124,True
4587,2011-07-15,3,0,7,0,0,5,1,1,0.62,0.5909,0.73,0.2239,23,57,80,80,True
4588,2011-07-15,3,0,7,1,0,5,1,1,0.62,0.5909,0.73,0.194,7,13,20,20,True
4589,2011-07-15,3,0,7,2,0,5,1,1,0.6,0.5758,0.78,0.1642,16,22,38,38,True
4590,2011-07-15,3,0,7,3,0,5,1,1,0.6,0.5909,0.73,0.194,1,6,7,7,True
4591,2011-07-15,3,0,7,4,0,5,1,1,0.6,0.5909,0.73,0.1642,2,8,10,10,True
4592,2011-07-15,3,0,7,5,0,5,1,1,0.6,0.5909,0.73,0.1343,7,16,23,23,True
4593,2011-07-15,3,0,7,6,0,5,1,2,0.6,0.5909,0.73,0.1045,12,108,120,120,True
4594,2011-07-15,3,0,7,7,0,5,1,1,0.64,0.6061,0.65,0.1045,17,257,274,274,True
4595,2011-07-15,3,0,7,8,0,5,1,1,0.64,0.6061,0.65,0.2537,50,499,549,549,True
4596,2011-07-15,3,0,7,9,0,5,1,1,0.68,0.6364,0.54,0.194,31,176,207,207,True
4597,2011-07-15,3,0,7,10,0,5,1,2,0.66,0.6212,0.61,0.1642,59,107,166,166,True
4598,2011-07-15,3,0,7,11,0,5,1,1,0.7,0.6515,0.54,0.1343,73,137,210,210,True
4599,2011-07-15,3,0,7,12,0,5,1,1,0.7,0.6515,0.48,0.194,61,177,238,238,True
4600,2011-07-15,3,0,7,13,0,5,1,1,0.7,0.6515,0.54,0.194,85,162,247,247,True
4601,2011-07-15,3,0,7,14,0,5,1,1,0.7,0.6515,0.51,0.194,105,160,265,265,True
4602,2011-07-15,3,0,7,15,0,5,1,1,0.72,0.6515,0.45,0.1642,74,163,237,237,True
4603,2011-07-15,3,0,7,16,0,5,1,1,0.72,0.6667,0.51,0.194,96,265,361,361,True
4604,2011-07-15,3,0,7,17,0,5,1,1,0.74,0.6667,0.42,0.2537,104,483,587,587,True
4605,2011-07-15,3,0,7,18,0,5,1,1,0.72,0.6515,0.45,0.2239,102,394,496,496,True
4606,2011-07-15,3,0,7,19,0,5,1,1,0.7,0.6364,0.45,0.2239,114,280,394,394,True
4607,2011-07-15,3,0,7,20,0,5,1,1,0.7,0.6515,0.51,0.2239,92,251,343,343,True
4608,2011-07-15,3,0,7,21,0,5,1,1,0.66,0.6212,0.54,0.1045,75,186,261,261,True
4609,2011-07-15,3,0,7,22,0,5,1,1,0.66,0.6212,0.57,0.2239,71,152,223,223,True
4610,2011-07-15,3,0,7,23,0,5,1,1,0.64,0.6212,0.61,0.1642,41,126,167,167,True
4611,2011-07-16,3,0,7,0,0,6,0,1,0.62,0.6061,0.65,0.194,42,68,110,110,True
4612,2011-07-16,3,0,7,1,0,6,0,1,0.6,0.5909,0.69,0.1045,24,51,75,75,True
4613,2011-07-16,3,0,7,2,0,6,0,1,0.6,0.5909,0.73,0.1343,10,48,58,58,True
4614,2011-07-16,3,0,7,3,0,6,0,1,0.6,0.5758,0.78,0.1343,6,20,26,26,True
4615,2011-07-16,3,0,7,4,0,6,0,1,0.6,0.5909,0.73,0.0896,9,7,16,16,True
4616,2011-07-16,3,0,7,5,0,6,0,1,0.58,0.5455,0.78,0.0896,4,6,10,10,True
4617,2011-07-16,3,0,7,6,0,6,0,1,0.6,0.5758,0.78,0.1642,16,21,37,37,True
4618,2011-07-16,3,0,7,7,0,6,0,1,0.62,0.5909,0.73,0.1343,14,38,52,52,True
4619,2011-07-16,3,0,7,8,0,6,0,1,0.66,0.6212,0.65,0.1642,37,90,127,127,True
4620,2011-07-16,3,0,7,9,0,6,0,1,0.7,0.6515,0.54,0.2239,72,150,222,222,True
4621,2011-07-16,3,0,7,10,0,6,0,1,0.72,0.6667,0.54,0.194,114,208,322,322,True
4622,2011-07-16,3,0,7,11,0,6,0,1,0.74,0.6667,0.48,0.2239,114,225,339,339,True
4623,2011-07-16,3,0,7,12,0,6,0,1,0.76,0.6818,0.43,0.2836,114,276,390,390,True
4624,2011-07-16,3,0,7,13,0,6,0,1,0.76,0.6818,0.45,0.2985,114,276,390,390,True
4625,2011-07-16,3,0,7,14,0,6,0,1,0.74,0.6667,0.45,0.2985,114,232,346,346,True
4626,2011-07-16,3,0,7,15,0,6,0,1,0.76,0.6818,0.45,0.3284,114,223,337,337,True
4627,2011-07-16,3,0,7,16,0,6,0,1,0.76,0.6818,0.45,0.2836,114,242,356,356,True
4628,2011-07-16,3,0,7,17,0,6,0,1,0.76,0.6818,0.45,0.2239,114,241,355,355,True
4629,2011-07-16,3,0,7,18,0,6,0,1,0.76,0.6818,0.45,0.2836,114,243,357,357,True
4630,2011-07-16,3,0,7,19,0,6,0,1,0.74,0.6818,0.48,0.194,114,242,356,356,True
4631,2011-07-16,3,0,7,20,0,6,0,1,0.72,0.6667,0.51,0.2239,108,188,296,296,True
4632,2011-07-16,3,0,7,21,0,6,0,1,0.7,0.6515,0.58,0.2239,85,167,252,252,True
4633,2011-07-16,3,0,7,22,0,6,0,1,0.7,0.6515,0.65,0.2836,65,136,201,201,True
4634,2011-07-16,3,0,7,23,0,6,0,1,0.68,0.6364,0.61,0.2239,61,107,168,168,True
4635,2011-07-17,3,0,7,0,0,0,0,1,0.66,0.6212,0.65,0.2239,34,91,125,125,True
4636,2011-07-17,3,0,7,1,0,0,0,1,0.64,0.6061,0.69,0.194,16,86,102,102,True
4637,2011-07-17,3,0,7,2,0,0,0,1,0.64,0.6061,0.69,0.2239,28,66,94,94,True
4638,2011-07-17,3,0,7,3,0,0,0,1,0.64,0.6061,0.69,0.2239,21,26,47,47,True
4639,2011-07-17,3,0,7,4,0,0,0,1,0.62,0.5909,0.73,0.1642,4,6,10,10,True
4640,2011-07-17,3,0,7,5,0,0,0,1,0.64,0.6061,0.69,0.2239,4,8,12,12,True
4641,2011-07-17,3,0,7,6,0,0,0,1,0.62,0.5909,0.73,0.1642,10,11,21,21,True
4642,2011-07-17,3,0,7,7,0,0,0,1,0.64,0.6061,0.73,0.1642,20,30,50,50,True
4643,2011-07-17,3,0,7,8,0,0,0,1,0.68,0.6364,0.65,0.2239,45,73,118,118,True
4644,2011-07-17,3,0,7,9,0,0,0,1,0.72,0.6667,0.58,0.2239,74,110,184,184,True
4645,2011-07-17,3,0,7,10,0,0,0,1,0.74,0.6818,0.6,0.2239,114,177,291,291,True
4646,2011-07-17,3,0,7,11,0,0,0,1,0.76,0.697,0.55,0.2836,114,244,358,358,True
4647,2011-07-17,3,0,7,12,0,0,0,1,0.76,0.697,0.55,0.2836,114,243,357,357,True
4648,2011-07-17,3,0,7,13,0,0,0,1,0.8,0.7424,0.49,0.2985,114,272,386,386,True
4649,2011-07-17,3,0,7,14,0,0,0,1,0.8,0.7424,0.49,0.3582,114,262,376,376,True
4650,2011-07-17,3,0,7,15,0,0,0,1,0.82,0.7424,0.43,0.2985,114,195,309,309,True
4651,2011-07-17,3,0,7,16,0,0,0,1,0.8,0.7273,0.46,0.2985,114,188,302,302,True
4652,2011-07-17,3,0,7,17,0,0,0,1,0.8,0.7424,0.49,0.3881,114,236,350,350,True
4653,2011-07-17,3,0,7,18,0,0,0,1,0.8,0.7273,0.46,0.2985,114,243,357,357,True
4654,2011-07-17,3,0,7,19,0,0,0,1,0.76,0.697,0.55,0.2836,114,234,348,348,True
4655,2011-07-17,3,0,7,20,0,0,0,1,0.76,0.7121,0.58,0.2537,85,177,262,262,True
4656,2011-07-17,3,0,7,21,0,0,0,1,0.74,0.6818,0.62,0.2239,59,148,207,207,True
4657,2011-07-17,3,0,7,22,0,0,0,1,0.72,0.6818,0.66,0.2239,65,116,181,181,True
4658,2011-07-17,3,0,7,23,0,0,0,1,0.7,0.6667,0.74,0.1343,39,54,93,93,True
4659,2011-07-18,3,0,7,0,0,1,1,1,0.7,0.6667,0.74,0.1343,21,30,51,51,True
4660,2011-07-18,3,0,7,1,0,1,1,1,0.7,0.6667,0.74,0.2239,17,8,25,25,True
4661,2011-07-18,3,0,7,2,0,1,1,1,0.66,0.6061,0.83,0.2239,2,8,10,10,True
4662,2011-07-18,3,0,7,3,0,1,1,1,0.66,0.6061,0.78,0.194,3,4,7,7,True
4663,2011-07-18,3,0,7,4,0,1,1,1,0.64,0.5909,0.78,0.1642,1,3,4,4,True
4664,2011-07-18,3,0,7,5,0,1,1,1,0.64,0.5909,0.78,0.1045,2,15,17,17,True
4665,2011-07-18,3,0,7,6,0,1,1,1,0.64,0.5758,0.83,0.1045,10,95,105,105,True
4666,2011-07-18,3,0,7,7,0,1,1,1,0.68,0.6364,0.74,0.2239,22,255,277,277,True
4667,2011-07-18,3,0,7,8,0,1,1,1,0.7,0.6515,0.7,0.194,18,329,347,347,True
4668,2011-07-18,3,0,7,9,0,1,1,1,0.74,0.697,0.67,0.2239,33,170,203,203,True
4669,2011-07-18,3,0,7,10,0,1,1,1,0.76,0.7121,0.62,0.194,52,78,130,130,True
4670,2011-07-18,3,0,7,11,0,1,1,1,0.8,0.7576,0.55,0.0896,42,99,141,141,True
4671,2011-07-18,3,0,7,12,0,1,1,1,0.8,0.7727,0.59,0.194,39,126,165,165,True
4672,2011-07-18,3,0,7,13,0,1,1,1,0.82,0.7879,0.56,0.2537,27,125,152,152,True
4673,2011-07-18,3,0,7,14,0,1,1,1,0.82,0.7879,0.56,0.3284,32,106,138,138,True
4674,2011-07-18,3,0,7,15,0,1,1,1,0.84,0.803,0.53,0.3284,53,111,164,164,True
4675,2011-07-18,3,0,7,16,0,1,1,1,0.84,0.803,0.53,0.2836,45,220,265,265,True
4676,2011-07-18,3,0,7,17,0,1,1,1,0.84,0.7879,0.49,0.3284,72,473,545,545,True
4677,2011-07-18,3,0,7,18,0,1,1,1,0.82,0.7727,0.49,0.3582,80,478,558,558,True
4678,2011-07-18,3,0,7,19,0,1,1,1,0.8,0.7576,0.55,0.2239,63,335,398,398,True
4679,2011-07-18,3,0,7,20,0,1,1,1,0.78,0.7424,0.59,0.2239,91,232,323,323,True
4680,2011-07-18,3,0,7,21,0,1,1,1,0.74,0.697,0.66,0.194,48,154,202,202,True
4681,2011-07-18,3,0,7,22,0,1,1,1,0.76,0.7273,0.66,0.2239,36,104,140,140,True
4682,2011-07-18,3,0,7,23,0,1,1,1,0.74,0.697,0.66,0.1642,32,59,91,91,True
4683,2011-07-19,3,0,7,0,0,2,1,1,0.74,0.697,0.66,0.1045,25,26,51,51,True
4684,2011-07-19,3,0,7,1,0,2,1,2,0.74,0.697,0.66,0.1343,7,6,13,13,True
4685,2011-07-19,3,0,7,2,0,2,1,1,0.72,0.6818,0.7,0.1642,9,4,13,13,True
4686,2011-07-19,3,0,7,3,0,2,1,1,0.72,0.6818,0.7,0.1642,2,1,3,3,True
4687,2011-07-19,3,0,7,4,0,2,1,1,0.72,0.6818,0.7,0.1343,1,4,5,5,True
4688,2011-07-19,3,0,7,5,0,2,1,2,0.7,0.6667,0.74,0.1045,0,19,19,19,True
4689,2011-07-19,3,0,7,6,0,2,1,2,0.72,0.697,0.74,0.1045,8,126,134,134,True
4690,2011-07-19,3,0,7,7,0,2,1,2,0.74,0.697,0.7,0.1642,28,287,315,315,True
4691,2011-07-19,3,0,7,8,0,2,1,2,0.76,0.7273,0.7,0.1642,31,381,412,412,True
4692,2011-07-19,3,0,7,9,0,2,1,2,0.8,0.7879,0.63,0.1343,22,177,199,199,True
4693,2011-07-19,3,0,7,10,0,2,1,2,0.82,0.7879,0.56,0.1642,29,112,141,141,True
4694,2011-07-19,3,0,7,11,0,2,1,1,0.82,0.803,0.59,0.0,29,98,127,127,True
4695,2011-07-19,3,0,7,12,0,2,1,1,0.84,0.8182,0.56,0.0896,26,127,153,153,True
4696,2011-07-19,3,0,7,13,0,2,1,1,0.86,0.8333,0.53,0.1045,33,139,172,172,True
4697,2011-07-19,3,0,7,14,0,2,1,1,0.86,0.8182,0.5,0.194,41,111,152,152,True
4698,2011-07-19,3,0,7,15,0,2,1,1,0.88,0.8182,0.44,0.194,48,110,158,158,True
4699,2011-07-19,3,0,7,16,0,2,1,1,0.9,0.8485,0.42,0.2985,61,216,277,277,True
4700,2011-07-19,3,0,7,17,0,2,1,1,0.8,0.803,0.66,0.0,68,445,513,513,True
4701,2011-07-19,3,0,7,18,0,2,1,1,0.8,0.803,0.66,0.1343,80,450,530,530,True
4702,2011-07-19,3,0,7,19,0,2,1,1,0.76,0.7424,0.75,0.194,54,334,388,388,True
4703,2011-07-19,3,0,7,20,0,2,1,1,0.74,0.7273,0.74,0.0896,48,229,277,277,True
4704,2011-07-19,3,0,7,21,0,2,1,1,0.74,0.7121,0.74,0.1343,47,194,241,241,True
4705,2011-07-19,3,0,7,22,0,2,1,1,0.74,0.7121,0.74,0.0,36,120,156,156,True
4706,2011-07-19,3,0,7,23,0,2,1,3,0.72,0.697,0.79,0.1642,19,73,92,92,True
4707,2011-07-20,3,0,7,0,0,3,1,1,0.7,0.6667,0.84,0.1045,11,29,40,40,True
4708,2011-07-20,3,0,7,1,0,3,1,1,0.7,0.6667,0.84,0.0,4,7,11,11,True
4709,2011-07-20,3,0,7,2,0,3,1,1,0.7,0.6667,0.84,0.0,2,7,9,9,True
4710,2011-07-20,3,0,7,3,0,3,1,1,0.7,0.6667,0.84,0.1045,2,4,6,6,True
4711,2011-07-20,3,0,7,4,0,3,1,1,0.68,0.6364,0.83,0.0,0,4,4,4,True
4712,2011-07-20,3,0,7,5,0,3,1,1,0.68,0.6364,0.83,0.1045,4,19,23,23,True
4713,2011-07-20,3,0,7,6,0,3,1,2,0.68,0.6364,0.89,0.1045,5,111,116,116,True
4714,2011-07-20,3,0,7,7,0,3,1,2,0.7,0.6667,0.84,0.1045,27,276,303,303,True
4715,2011-07-20,3,0,7,8,0,3,1,1,0.74,0.7121,0.74,0.0,34,404,438,438,True
4716,2011-07-20,3,0,7,9,0,3,1,1,0.74,0.697,0.7,0.0896,28,181,209,209,True
4717,2011-07-20,3,0,7,10,0,3,1,1,0.76,0.7273,0.7,0.0,34,76,110,110,True
4718,2011-07-20,3,0,7,11,0,3,1,1,0.8,0.7879,0.63,0.0896,26,116,142,142,True
4719,2011-07-20,3,0,7,12,0,3,1,1,0.82,0.803,0.59,0.0,28,121,149,149,True
4720,2011-07-20,3,0,7,13,0,3,1,1,0.84,0.8182,0.56,0.194,23,97,120,120,True
4721,2011-07-20,3,0,7,14,0,3,1,1,0.86,0.8333,0.53,0.2239,44,83,127,127,True
4722,2011-07-20,3,0,7,15,0,3,1,1,0.86,0.8182,0.5,0.1642,36,102,138,138,True
4723,2011-07-20,3,0,7,16,0,3,1,1,0.84,0.8182,0.56,0.0,30,204,234,234,True
4724,2011-07-20,3,0,7,17,0,3,1,1,0.84,0.8333,0.59,0.194,50,405,455,455,True
4725,2011-07-20,3,0,7,18,0,3,1,1,0.84,0.8333,0.59,0.2239,68,429,497,497,True
4726,2011-07-20,3,0,7,19,0,3,1,1,0.82,0.8485,0.67,0.1642,59,323,382,382,True
4727,2011-07-20,3,0,7,20,0,3,1,1,0.8,0.8333,0.75,0.2239,45,264,309,309,True
4728,2011-07-20,3,0,7,21,0,3,1,1,0.8,0.803,0.66,0.1642,33,209,242,242,True
4729,2011-07-20,3,0,7,22,0,3,1,1,0.78,0.7727,0.7,0.2239,25,144,169,169,True
4730,2011-07-20,3,0,7,23,0,3,1,1,0.76,0.7424,0.75,0.2537,26,73,99,99,True
4731,2011-07-21,3,0,7,0,0,4,1,2,0.76,0.7424,0.75,0.194,13,29,42,42,True
4732,2011-07-21,3,0,7,1,0,4,1,2,0.74,0.7273,0.84,0.2239,5,16,21,21,True
4733,2011-07-21,3,0,7,2,0,4,1,2,0.74,0.7273,0.84,0.2239,2,4,6,6,True
4734,2011-07-21,3,0,7,3,0,4,1,2,0.74,0.7121,0.79,0.1343,1,5,6,6,True
4735,2011-07-21,3,0,7,4,0,4,1,2,0.72,0.7121,0.84,0.1045,0,4,4,4,True
4736,2011-07-21,3,0,7,5,0,4,1,2,0.72,0.7121,0.84,0.1045,2,16,18,18,True
4737,2011-07-21,3,0,7,6,0,4,1,2,0.72,0.7121,0.84,0.1045,6,111,117,117,True
4738,2011-07-21,3,0,7,7,0,4,1,2,0.74,0.7273,0.84,0.1343,23,251,274,274,True
4739,2011-07-21,3,0,7,8,0,4,1,2,0.76,0.7576,0.79,0.1642,23,358,381,381,True
4740,2011-07-21,3,0,7,9,0,4,1,2,0.8,0.8182,0.75,0.2537,34,166,200,200,True
4741,2011-07-21,3,0,7,10,0,4,1,2,0.82,0.8636,0.71,0.2239,31,47,78,78,True
4742,2011-07-21,3,0,7,11,0,4,1,2,0.86,0.8939,0.63,0.2985,27,79,106,106,True
4743,2011-07-21,3,0,7,12,0,4,1,1,0.88,0.8939,0.56,0.3284,29,106,135,135,True
4744,2011-07-21,3,0,7,13,0,4,1,1,0.88,0.8939,0.56,0.2985,21,81,102,102,True
4745,2011-07-21,3,0,7,14,0,4,1,1,0.9,0.8939,0.5,0.3582,50,97,147,147,True
4746,2011-07-21,3,0,7,15,0,4,1,1,0.9,0.9242,0.53,0.2537,40,93,133,133,True
4747,2011-07-21,3,0,7,16,0,4,1,1,0.92,0.9242,0.48,0.2836,43,167,210,210,True
4748,2011-07-21,3,0,7,17,0,4,1,1,0.92,0.9091,0.45,0.2985,40,374,414,414,True
4749,2011-07-21,3,0,7,18,0,4,1,1,0.9,0.8939,0.5,0.2836,39,343,382,382,True
4750,2011-07-21,3,0,7,19,0,4,1,1,0.86,0.9242,0.67,0.2836,51,233,284,284,True
4751,2011-07-21,3,0,7,20,0,4,1,1,0.84,0.8939,0.71,0.2239,38,199,237,237,True
4752,2011-07-21,3,0,7,21,0,4,1,1,0.82,0.8939,0.75,0.2239,38,187,225,225,True
4753,2011-07-21,3,0,7,22,0,4,1,1,0.82,0.8636,0.71,0.1642,36,113,149,149,True
4754,2011-07-21,3,0,7,23,0,4,1,1,0.8,0.8182,0.71,0.1642,40,73,113,113,True
4755,2011-07-22,3,0,7,0,0,5,1,1,0.82,0.8333,0.63,0.1343,9,51,60,60,True
4756,2011-07-22,3,0,7,1,0,5,1,1,0.8,0.7879,0.63,0.0,7,17,24,24,True
4757,2011-07-22,3,0,7,2,0,5,1,1,0.78,0.803,0.79,0.1343,0,14,14,14,True
4758,2011-07-22,3,0,7,3,0,5,1,1,0.78,0.7879,0.75,0.1045,1,6,7,7,True
4759,2011-07-22,3,0,7,4,0,5,1,1,0.76,0.7424,0.75,0.1045,8,5,13,13,True
4760,2011-07-22,3,0,7,5,0,5,1,1,0.74,0.7121,0.79,0.1045,2,17,19,19,True
4761,2011-07-22,3,0,7,6,0,5,1,1,0.76,0.7424,0.75,0.0896,13,83,96,96,True
4762,2011-07-22,3,0,7,7,0,5,1,2,0.8,0.803,0.66,0.1045,20,232,252,252,True
4763,2011-07-22,3,0,7,8,0,5,1,2,0.84,0.8485,0.63,0.1642,30,292,322,322,True
4764,2011-07-22,3,0,7,9,0,5,1,1,0.86,0.8939,0.63,0.0896,31,177,208,208,True
4765,2011-07-22,3,0,7,10,0,5,1,1,0.9,0.9242,0.53,0.0896,32,83,115,115,True
4766,2011-07-22,3,0,7,11,0,5,1,1,0.9,0.8939,0.5,0.1045,23,86,109,109,True
4767,2011-07-22,3,0,7,12,0,5,1,1,0.94,0.9545,0.48,0.1642,20,95,115,115,True
4768,2011-07-22,3,0,7,13,0,5,1,1,0.94,0.9848,0.51,0.1642,25,98,123,123,True
4769,2011-07-22,3,0,7,14,0,5,1,1,0.96,1.0,0.48,0.2985,24,77,101,101,True
4770,2011-07-22,3,0,7,15,0,5,1,1,0.94,0.9848,0.51,0.2985,32,101,133,133,True
4771,2011-07-22,3,0,7,16,0,5,1,3,0.9,0.8333,0.39,0.2985,29,153,182,182,True
4772,2011-07-22,3,0,7,17,0,5,1,1,0.88,0.8485,0.47,0.1045,35,271,306,306,True
4773,2011-07-22,3,0,7,18,0,5,1,1,0.9,0.8182,0.37,0.1642,34,250,284,284,True
4774,2011-07-22,3,0,7,19,0,5,1,2,0.86,0.7879,0.41,0.1045,40,210,250,250,True
4775,2011-07-22,3,0,7,20,0,5,1,1,0.84,0.8182,0.56,0.0,46,166,212,212,True
4776,2011-07-22,3,0,7,21,0,5,1,1,0.82,0.803,0.59,0.0896,38,152,190,190,True
4777,2011-07-22,3,0,7,22,0,5,1,2,0.84,0.7879,0.49,0.0896,44,105,149,149,True
4778,2011-07-22,3,0,7,23,0,5,1,1,0.8,0.7879,0.63,0.194,19,84,103,103,True
4779,2011-07-23,3,0,7,0,0,6,0,1,0.82,0.7879,0.56,0.0,16,85,101,101,True
4780,2011-07-23,3,0,7,1,0,6,0,1,0.82,0.7727,0.52,0.1045,13,57,70,70,True
4781,2011-07-23,3,0,7,2,0,6,0,1,0.82,0.7727,0.52,0.0,13,48,61,61,True
4782,2011-07-23,3,0,7,3,0,6,0,1,0.78,0.7576,0.66,0.0896,6,16,22,22,True
4783,2011-07-23,3,0,7,4,0,6,0,1,0.76,0.7273,0.66,0.1045,5,4,9,9,True
4784,2011-07-23,3,0,7,5,0,6,0,1,0.76,0.7121,0.62,0.1343,1,6,7,7,True
4785,2011-07-23,3,0,7,6,0,6,0,1,0.8,0.7424,0.52,0.1343,6,19,25,25,True
4786,2011-07-23,3,0,7,7,0,6,0,1,0.8,0.7424,0.52,0.1045,7,38,45,45,True
4787,2011-07-23,3,0,7,8,0,6,0,1,0.84,0.7879,0.49,0.2537,24,85,109,109,True
4788,2011-07-23,3,0,7,9,0,6,0,1,0.84,0.7879,0.49,0.1642,30,102,132,132,True
4789,2011-07-23,3,0,7,10,0,6,0,1,0.86,0.7879,0.41,0.2239,61,137,198,198,True
4790,2011-07-23,3,0,7,11,0,6,0,1,0.9,0.8182,0.37,0.194,62,154,216,216,True
4791,2011-07-23,3,0,7,12,0,6,0,1,0.92,0.8636,0.37,0.1045,71,164,235,235,True
4792,2011-07-23,3,0,7,13,0,6,0,1,0.94,0.8788,0.38,0.1642,78,167,245,245,True
4793,2011-07-23,3,0,7,14,0,6,0,1,0.92,0.8939,0.42,0.0,84,152,236,236,True
4794,2011-07-23,3,0,7,15,0,6,0,1,0.94,0.8788,0.38,0.0,78,137,215,215,True
4795,2011-07-23,3,0,7,16,0,6,0,1,0.94,0.8788,0.38,0.1343,70,151,221,221,True
4796,2011-07-23,3,0,7,17,0,6,0,1,0.94,0.8788,0.38,0.1343,70,127,197,197,True
4797,2011-07-23,3,0,7,18,0,6,0,1,0.92,0.8788,0.4,0.2239,62,134,196,196,True
4798,2011-07-23,3,0,7,19,0,6,0,2,0.82,0.803,0.59,0.1343,80,137,217,217,True
4799,2011-07-23,3,0,7,20,0,6,0,1,0.82,0.803,0.59,0.2239,47,98,145,145,True
4800,2011-07-23,3,0,7,21,0,6,0,1,0.82,0.803,0.59,0.2239,39,115,154,154,True
4801,2011-07-23,3,0,7,22,0,6,0,1,0.8,0.7727,0.59,0.194,37,88,125,125,True
4802,2011-07-23,3,0,7,23,0,6,0,1,0.8,0.7727,0.59,0.1045,27,77,104,104,True
4803,2011-07-24,3,0,7,0,0,0,0,1,0.8,0.7727,0.59,0.1045,42,77,119,119,True
4804,2011-07-24,3,0,7,1,0,0,0,1,0.78,0.7576,0.66,0.1045,33,63,96,96,True
4805,2011-07-24,3,0,7,2,0,0,0,1,0.8,0.7879,0.63,0.0896,12,48,60,60,True
4806,2011-07-24,3,0,7,3,0,0,0,1,0.8,0.7879,0.63,0.0896,17,20,37,37,True
4807,2011-07-24,3,0,7,4,0,0,0,1,0.78,0.7576,0.66,0.1045,1,5,6,6,True
4808,2011-07-24,3,0,7,5,0,0,0,1,0.78,0.7576,0.66,0.0896,5,3,8,8,True
4809,2011-07-24,3,0,7,6,0,0,0,2,0.8,0.7879,0.63,0.0896,9,13,22,22,True
4810,2011-07-24,3,0,7,7,0,0,0,1,0.8,0.7727,0.59,0.1343,6,29,35,35,True
4811,2011-07-24,3,0,7,8,0,0,0,1,0.82,0.7879,0.56,0.2836,22,82,104,104,True
4812,2011-07-24,3,0,7,9,0,0,0,1,0.82,0.7879,0.56,0.3881,42,112,154,154,True
4813,2011-07-24,3,0,7,10,0,0,0,1,0.86,0.8182,0.5,0.3284,61,165,226,226,True
4814,2011-07-24,3,0,7,11,0,0,0,1,0.84,0.803,0.53,0.2537,74,169,243,243,True
4815,2011-07-24,3,0,7,12,0,0,0,1,0.9,0.8636,0.45,0.1642,85,161,246,246,True
4816,2011-07-24,3,0,7,13,0,0,0,1,0.86,0.803,0.47,0.2239,90,162,252,252,True
4817,2011-07-24,3,0,7,14,0,0,0,1,0.86,0.8182,0.5,0.2836,79,204,283,283,True
4818,2011-07-24,3,0,7,15,0,0,0,1,0.9,0.8485,0.42,0.2537,68,170,238,238,True
4819,2011-07-24,3,0,7,16,0,0,0,1,0.9,0.8485,0.42,0.2537,62,187,249,249,True
4820,2011-07-24,3,0,7,17,0,0,0,1,0.9,0.8333,0.39,0.1045,75,174,249,249,True
4821,2011-07-24,3,0,7,18,0,0,0,1,0.88,0.8182,0.42,0.1642,67,176,243,243,True
4822,2011-07-24,3,0,7,19,0,0,0,1,0.86,0.803,0.47,0.1642,70,170,240,240,True
4823,2011-07-24,3,0,7,20,0,0,0,1,0.84,0.7879,0.49,0.1642,52,143,195,195,True
4824,2011-07-24,3,0,7,21,0,0,0,1,0.8,0.7879,0.63,0.1343,42,111,153,153,True
4825,2011-07-24,3,0,7,22,0,0,0,1,0.78,0.7576,0.66,0.0,23,75,98,98,True
4826,2011-07-24,3,0,7,23,0,0,0,2,0.76,0.7273,0.7,0.0896,13,37,50,50,True
4827,2011-07-25,3,0,7,0,0,1,1,2,0.76,0.7273,0.7,0.0,17,17,34,34,True
4828,2011-07-25,3,0,7,1,0,1,1,2,0.76,0.7424,0.75,0.0896,4,8,12,12,True
4829,2011-07-25,3,0,7,2,0,1,1,2,0.74,0.7121,0.79,0.0896,3,3,6,6,True
4830,2011-07-25,3,0,7,3,0,1,1,1,0.74,0.7121,0.79,0.0,2,2,4,4,True
4831,2011-07-25,3,0,7,4,0,1,1,1,0.72,0.7121,0.84,0.0896,0,6,6,6,True
4832,2011-07-25,3,0,7,5,0,1,1,1,0.72,0.7121,0.84,0.0896,2,22,24,24,True
4833,2011-07-25,3,0,7,6,0,1,1,2,0.72,0.7121,0.84,0.0896,7,100,107,107,True
4834,2011-07-25,3,0,7,7,0,1,1,2,0.74,0.7121,0.79,0.0,20,257,277,277,True
4835,2011-07-25,3,0,7,8,0,1,1,2,0.76,0.7424,0.75,0.0,34,353,387,387,True
4836,2011-07-25,3,0,7,9,0,1,1,1,0.8,0.803,0.66,0.0,11,124,135,135,True
4837,2011-07-25,3,0,7,10,0,1,1,1,0.82,0.803,0.59,0.0,30,54,84,84,True
4838,2011-07-25,3,0,7,11,0,1,1,2,0.84,0.8333,0.59,0.194,24,83,107,107,True
4839,2011-07-25,3,0,7,12,0,1,1,2,0.84,0.8333,0.59,0.194,17,50,67,67,True
4840,2011-07-25,3,0,7,13,0,1,1,2,0.74,0.7121,0.74,0.1343,14,64,78,78,True
4841,2011-07-25,3,0,7,14,0,1,1,2,0.72,0.697,0.79,0.194,28,62,90,90,True
4842,2011-07-25,3,0,7,15,0,1,1,1,0.7,0.6667,0.84,0.3881,16,96,112,112,True
4843,2011-07-25,3,0,7,16,0,1,1,1,0.7,0.6667,0.84,0.2239,37,161,198,198,True
4844,2011-07-25,3,0,7,17,0,1,1,1,0.72,0.697,0.74,0.0,48,437,485,485,True
4845,2011-07-25,3,0,7,18,0,1,1,1,0.74,0.7121,0.74,0.0896,60,473,533,533,True
4846,2011-07-25,3,0,7,19,0,1,1,1,0.74,0.697,0.7,0.0896,62,324,386,386,True
4847,2011-07-25,3,0,7,20,0,1,1,1,0.72,0.697,0.74,0.1343,55,247,302,302,True
4848,2011-07-25,3,0,7,21,0,1,1,1,0.7,0.6667,0.84,0.0,41,153,194,194,True
4849,2011-07-25,3,0,7,22,0,1,1,1,0.7,0.6667,0.84,0.0,13,112,125,125,True
4850,2011-07-25,3,0,7,23,0,1,1,1,0.7,0.6667,0.84,0.0896,23,64,87,87,True
4851,2011-07-26,3,0,7,0,0,2,1,1,0.7,0.6667,0.79,0.1045,8,20,28,28,True
4852,2011-07-26,3,0,7,1,0,2,1,1,0.7,0.6667,0.79,0.1045,6,6,12,12,True
4853,2011-07-26,3,0,7,2,0,2,1,1,0.68,0.6364,0.89,0.1045,1,6,7,7,True
4854,2011-07-26,3,0,7,3,0,2,1,1,0.68,0.6364,0.89,0.1343,2,2,4,4,True
4855,2011-07-26,3,0,7,4,0,2,1,1,0.68,0.6364,0.88,0.1642,0,6,6,6,True
4856,2011-07-26,3,0,7,5,0,2,1,1,0.66,0.5909,0.89,0.0896,3,24,27,27,True
4857,2011-07-26,3,0,7,6,0,2,1,1,0.68,0.6364,0.83,0.2239,2,108,110,110,True
4858,2011-07-26,3,0,7,7,0,2,1,1,0.72,0.6818,0.66,0.2836,30,288,318,318,True
4859,2011-07-26,3,0,7,8,0,2,1,1,0.74,0.6818,0.55,0.194,32,392,424,424,True
4860,2011-07-26,3,0,7,9,0,2,1,1,0.76,0.6818,0.4,0.2239,25,162,187,187,True
4861,2011-07-26,3,0,7,10,0,2,1,1,0.8,0.697,0.31,0.2239,42,96,138,138,True
4862,2011-07-26,3,0,7,11,0,2,1,1,0.82,0.7121,0.3,0.0,49,102,151,151,True
4863,2011-07-26,3,0,7,12,0,2,1,1,0.84,0.7273,0.28,0.0,25,122,147,147,True
4864,2011-07-26,3,0,7,13,0,2,1,1,0.84,0.7273,0.32,0.2985,43,139,182,182,True
4865,2011-07-26,3,0,7,14,0,2,1,1,0.86,0.7424,0.3,0.2836,46,101,147,147,True
4866,2011-07-26,3,0,7,15,0,2,1,1,0.88,0.7576,0.28,0.3284,49,114,163,163,True
4867,2011-07-26,3,0,7,16,0,2,1,1,0.86,0.7576,0.36,0.2836,41,213,254,254,True
4868,2011-07-26,3,0,7,17,0,2,1,1,0.86,0.7576,0.36,0.3582,72,465,537,537,True
4869,2011-07-26,3,0,7,18,0,2,1,1,0.84,0.7424,0.39,0.3881,68,478,546,546,True
4870,2011-07-26,3,0,7,19,0,2,1,1,0.82,0.7424,0.43,0.2985,69,329,398,398,True
4871,2011-07-26,3,0,7,20,0,2,1,1,0.8,0.7273,0.46,0.2537,47,243,290,290,True
4872,2011-07-26,3,0,7,21,0,2,1,1,0.78,0.7121,0.49,0.2239,45,222,267,267,True
4873,2011-07-26,3,0,7,22,0,2,1,1,0.76,0.697,0.55,0.1343,27,131,158,158,True
4874,2011-07-26,3,0,7,23,0,2,1,1,0.76,0.7121,0.58,0.1045,18,71,89,89,True
4875,2011-07-27,3,0,7,0,0,3,1,2,0.78,0.7121,0.52,0.1642,19,26,45,45,True
4876,2011-07-27,3,0,7,1,0,3,1,1,0.78,0.7121,0.49,0.194,1,9,10,10,True
4877,2011-07-27,3,0,7,2,0,3,1,1,0.76,0.697,0.52,0.2985,1,5,6,6,True
4878,2011-07-27,3,0,7,3,0,3,1,1,0.72,0.6667,0.58,0.1642,0,4,4,4,True
4879,2011-07-27,3,0,7,4,0,3,1,1,0.72,0.6667,0.51,0.194,1,3,4,4,True
4880,2011-07-27,3,0,7,5,0,3,1,1,0.7,0.6515,0.54,0.2836,0,18,18,18,True
4881,2011-07-27,3,0,7,6,0,3,1,1,0.7,0.6515,0.54,0.2239,4,119,123,123,True
4882,2011-07-27,3,0,7,7,0,3,1,1,0.72,0.6667,0.48,0.2537,34,313,347,347,True
4883,2011-07-27,3,0,7,8,0,3,1,1,0.74,0.6667,0.42,0.2537,28,405,433,433,True
4884,2011-07-27,3,0,7,9,0,3,1,1,0.76,0.6667,0.35,0.2537,27,189,216,216,True
4885,2011-07-27,3,0,7,10,0,3,1,1,0.78,0.6818,0.33,0.0,32,82,114,114,True
4886,2011-07-27,3,0,7,11,0,3,1,1,0.8,0.697,0.31,0.0,42,94,136,136,True
4887,2011-07-27,3,0,7,12,0,3,1,1,0.82,0.7121,0.3,0.2836,37,132,169,169,True
4888,2011-07-27,3,0,7,13,0,3,1,1,0.84,0.7273,0.3,0.3582,29,151,180,180,True
4889,2011-07-27,3,0,7,14,0,3,1,1,0.84,0.7273,0.28,0.2239,20,107,127,127,True
4890,2011-07-27,3,0,7,15,0,3,1,1,0.86,0.7424,0.26,0.2537,37,103,140,140,True
4891,2011-07-27,3,0,7,16,0,3,1,1,0.86,0.7273,0.25,0.1642,40,228,268,268,True
4892,2011-07-27,3,0,7,17,0,3,1,1,0.84,0.7121,0.26,0.2239,81,491,572,572,True
4893,2011-07-27,3,0,7,18,0,3,1,1,0.82,0.7121,0.28,0.1045,78,463,541,541,True
4894,2011-07-27,3,0,7,19,0,3,1,1,0.8,0.697,0.29,0.0896,87,288,375,375,True
4895,2011-07-27,3,0,7,20,0,3,1,1,0.76,0.6818,0.45,0.2239,55,239,294,294,True
4896,2011-07-27,3,0,7,21,0,3,1,1,0.74,0.6667,0.48,0.1045,49,196,245,245,True
4897,2011-07-27,3,0,7,22,0,3,1,1,0.72,0.6667,0.48,0.0,37,143,180,180,True
4898,2011-07-27,3,0,7,23,0,3,1,1,0.74,0.6667,0.45,0.0896,16,93,109,109,True
4899,2011-07-28,3,0,7,0,0,4,1,1,0.7,0.6515,0.51,0.1343,14,31,45,45,True
4900,2011-07-28,3,0,7,1,0,4,1,1,0.72,0.6667,0.51,0.0,3,26,29,29,True
4901,2011-07-28,3,0,7,2,0,4,1,1,0.72,0.6667,0.54,0.1045,2,5,7,7,True
4902,2011-07-28,3,0,7,3,0,4,1,1,0.72,0.6667,0.54,0.0,0,5,5,5,True
4903,2011-07-28,3,0,7,4,0,4,1,1,0.7,0.6515,0.61,0.1045,0,6,6,6,True
4904,2011-07-28,3,0,7,5,0,4,1,1,0.7,0.6515,0.65,0.1045,1,26,27,27,True
4905,2011-07-28,3,0,7,6,0,4,1,1,0.7,0.6515,0.7,0.0896,6,110,116,116,True
4906,2011-07-28,3,0,7,7,0,4,1,1,0.72,0.6818,0.7,0.1642,27,278,305,305,True
4907,2011-07-28,3,0,7,8,0,4,1,1,0.74,0.697,0.66,0.1642,47,409,456,456,True
4908,2011-07-28,3,0,7,9,0,4,1,1,0.78,0.7424,0.59,0.194,21,189,210,210,True
4909,2011-07-28,3,0,7,10,0,4,1,1,0.8,0.7576,0.55,0.2836,30,86,116,116,True
4910,2011-07-28,3,0,7,11,0,4,1,1,0.84,0.8182,0.56,0.2836,41,113,154,154,True
4911,2011-07-28,3,0,7,12,0,4,1,1,0.84,0.803,0.53,0.2537,35,151,186,186,True
4912,2011-07-28,3,0,7,13,0,4,1,1,0.86,0.803,0.47,0.2537,26,126,152,152,True
4913,2011-07-28,3,0,7,14,0,4,1,2,0.84,0.7879,0.49,0.2537,27,111,138,138,True
4914,2011-07-28,3,0,7,15,0,4,1,1,0.86,0.8182,0.5,0.194,22,124,146,146,True
4915,2011-07-28,3,0,7,16,0,4,1,1,0.86,0.803,0.47,0.1642,42,214,256,256,True
4916,2011-07-28,3,0,7,17,0,4,1,1,0.84,0.803,0.53,0.194,45,423,468,468,True
4917,2011-07-28,3,0,7,18,0,4,1,1,0.84,0.8182,0.56,0.2239,55,428,483,483,True
4918,2011-07-28,3,0,7,19,0,4,1,1,0.82,0.803,0.59,0.194,37,285,322,322,True
4919,2011-07-28,3,0,7,20,0,4,1,1,0.8,0.7879,0.63,0.194,41,229,270,270,True
4920,2011-07-28,3,0,7,21,0,4,1,1,0.78,0.7576,0.66,0.2836,31,165,196,196,True
4921,2011-07-28,3,0,7,22,0,4,1,1,0.76,0.7273,0.7,0.2537,25,149,174,174,True
4922,2011-07-28,3,0,7,23,0,4,1,1,0.76,0.7424,0.75,0.194,28,95,123,123,True
4923,2011-07-29,3,0,7,0,0,5,1,1,0.74,0.7121,0.79,0.1642,12,45,57,57,True
4924,2011-07-29,3,0,7,1,0,5,1,1,0.74,0.7121,0.79,0.1343,12,22,34,34,True
4925,2011-07-29,3,0,7,2,0,5,1,1,0.74,0.7121,0.79,0.0,3,10,13,13,True
4926,2011-07-29,3,0,7,3,0,5,1,1,0.74,0.7121,0.79,0.0,2,9,11,11,True
4927,2011-07-29,3,0,7,4,0,5,1,1,0.72,0.7121,0.84,0.1343,2,4,6,6,True
4928,2011-07-29,3,0,7,5,0,5,1,1,0.72,0.7121,0.84,0.0,4,23,27,27,True
4929,2011-07-29,3,0,7,6,0,5,1,2,0.72,0.7121,0.84,0.0,7,83,90,90,True
4930,2011-07-29,3,0,7,7,0,5,1,2,0.74,0.7121,0.79,0.0896,26,228,254,254,True
4931,2011-07-29,3,0,7,8,0,5,1,2,0.76,0.7727,0.77,0.0,30,354,384,384,True
4932,2011-07-29,3,0,7,9,0,5,1,1,0.86,0.803,0.47,0.2537,28,151,179,179,True
4933,2011-07-29,3,0,7,10,0,5,1,1,0.9,0.8485,0.42,0.2836,37,69,106,106,True
4934,2011-07-29,3,0,7,11,0,5,1,1,0.92,0.8788,0.4,0.2985,43,118,161,161,True
4935,2011-07-29,3,0,7,12,0,5,1,1,0.96,0.8636,0.31,0.2836,40,95,135,135,True
4936,2011-07-29,3,0,7,13,0,5,1,1,0.94,0.8333,0.31,0.0,42,114,156,156,True
4937,2011-07-29,3,0,7,14,0,5,1,1,0.96,0.8636,0.3,0.2239,34,114,148,148,True
4938,2011-07-29,3,0,7,15,0,5,1,1,0.96,0.8636,0.3,0.2537,40,129,169,169,True
4939,2011-07-29,3,0,7,16,0,5,1,1,0.96,0.8636,0.3,0.3881,35,198,233,233,True
4940,2011-07-29,3,0,7,17,0,5,1,1,0.96,0.8636,0.3,0.2985,47,374,421,421,True
4941,2011-07-29,3,0,7,18,0,5,1,1,0.92,0.8636,0.37,0.3284,49,313,362,362,True
4942,2011-07-29,3,0,7,19,0,5,1,1,0.9,0.8485,0.42,0.2239,22,219,241,241,True
4943,2011-07-29,3,0,7,20,0,5,1,1,0.86,0.7879,0.41,0.3284,53,153,206,206,True
4944,2011-07-29,3,0,7,21,0,5,1,1,0.82,0.7576,0.46,0.1642,29,134,163,163,True
4945,2011-07-29,3,0,7,22,0,5,1,1,0.8,0.7424,0.49,0.2239,47,127,174,174,True
4946,2011-07-29,3,0,7,23,0,5,1,1,0.78,0.7121,0.52,0.1045,26,90,116,116,True
4947,2011-07-30,3,0,7,0,0,6,0,1,0.76,0.697,0.55,0.194,60,73,133,133,True
4948,2011-07-30,3,0,7,1,0,6,0,1,0.76,0.697,0.55,0.0896,15,75,90,90,True
4949,2011-07-30,3,0,7,2,0,6,0,1,0.76,0.697,0.55,0.1045,11,31,42,42,True
4950,2011-07-30,3,0,7,3,0,6,0,1,0.74,0.6818,0.62,0.1642,18,25,43,43,True
4951,2011-07-30,3,0,7,4,0,6,0,1,0.72,0.6818,0.66,0.1642,4,6,10,10,True
4952,2011-07-30,3,0,7,5,0,6,0,1,0.72,0.6818,0.7,0.2836,4,9,13,13,True
4953,2011-07-30,3,0,7,6,0,6,0,1,0.72,0.6818,0.7,0.2985,6,18,24,24,True
4954,2011-07-30,3,0,7,7,0,6,0,1,0.76,0.7273,0.66,0.194,3,39,42,42,True
4955,2011-07-30,3,0,7,8,0,6,0,1,0.78,0.7424,0.59,0.2239,27,87,114,114,True
4956,2011-07-30,3,0,7,9,0,6,0,1,0.82,0.7576,0.46,0.2985,49,125,174,174,True
4957,2011-07-30,3,0,7,10,0,6,0,1,0.82,0.7424,0.41,0.2985,79,182,261,261,True
4958,2011-07-30,3,0,7,11,0,6,0,1,0.84,0.7424,0.36,0.194,111,206,317,317,True
4959,2011-07-30,3,0,7,12,0,6,0,1,0.84,0.7273,0.32,0.1642,111,230,341,341,True
4960,2011-07-30,3,0,7,13,0,6,0,1,0.88,0.7576,0.29,0.0,114,183,297,297,True
4961,2011-07-30,3,0,7,14,0,6,0,1,0.9,0.7879,0.29,0.0,112,193,305,305,True
4962,2011-07-30,3,0,7,15,0,6,0,1,0.9,0.803,0.31,0.1343,113,189,302,302,True
4963,2011-07-30,3,0,7,16,0,6,0,1,0.9,0.7879,0.27,0.2239,114,176,290,290,True
4964,2011-07-30,3,0,7,17,0,6,0,1,0.9,0.7879,0.29,0.1045,93,209,302,302,True
4965,2011-07-30,3,0,7,18,0,6,0,1,0.88,0.7576,0.28,0.194,92,207,299,299,True
4966,2011-07-30,3,0,7,19,0,6,0,1,0.74,0.6515,0.33,0.2239,101,155,256,256,True
4967,2011-07-30,3,0,7,20,0,6,0,1,0.82,0.7424,0.43,0.1343,74,132,206,206,True
4968,2011-07-30,3,0,7,21,0,6,0,1,0.8,0.7424,0.49,0.1642,82,123,205,205,True
4969,2011-07-30,3,0,7,22,0,6,0,1,0.78,0.7121,0.52,0.1045,80,129,209,209,True
4970,2011-07-30,3,0,7,23,0,6,0,1,0.76,0.697,0.55,0.0896,63,114,177,177,True
4971,2011-07-31,3,0,7,0,0,0,0,1,0.76,0.697,0.55,0.0896,33,80,113,113,True
4972,2011-07-31,3,0,7,1,0,0,0,1,0.74,0.6818,0.62,0.0896,8,71,79,79,True
4973,2011-07-31,3,0,7,2,0,0,0,1,0.74,0.697,0.66,0.0896,19,48,67,67,True
4974,2011-07-31,3,0,7,3,0,0,0,1,0.74,0.697,0.66,0.0,24,26,50,50,True
4975,2011-07-31,3,0,7,4,0,0,0,1,0.72,0.6818,0.7,0.0,6,7,13,13,True
4976,2011-07-31,3,0,7,5,0,0,0,1,0.72,0.6818,0.69,0.0,4,4,8,8,True
4977,2011-07-31,3,0,7,6,0,0,0,1,0.74,0.697,0.7,0.0,5,8,13,13,True
4978,2011-07-31,3,0,7,7,0,0,0,1,0.74,0.6818,0.58,0.1343,19,26,45,45,True
4979,2011-07-31,3,0,7,8,0,0,0,1,0.76,0.697,0.55,0.2239,54,88,142,142,True
4980,2011-07-31,3,0,7,9,0,0,0,1,0.8,0.7424,0.49,0.0,55,128,183,183,True
4981,2011-07-31,3,0,7,10,0,0,0,1,0.84,0.7424,0.36,0.1642,91,163,254,254,True
4982,2011-07-31,3,0,7,11,0,0,0,1,0.86,0.7424,0.28,0.1642,112,163,275,275,True
4983,2011-07-31,3,0,7,12,0,0,0,1,0.9,0.7727,0.25,0.194,114,192,306,306,True
4984,2011-07-31,3,0,7,13,0,0,0,1,0.9,0.7727,0.24,0.1343,114,152,266,266,True
4985,2011-07-31,3,0,7,14,0,0,0,1,0.9,0.7727,0.24,0.1642,114,196,310,310,True
4986,2011-07-31,3,0,7,15,0,0,0,1,0.92,0.7727,0.18,0.2985,109,184,293,293,True
4987,2011-07-31,3,0,7,16,0,0,0,1,0.92,0.7727,0.17,0.2836,98,208,306,306,True
4988,2011-07-31,3,0,7,17,0,0,0,1,0.92,0.7727,0.16,0.1642,114,206,320,320,True
4989,2011-07-31,3,0,7,18,0,0,0,1,0.86,0.7879,0.41,0.2836,91,213,304,304,True
4990,2011-07-31,3,0,7,19,0,0,0,1,0.8,0.7576,0.55,0.3284,87,187,274,274,True
4991,2011-07-31,3,0,7,20,0,0,0,1,0.8,0.7576,0.55,0.3284,70,205,275,275,True
4992,2011-07-31,3,0,7,21,0,0,0,1,0.78,0.7424,0.59,0.2985,68,96,164,164,True
4993,2011-07-31,3,0,7,22,0,0,0,1,0.74,0.697,0.7,0.2985,25,71,96,96,True
4994,2011-07-31,3,0,7,23,0,0,0,1,0.74,0.697,0.66,0.2239,14,56,70,70,True
4995,2011-08-01,3,0,8,0,0,1,1,1,0.72,0.6818,0.7,0.2239,7,22,29,29,True
4996,2011-08-01,3,0,8,1,0,1,1,1,0.72,0.697,0.74,0.194,5,12,17,17,True
4997,2011-08-01,3,0,8,2,0,1,1,1,0.7,0.6667,0.74,0.1045,4,7,11,11,True
4998,2011-08-01,3,0,8,3,0,1,1,1,0.7,0.6667,0.79,0.1642,0,4,4,4,True
4999,2011-08-01,3,0,8,4,0,1,1,1,0.66,0.6061,0.83,0.1343,2,2,4,4,True
5000,2011-08-01,3,0,8,5,0,1,1,1,0.66,0.6061,0.83,0.1045,2,24,26,26,True
5001,2011-08-01,3,0,8,6,0,1,1,1,0.66,0.6061,0.83,0.0896,3,97,100,100,True
5002,2011-08-01,3,0,8,7,0,1,1,1,0.74,0.6818,0.62,0.0,24,258,282,282,True
5003,2011-08-01,3,0,8,8,0,1,1,1,0.8,0.7273,0.43,0.194,35,347,382,382,True
5004,2011-08-01,3,0,8,9,0,1,1,1,0.82,0.7424,0.41,0.0,27,139,166,166,True
5005,2011-08-01,3,0,8,10,0,1,1,1,0.86,0.7576,0.36,0.1642,27,70,97,97,True
5006,2011-08-01,3,0,8,11,0,1,1,1,0.88,0.7727,0.32,0.1642,53,66,119,119,True
5007,2011-08-01,3,0,8,12,0,1,1,1,0.9,0.803,0.33,0.2537,53,115,168,168,True
5008,2011-08-01,3,0,8,13,0,1,1,1,0.9,0.803,0.31,0.2985,38,112,150,150,True
5009,2011-08-01,3,0,8,14,0,1,1,1,0.92,0.8182,0.29,0.194,37,86,123,123,True
5010,2011-08-01,3,0,8,15,0,1,1,1,0.9,0.7879,0.27,0.0,52,77,129,129,True
5011,2011-08-01,3,0,8,16,0,1,1,1,0.9,0.7879,0.27,0.0,34,197,231,231,True
5012,2011-08-01,3,0,8,17,0,1,1,1,0.76,0.6818,0.45,0.2985,69,445,514,514,True
5013,2011-08-01,3,0,8,18,0,1,1,1,0.78,0.697,0.43,0.194,68,475,543,543,True
5014,2011-08-01,3,0,8,19,0,1,1,1,0.74,0.6667,0.51,0.2239,63,350,413,413,True
5015,2011-08-01,3,0,8,20,0,1,1,1,0.72,0.6818,0.62,0.2239,49,256,305,305,True
5016,2011-08-01,3,0,8,21,0,1,1,1,0.7,0.6515,0.7,0.2537,42,178,220,220,True
5017,2011-08-01,3,0,8,22,0,1,1,1,0.7,0.6515,0.7,0.0896,21,116,137,137,True
5018,2011-08-01,3,0,8,23,0,1,1,1,0.68,0.6364,0.74,0.194,14,82,96,96,True
5019,2011-08-02,3,0,8,0,0,2,1,1,0.66,0.6212,0.74,0.0,11,18,29,29,True
5020,2011-08-02,3,0,8,1,0,2,1,1,0.66,0.6212,0.74,0.1045,4,8,12,12,True
5021,2011-08-02,3,0,8,2,0,2,1,1,0.68,0.6364,0.69,0.0,2,6,8,8,True
5022,2011-08-02,3,0,8,3,0,2,1,1,0.66,0.6212,0.74,0.194,0,5,5,5,True
5023,2011-08-02,3,0,8,4,0,2,1,1,0.66,0.6212,0.74,0.1045,0,10,10,10,True
5024,2011-08-02,3,0,8,5,0,2,1,1,0.66,0.6212,0.74,0.1343,4,17,21,21,True
5025,2011-08-02,3,0,8,6,0,2,1,1,0.68,0.6364,0.69,0.1045,12,105,117,117,True
5026,2011-08-02,3,0,8,7,0,2,1,1,0.72,0.6667,0.61,0.2836,15,320,335,335,True
5027,2011-08-02,3,0,8,8,0,2,1,1,0.74,0.6818,0.58,0.2836,37,398,435,435,True
5028,2011-08-02,3,0,8,9,0,2,1,1,0.78,0.697,0.46,0.2985,31,182,213,213,True
5029,2011-08-02,3,0,8,10,0,2,1,1,0.82,0.7273,0.36,0.2985,50,90,140,140,True
5030,2011-08-02,3,0,8,11,0,2,1,1,0.84,0.7273,0.32,0.4179,32,96,128,128,True
5031,2011-08-02,3,0,8,12,0,2,1,1,0.86,0.7424,0.3,0.2836,45,112,157,157,True
5032,2011-08-02,3,0,8,13,0,2,1,1,0.86,0.7424,0.3,0.2239,50,153,203,203,True
5033,2011-08-02,3,0,8,14,0,2,1,1,0.9,0.7727,0.25,0.2836,45,114,159,159,True
5034,2011-08-02,3,0,8,15,0,2,1,1,0.9,0.7727,0.25,0.2836,48,120,168,168,True
5035,2011-08-02,3,0,8,16,0,2,1,1,0.9,0.7727,0.25,0.2836,58,216,274,274,True
5036,2011-08-02,3,0,8,17,0,2,1,2,0.9,0.7879,0.27,0.1343,63,493,556,556,True
5037,2011-08-02,3,0,8,18,0,2,1,2,0.86,0.7576,0.34,0.194,65,491,556,556,True
5038,2011-08-02,3,0,8,19,0,2,1,2,0.86,0.7576,0.36,0.2239,85,369,454,454,True
5039,2011-08-02,3,0,8,20,0,2,1,2,0.82,0.7576,0.46,0.2537,40,248,288,288,True
5040,2011-08-02,3,0,8,21,0,2,1,1,0.8,0.7424,0.52,0.2239,53,201,254,254,True
5041,2011-08-02,3,0,8,22,0,2,1,2,0.78,0.7424,0.59,0.1642,22,169,191,191,True
5042,2011-08-02,3,0,8,23,0,2,1,2,0.8,0.7424,0.49,0.1642,29,103,132,132,True
5043,2011-08-03,3,0,8,0,0,3,1,2,0.8,0.7424,0.49,0.1642,11,32,43,43,True
5044,2011-08-03,3,0,8,1,0,3,1,2,0.78,0.7121,0.52,0.1642,7,9,16,16,True
5045,2011-08-03,3,0,8,2,0,3,1,2,0.78,0.7121,0.49,0.1642,2,9,11,11,True
5046,2011-08-03,3,0,8,3,0,3,1,2,0.76,0.697,0.55,0.0896,0,4,4,4,True
5047,2011-08-03,3,0,8,4,0,3,1,2,0.76,0.697,0.52,0.1642,0,7,7,7,True
5048,2011-08-03,3,0,8,5,0,3,1,2,0.76,0.697,0.55,0.0896,2,22,24,24,True
5049,2011-08-03,3,0,8,6,0,3,1,3,0.72,0.6818,0.66,0.4775,9,101,110,110,True
5050,2011-08-03,3,0,8,7,0,3,1,2,0.74,0.6667,0.51,0.2239,19,252,271,271,True
5051,2011-08-03,3,0,8,8,0,3,1,2,0.74,0.6667,0.51,0.1642,29,408,437,437,True
5052,2011-08-03,3,0,8,9,0,3,1,2,0.74,0.6818,0.55,0.194,23,172,195,195,True
5053,2011-08-03,3,0,8,10,0,3,1,3,0.74,0.6818,0.58,0.0896,9,59,68,68,True
5054,2011-08-03,3,0,8,11,0,3,1,2,0.74,0.6818,0.58,0.1045,29,93,122,122,True
5055,2011-08-03,3,0,8,12,0,3,1,3,0.76,0.697,0.55,0.1343,19,142,161,161,True
5056,2011-08-03,3,0,8,13,0,3,1,2,0.76,0.7121,0.58,0.2239,37,107,144,144,True
5057,2011-08-03,3,0,8,14,0,3,1,2,0.76,0.7121,0.58,0.2239,43,104,147,147,True
5058,2011-08-03,3,0,8,15,0,3,1,2,0.7,0.6667,0.79,0.1343,31,87,118,118,True
5059,2011-08-03,3,0,8,16,0,3,1,3,0.68,0.6364,0.79,0.0,21,129,150,150,True
5060,2011-08-03,3,0,8,17,0,3,1,2,0.7,0.6667,0.79,0.0,47,378,425,425,True
5061,2011-08-03,3,0,8,18,0,3,1,3,0.7,0.6667,0.84,0.0,49,443,492,492,True
5062,2011-08-03,3,0,8,19,0,3,1,3,0.7,0.6667,0.84,0.0,51,270,321,321,True
5063,2011-08-03,3,0,8,20,0,3,1,3,0.7,0.6667,0.84,0.1045,7,80,87,87,True
5064,2011-08-03,3,0,8,21,0,3,1,2,0.68,0.6364,0.89,0.1343,7,81,88,88,True
5065,2011-08-03,3,0,8,22,0,3,1,3,0.68,0.6364,0.89,0.1045,11,66,77,77,True
5066,2011-08-03,3,0,8,23,0,3,1,2,0.68,0.6364,0.89,0.0896,4,52,56,56,True
5067,2011-08-04,3,0,8,0,0,4,1,2,0.68,0.6364,0.89,0.0896,2,15,17,17,True
5068,2011-08-04,3,0,8,1,0,4,1,2,0.66,0.5909,0.94,0.0896,3,14,17,17,True
5069,2011-08-04,3,0,8,2,0,4,1,2,0.66,0.5909,0.94,0.0896,2,5,7,7,True
5070,2011-08-04,3,0,8,3,0,4,1,3,0.66,0.5909,0.94,0.0896,0,3,3,3,True
5071,2011-08-04,3,0,8,4,0,4,1,2,0.68,0.6364,0.89,0.0,0,7,7,7,True
5072,2011-08-04,3,0,8,5,0,4,1,2,0.68,0.6364,0.89,0.0,3,17,20,20,True
5073,2011-08-04,3,0,8,6,0,4,1,2,0.68,0.6364,0.89,0.2985,7,90,97,97,True
5074,2011-08-04,3,0,8,7,0,4,1,2,0.68,0.6364,0.89,0.2985,11,271,282,282,True
5075,2011-08-04,3,0,8,8,0,4,1,2,0.7,0.6515,0.82,0.3582,29,369,398,398,True
5076,2011-08-04,3,0,8,9,0,4,1,1,0.72,0.697,0.74,0.3284,25,162,187,187,True
5077,2011-08-04,3,0,8,10,0,4,1,1,0.72,0.6667,0.71,0.2985,24,89,113,113,True
5078,2011-08-04,3,0,8,11,0,4,1,2,0.74,0.697,0.66,0.2239,37,112,149,149,True
5079,2011-08-04,3,0,8,12,0,4,1,2,0.76,0.7121,0.62,0.2239,53,152,205,205,True
5080,2011-08-04,3,0,8,13,0,4,1,1,0.76,0.7121,0.58,0.0,63,142,205,205,True
5081,2011-08-04,3,0,8,14,0,4,1,1,0.8,0.7576,0.55,0.1642,53,114,167,167,True
5082,2011-08-04,3,0,8,15,0,4,1,1,0.8,0.7576,0.55,0.2537,50,115,165,165,True
5083,2011-08-04,3,0,8,16,0,4,1,1,0.76,0.7121,0.62,0.3284,70,220,290,290,True
5084,2011-08-04,3,0,8,17,0,4,1,1,0.76,0.7121,0.62,0.3284,91,464,555,555,True
5085,2011-08-04,3,0,8,18,0,4,1,1,0.7,0.6667,0.74,0.2985,88,435,523,523,True
5086,2011-08-04,3,0,8,19,0,4,1,1,0.7,0.6667,0.74,0.2836,65,301,366,366,True
5087,2011-08-04,3,0,8,20,0,4,1,2,0.7,0.6667,0.74,0.194,41,245,286,286,True
5088,2011-08-04,3,0,8,21,0,4,1,2,0.7,0.6667,0.74,0.194,25,186,211,211,True
5089,2011-08-04,3,0,8,22,0,4,1,1,0.68,0.6364,0.74,0.194,33,141,174,174,True
5090,2011-08-04,3,0,8,23,0,4,1,1,0.66,0.6212,0.74,0.1045,24,108,132,132,True
5091,2011-08-05,3,0,8,0,0,5,1,1,0.66,0.6212,0.74,0.1045,13,41,54,54,True
5092,2011-08-05,3,0,8,1,0,5,1,1,0.64,0.5909,0.78,0.0896,3,16,19,19,True
5093,2011-08-05,3,0,8,2,0,5,1,1,0.66,0.6212,0.69,0.0,5,14,19,19,True
5094,2011-08-05,3,0,8,3,0,5,1,1,0.64,0.5909,0.78,0.0896,0,6,6,6,True
5095,2011-08-05,3,0,8,4,0,5,1,1,0.64,0.5909,0.78,0.1343,1,6,7,7,True
5096,2011-08-05,3,0,8,5,0,5,1,1,0.64,0.5909,0.78,0.0896,0,16,16,16,True
5097,2011-08-05,3,0,8,6,0,5,1,1,0.64,0.5909,0.78,0.1343,7,94,101,101,True
5098,2011-08-05,3,0,8,7,0,5,1,1,0.66,0.6061,0.78,0.1343,23,247,270,270,True
5099,2011-08-05,3,0,8,8,0,5,1,1,0.7,0.6515,0.65,0.2239,39,415,454,454,True
5100,2011-08-05,3,0,8,9,0,5,1,1,0.72,0.6667,0.58,0.1045,43,183,226,226,True
5101,2011-08-05,3,0,8,10,0,5,1,1,0.74,0.6818,0.55,0.1343,50,113,163,163,True
5102,2011-08-05,3,0,8,11,0,5,1,2,0.76,0.697,0.52,0.2537,44,103,147,147,True
5103,2011-08-05,3,0,8,12,0,5,1,1,0.76,0.697,0.52,0.2537,57,159,216,216,True
5104,2011-08-05,3,0,8,13,0,5,1,1,0.78,0.7121,0.52,0.2537,40,164,204,204,True
5105,2011-08-05,3,0,8,14,0,5,1,2,0.78,0.7121,0.52,0.2537,81,164,245,245,True
5106,2011-08-05,3,0,8,15,0,5,1,1,0.76,0.697,0.55,0.2537,50,160,210,210,True
5107,2011-08-05,3,0,8,16,0,5,1,1,0.8,0.7424,0.49,0.2537,76,254,330,330,True
5108,2011-08-05,3,0,8,17,0,5,1,1,0.78,0.7121,0.49,0.2985,84,466,550,550,True
5109,2011-08-05,3,0,8,18,0,5,1,1,0.76,0.697,0.52,0.2537,105,361,466,466,True
5110,2011-08-05,3,0,8,19,0,5,1,1,0.74,0.6818,0.55,0.2537,90,282,372,372,True
5111,2011-08-05,3,0,8,20,0,5,1,1,0.72,0.6667,0.58,0.2239,70,221,291,291,True
5112,2011-08-05,3,0,8,21,0,5,1,1,0.7,0.6515,0.65,0.194,54,119,173,173,True
5113,2011-08-05,3,0,8,22,0,5,1,1,0.7,0.6515,0.65,0.2239,51,137,188,188,True
5114,2011-08-05,3,0,8,23,0,5,1,1,0.68,0.6364,0.69,0.2239,37,102,139,139,True
5115,2011-08-06,3,0,8,0,0,6,0,1,0.66,0.6061,0.78,0.194,29,104,133,133,True
5116,2011-08-06,3,0,8,1,0,6,0,1,0.66,0.6061,0.78,0.1642,17,50,67,67,True
5117,2011-08-06,3,0,8,2,0,6,0,1,0.66,0.6061,0.78,0.2239,14,39,53,53,True
5118,2011-08-06,3,0,8,3,0,6,0,2,0.66,0.6061,0.78,0.1642,14,28,42,42,True
5119,2011-08-06,3,0,8,4,0,6,0,2,0.66,0.6061,0.83,0.1642,5,5,10,10,True
5120,2011-08-06,3,0,8,5,0,6,0,1,0.64,0.5758,0.89,0.0896,2,4,6,6,True
5121,2011-08-06,3,0,8,6,0,6,0,1,0.64,0.5758,0.89,0.1045,5,22,27,27,True
5122,2011-08-06,3,0,8,7,0,6,0,1,0.68,0.6364,0.83,0.1642,14,49,63,63,True
5123,2011-08-06,3,0,8,8,0,6,0,1,0.68,0.6364,0.83,0.1642,27,94,121,121,True
5124,2011-08-06,3,0,8,9,0,6,0,1,0.74,0.697,0.7,0.2239,60,155,215,215,True
5125,2011-08-06,3,0,8,10,0,6,0,2,0.74,0.697,0.7,0.2836,91,199,290,290,True
5126,2011-08-06,3,0,8,11,0,6,0,1,0.78,0.7424,0.62,0.2239,114,211,325,325,True
5127,2011-08-06,3,0,8,12,0,6,0,1,0.8,0.7576,0.55,0.2239,114,252,366,366,True
5128,2011-08-06,3,0,8,13,0,6,0,2,0.8,0.7727,0.59,0.3284,114,265,379,379,True
5129,2011-08-06,3,0,8,14,0,6,0,1,0.82,0.7727,0.52,0.2537,114,204,318,318,True
5130,2011-08-06,3,0,8,15,0,6,0,2,0.84,0.803,0.53,0.2537,114,232,346,346,True
5131,2011-08-06,3,0,8,16,0,6,0,3,0.74,0.7121,0.79,0.1642,114,188,302,302,True
5132,2011-08-06,3,0,8,17,0,6,0,3,0.74,0.7121,0.79,0.1642,61,88,149,149,True
5133,2011-08-06,3,0,8,18,0,6,0,2,0.72,0.697,0.79,0.4478,81,130,211,211,True
5134,2011-08-06,3,0,8,19,0,6,0,3,0.72,0.7121,0.84,0.2537,57,114,171,171,True
5135,2011-08-06,3,0,8,20,0,6,0,3,0.72,0.697,0.79,0.2836,58,79,137,137,True
5136,2011-08-06,3,0,8,21,0,6,0,2,0.7,0.6667,0.84,0.3284,28,86,114,114,True
5137,2011-08-06,3,0,8,22,0,6,0,2,0.7,0.6667,0.84,0.3284,24,96,120,120,True
5138,2011-08-06,3,0,8,23,0,6,0,3,0.7,0.6667,0.84,0.2836,29,79,108,108,True
5139,2011-08-07,3,0,8,0,0,0,0,2,0.7,0.6667,0.84,0.2836,14,66,80,80,True
5140,2011-08-07,3,0,8,1,0,0,0,2,0.7,0.6667,0.84,0.2537,10,63,73,73,True
5141,2011-08-07,3,0,8,2,0,0,0,2,0.7,0.6667,0.84,0.2239,18,48,66,66,True
5142,2011-08-07,3,0,8,3,0,0,0,2,0.7,0.6667,0.84,0.1343,9,23,32,32,True
5143,2011-08-07,3,0,8,4,0,0,0,1,0.7,0.6667,0.84,0.1343,1,5,6,6,True
5144,2011-08-07,3,0,8,5,0,0,0,1,0.7,0.6667,0.89,0.194,1,4,5,5,True
5145,2011-08-07,3,0,8,6,0,0,0,1,0.7,0.6667,0.89,0.1642,3,10,13,13,True
5146,2011-08-07,3,0,8,7,0,0,0,1,0.7,0.6667,0.84,0.194,11,28,39,39,True
5147,2011-08-07,3,0,8,8,0,0,0,1,0.72,0.697,0.79,0.194,23,66,89,89,True
5148,2011-08-07,3,0,8,9,0,0,0,1,0.76,0.7424,0.75,0.1045,82,102,184,184,True
5149,2011-08-07,3,0,8,10,0,0,0,1,0.8,0.803,0.66,0.1343,88,178,266,266,True
5150,2011-08-07,3,0,8,11,0,0,0,1,0.82,0.8333,0.63,0.0,113,156,269,269,True
5151,2011-08-07,3,0,8,12,0,0,0,1,0.9,0.8485,0.42,0.2985,114,209,323,323,True
5152,2011-08-07,3,0,8,13,0,0,0,1,0.9,0.8485,0.42,0.2985,114,206,320,320,True
5153,2011-08-07,3,0,8,14,0,0,0,1,0.86,0.803,0.47,0.194,114,192,306,306,True
5154,2011-08-07,3,0,8,15,0,0,0,3,0.72,0.697,0.74,0.2985,114,208,322,322,True
5155,2011-08-07,3,0,8,16,0,0,0,3,0.72,0.697,0.74,0.2985,74,119,193,193,True
5156,2011-08-07,3,0,8,17,0,0,0,3,0.74,0.7121,0.74,0.4775,63,131,194,194,True
5157,2011-08-07,3,0,8,18,0,0,0,1,0.72,0.697,0.74,0.0896,74,155,229,229,True
5158,2011-08-07,3,0,8,19,0,0,0,1,0.72,0.697,0.79,0.1642,68,160,228,228,True
5159,2011-08-07,3,0,8,20,0,0,0,1,0.72,0.7121,0.84,0.1343,50,133,183,183,True
5160,2011-08-07,3,0,8,21,0,0,0,1,0.72,0.7121,0.84,0.1045,36,100,136,136,True
5161,2011-08-07,3,0,8,22,0,0,0,1,0.7,0.6667,0.89,0.194,21,82,103,103,True
5162,2011-08-07,3,0,8,23,0,0,0,1,0.7,0.6667,0.79,0.1045,12,43,55,55,True
5163,2011-08-08,3,0,8,0,0,1,1,1,0.7,0.6667,0.79,0.1045,13,17,30,30,True
5164,2011-08-08,3,0,8,1,0,1,1,1,0.68,0.6364,0.83,0.1343,4,8,12,12,True
5165,2011-08-08,3,0,8,2,0,1,1,1,0.66,0.5909,0.89,0.0,4,3,7,7,True
5166,2011-08-08,3,0,8,3,0,1,1,1,0.66,0.5909,0.89,0.0,1,0,1,1,True
5167,2011-08-08,3,0,8,4,0,1,1,1,0.66,0.5909,0.89,0.1045,2,8,10,10,True
5168,2011-08-08,3,0,8,5,0,1,1,1,0.7,0.6667,0.79,0.0896,1,14,15,15,True
5169,2011-08-08,3,0,8,6,0,1,1,1,0.7,0.6515,0.65,0.2836,8,87,95,95,True
5170,2011-08-08,3,0,8,7,0,1,1,1,0.72,0.6818,0.62,0.2985,18,249,267,267,True
5171,2011-08-08,3,0,8,8,0,1,1,1,0.74,0.6818,0.58,0.3284,29,320,349,349,True
5172,2011-08-08,3,0,8,9,0,1,1,1,0.76,0.697,0.55,0.3881,37,146,183,183,True
5173,2011-08-08,3,0,8,10,0,1,1,1,0.8,0.7424,0.52,0.3881,62,62,124,124,True
5174,2011-08-08,3,0,8,11,0,1,1,1,0.82,0.7424,0.48,0.3582,90,89,179,179,True
5175,2011-08-08,3,0,8,12,0,1,1,1,0.82,0.7576,0.46,0.2537,48,134,182,182,True
5176,2011-08-08,3,0,8,13,0,1,1,1,0.84,0.7576,0.44,0.2985,43,108,151,151,True
5177,2011-08-08,3,0,8,14,0,1,1,1,0.82,0.7424,0.43,0.2985,41,109,150,150,True
5178,2011-08-08,3,0,8,15,0,1,1,1,0.84,0.7576,0.41,0.2985,40,86,126,126,True
5179,2011-08-08,3,0,8,16,0,1,1,1,0.86,0.7727,0.39,0.2836,64,218,282,282,True
5180,2011-08-08,3,0,8,17,0,1,1,1,0.86,0.7727,0.39,0.1642,67,460,527,527,True
5181,2011-08-08,3,0,8,18,0,1,1,1,0.84,0.7576,0.41,0.1343,64,465,529,529,True
5182,2011-08-08,3,0,8,19,0,1,1,1,0.82,0.7424,0.43,0.1045,64,352,416,416,True
5183,2011-08-08,3,0,8,20,0,1,1,1,0.8,0.7576,0.55,0.0,71,215,286,286,True
5184,2011-08-08,3,0,8,21,0,1,1,1,0.76,0.7121,0.58,0.0896,30,156,186,186,True
5185,2011-08-08,3,0,8,22,0,1,1,1,0.76,0.7121,0.58,0.1045,26,121,147,147,True
5186,2011-08-08,3,0,8,23,0,1,1,1,0.74,0.697,0.66,0.1045,19,53,72,72,True
5187,2011-08-09,3,0,8,0,0,2,1,1,0.72,0.697,0.79,0.1343,10,25,35,35,True
5188,2011-08-09,3,0,8,1,0,2,1,1,0.72,0.6818,0.66,0.0,5,9,14,14,True
5189,2011-08-09,3,0,8,2,0,2,1,1,0.72,0.6818,0.7,0.0,9,3,12,12,True
5190,2011-08-09,3,0,8,3,0,2,1,1,0.72,0.6818,0.62,0.0,0,3,3,3,True
5191,2011-08-09,3,0,8,4,0,2,1,1,0.7,0.6667,0.74,0.0,1,6,7,7,True
5192,2011-08-09,3,0,8,5,0,2,1,1,0.7,0.6515,0.65,0.0896,5,25,30,30,True
5193,2011-08-09,3,0,8,6,0,2,1,1,0.72,0.6667,0.64,0.0,6,95,101,101,True
5194,2011-08-09,3,0,8,7,0,2,1,1,0.72,0.697,0.74,0.1045,30,313,343,343,True
5195,2011-08-09,3,0,8,8,0,2,1,1,0.74,0.697,0.66,0.0,40,352,392,392,True
5196,2011-08-09,3,0,8,9,0,2,1,2,0.78,0.7424,0.62,0.1343,34,141,175,175,True
5197,2011-08-09,3,0,8,10,0,2,1,2,0.8,0.7727,0.59,0.2239,55,89,144,144,True
5198,2011-08-09,3,0,8,11,0,2,1,1,0.8,0.7727,0.59,0.2239,61,88,149,149,True
5199,2011-08-09,3,0,8,12,0,2,1,1,0.82,0.7879,0.56,0.194,60,125,185,185,True
5200,2011-08-09,3,0,8,13,0,2,1,1,0.84,0.7879,0.49,0.1642,48,127,175,175,True
5201,2011-08-09,3,0,8,14,0,2,1,1,0.86,0.7879,0.44,0.2836,53,95,148,148,True
5202,2011-08-09,3,0,8,15,0,2,1,1,0.86,0.7727,0.39,0.2836,58,106,164,164,True
5203,2011-08-09,3,0,8,16,0,2,1,1,0.86,0.7727,0.39,0.2985,57,228,285,285,True
5204,2011-08-09,3,0,8,17,0,2,1,1,0.8,0.7576,0.55,0.1642,79,453,532,532,True
5205,2011-08-09,3,0,8,18,0,2,1,1,0.8,0.7576,0.55,0.194,97,488,585,585,True
5206,2011-08-09,3,0,8,19,0,2,1,1,0.8,0.7424,0.49,0.1045,69,302,371,371,True
5207,2011-08-09,3,0,8,20,0,2,1,1,0.8,0.7273,0.43,0.194,34,258,292,292,True
5208,2011-08-09,3,0,8,21,0,2,1,1,0.78,0.697,0.46,0.2537,46,184,230,230,True
5209,2011-08-09,3,0,8,22,0,2,1,1,0.78,0.697,0.46,0.2985,28,127,155,155,True
5210,2011-08-09,3,0,8,23,0,2,1,1,0.76,0.6818,0.48,0.2836,22,53,75,75,True
5211,2011-08-10,3,0,8,0,0,3,1,1,0.74,0.6667,0.51,0.2239,19,18,37,37,True
5212,2011-08-10,3,0,8,1,0,3,1,1,0.72,0.6667,0.54,0.194,7,10,17,17,True
5213,2011-08-10,3,0,8,2,0,3,1,1,0.72,0.6667,0.54,0.1642,1,10,11,11,True
5214,2011-08-10,3,0,8,3,0,3,1,1,0.7,0.6515,0.58,0.1642,1,3,4,4,True
5215,2011-08-10,3,0,8,4,0,3,1,1,0.7,0.6515,0.54,0.1343,1,4,5,5,True
5216,2011-08-10,3,0,8,5,0,3,1,1,0.68,0.6364,0.61,0.0896,2,30,32,32,True
5217,2011-08-10,3,0,8,6,0,3,1,1,0.68,0.6364,0.61,0.0,9,110,119,119,True
5218,2011-08-10,3,0,8,7,0,3,1,1,0.7,0.6515,0.58,0.0896,16,289,305,305,True
5219,2011-08-10,3,0,8,8,0,3,1,1,0.74,0.6667,0.51,0.194,38,361,399,399,True
5220,2011-08-10,3,0,8,9,0,3,1,1,0.76,0.6818,0.48,0.2239,32,148,180,180,True
5221,2011-08-10,3,0,8,10,0,3,1,1,0.8,0.7273,0.43,0.2239,41,72,113,113,True
5222,2011-08-10,3,0,8,11,0,3,1,1,0.8,0.7121,0.41,0.3881,54,95,149,149,True
5223,2011-08-10,3,0,8,12,0,3,1,1,0.82,0.7273,0.38,0.2985,74,166,240,240,True
5224,2011-08-10,3,0,8,13,0,3,1,1,0.82,0.7273,0.38,0.2836,41,150,191,191,True
5225,2011-08-10,3,0,8,14,0,3,1,1,0.84,0.7273,0.34,0.3284,62,116,178,178,True
5226,2011-08-10,3,0,8,15,0,3,1,1,0.86,0.7424,0.3,0.3284,53,141,194,194,True
5227,2011-08-10,3,0,8,16,0,3,1,1,0.86,0.7424,0.26,0.2985,76,206,282,282,True
5228,2011-08-10,3,0,8,17,0,3,1,1,0.84,0.7121,0.26,0.2985,71,499,570,570,True
5229,2011-08-10,3,0,8,18,0,3,1,1,0.82,0.7121,0.28,0.2985,70,489,559,559,True
5230,2011-08-10,3,0,8,19,0,3,1,1,0.8,0.697,0.26,0.2537,79,334,413,413,True
5231,2011-08-10,3,0,8,20,0,3,1,1,0.76,0.6667,0.31,0.1343,59,253,312,312,True
5232,2011-08-10,3,0,8,21,0,3,1,1,0.76,0.6667,0.33,0.1045,47,162,209,209,True
5233,2011-08-10,3,0,8,22,0,3,1,1,0.74,0.6515,0.37,0.0,17,122,139,139,True
5234,2011-08-10,3,0,8,23,0,3,1,1,0.74,0.6515,0.37,0.0896,14,94,108,108,True
5235,2011-08-11,3,0,8,0,0,4,1,1,0.7,0.6364,0.45,0.1045,6,40,46,46,True
5236,2011-08-11,3,0,8,1,0,4,1,1,0.7,0.6364,0.45,0.1343,9,17,26,26,True
5237,2011-08-11,3,0,8,2,0,4,1,1,0.66,0.6212,0.54,0.1343,3,8,11,11,True
5238,2011-08-11,3,0,8,3,0,4,1,1,0.64,0.6212,0.57,0.1343,2,7,9,9,True
5239,2011-08-11,3,0,8,4,0,4,1,1,0.64,0.6212,0.57,0.1642,1,4,5,5,True
5240,2011-08-11,3,0,8,5,0,4,1,1,0.64,0.6212,0.61,0.194,2,23,25,25,True
5241,2011-08-11,3,0,8,6,0,4,1,1,0.62,0.6061,0.65,0.1642,5,101,106,106,True
5242,2011-08-11,3,0,8,7,0,4,1,1,0.66,0.6212,0.54,0.1343,15,292,307,307,True
5243,2011-08-11,3,0,8,8,0,4,1,1,0.7,0.6364,0.45,0.1642,29,361,390,390,True
5244,2011-08-11,3,0,8,9,0,4,1,1,0.72,0.6515,0.39,0.2239,31,166,197,197,True
5245,2011-08-11,3,0,8,10,0,4,1,1,0.74,0.6515,0.37,0.2537,36,96,132,132,True
5246,2011-08-11,3,0,8,11,0,4,1,1,0.76,0.6667,0.35,0.2537,59,128,187,187,True
5247,2011-08-11,3,0,8,12,0,4,1,1,0.78,0.6818,0.31,0.2537,50,164,214,214,True
5248,2011-08-11,3,0,8,13,0,4,1,1,0.76,0.6667,0.31,0.2239,51,166,217,217,True
5249,2011-08-11,3,0,8,14,0,4,1,1,0.8,0.697,0.29,0.0,39,103,142,142,True
5250,2011-08-11,3,0,8,15,0,4,1,1,0.8,0.697,0.29,0.2985,52,126,178,178,True
5251,2011-08-11,3,0,8,16,0,4,1,1,0.8,0.697,0.27,0.194,57,241,298,298,True
5252,2011-08-11,3,0,8,17,0,4,1,1,0.8,0.697,0.29,0.2537,96,486,582,582,True
5253,2011-08-11,3,0,8,18,0,4,1,1,0.78,0.6818,0.29,0.0896,74,497,571,571,True
5254,2011-08-11,3,0,8,19,0,4,1,1,0.74,0.6515,0.35,0.194,48,323,371,371,True
5255,2011-08-11,3,0,8,20,0,4,1,1,0.72,0.6515,0.37,0.1343,56,232,288,288,True
5256,2011-08-11,3,0,8,21,0,4,1,1,0.7,0.6515,0.48,0.0896,35,171,206,206,True
5257,2011-08-11,3,0,8,22,0,4,1,1,0.7,0.6515,0.48,0.0,34,123,157,157,True
5258,2011-08-11,3,0,8,23,0,4,1,1,0.66,0.6212,0.5,0.1642,22,105,127,127,True
5259,2011-08-12,3,0,8,0,0,5,1,1,0.64,0.6212,0.53,0.1642,12,53,65,65,True
5260,2011-08-12,3,0,8,1,0,5,1,1,0.64,0.6212,0.53,0.1343,4,19,23,23,True
5261,2011-08-12,3,0,8,2,0,5,1,1,0.62,0.6212,0.57,0.194,0,15,15,15,True
5262,2011-08-12,3,0,8,3,0,5,1,1,0.62,0.6212,0.53,0.1642,0,9,9,9,True
5263,2011-08-12,3,0,8,4,0,5,1,1,0.62,0.6212,0.53,0.1343,0,5,5,5,True
5264,2011-08-12,3,0,8,5,0,5,1,1,0.6,0.6212,0.56,0.1343,2,24,26,26,True
5265,2011-08-12,3,0,8,6,0,5,1,1,0.62,0.6212,0.5,0.1343,3,73,76,76,True
5266,2011-08-12,3,0,8,7,0,5,1,1,0.64,0.6212,0.44,0.1642,17,247,264,264,True
5267,2011-08-12,3,0,8,8,0,5,1,1,0.68,0.6364,0.39,0.2239,29,397,426,426,True
5268,2011-08-12,3,0,8,9,0,5,1,1,0.72,0.6515,0.34,0.1343,27,178,205,205,True
5269,2011-08-12,3,0,8,10,0,5,1,1,0.74,0.6515,0.33,0.1045,44,86,130,130,True
5270,2011-08-12,3,0,8,11,0,5,1,1,0.76,0.6667,0.29,0.0,48,108,156,156,True
5271,2011-08-12,3,0,8,12,0,5,1,1,0.8,0.697,0.27,0.0,55,167,222,222,True
5272,2011-08-12,3,0,8,13,0,5,1,1,0.78,0.6818,0.29,0.0896,74,179,253,253,True
5273,2011-08-12,3,0,8,14,0,5,1,1,0.8,0.697,0.29,0.194,51,135,186,186,True
5274,2011-08-12,3,0,8,15,0,5,1,1,0.8,0.697,0.29,0.1642,59,190,249,249,True
5275,2011-08-12,3,0,8,16,0,5,1,1,0.82,0.7121,0.28,0.0,68,266,334,334,True
5276,2011-08-12,3,0,8,17,0,5,1,1,0.82,0.7121,0.26,0.0,93,423,516,516,True
5277,2011-08-12,3,0,8,18,0,5,1,1,0.76,0.6818,0.4,0.2985,89,376,465,465,True
5278,2011-08-12,3,0,8,19,0,5,1,1,0.74,0.6667,0.42,0.2239,101,284,385,385,True
5279,2011-08-12,3,0,8,20,0,5,1,1,0.72,0.6515,0.42,0.2239,77,210,287,287,True
5280,2011-08-12,3,0,8,21,0,5,1,1,0.7,0.6515,0.48,0.1343,73,153,226,226,True
5281,2011-08-12,3,0,8,22,0,5,1,1,0.68,0.6364,0.51,0.0,74,157,231,231,True
5282,2011-08-12,3,0,8,23,0,5,1,1,0.68,0.6364,0.51,0.0,51,100,151,151,True
5283,2011-08-13,3,0,8,0,0,6,0,1,0.68,0.6364,0.51,0.1045,15,69,84,84,True
5284,2011-08-13,3,0,8,1,0,6,0,2,0.68,0.6364,0.57,0.0896,13,64,77,77,True
5285,2011-08-13,3,0,8,2,0,6,0,1,0.68,0.6364,0.57,0.0,16,58,74,74,True
5286,2011-08-13,3,0,8,3,0,6,0,1,0.66,0.6212,0.65,0.1343,9,18,27,27,True
5287,2011-08-13,3,0,8,4,0,6,0,2,0.64,0.6061,0.73,0.1343,5,5,10,10,True
5288,2011-08-13,3,0,8,5,0,6,0,1,0.64,0.6061,0.73,0.1045,3,15,18,18,True
5289,2011-08-13,3,0,8,6,0,6,0,1,0.64,0.6061,0.73,0.0896,3,19,22,22,True
5290,2011-08-13,3,0,8,7,0,6,0,2,0.66,0.6212,0.74,0.194,10,34,44,44,True
5291,2011-08-13,3,0,8,8,0,6,0,2,0.7,0.6515,0.65,0.1642,28,90,118,118,True
5292,2011-08-13,3,0,8,9,0,6,0,2,0.7,0.6667,0.74,0.1642,70,138,208,208,True
5293,2011-08-13,3,0,8,10,0,6,0,2,0.72,0.697,0.74,0.2239,97,163,260,260,True
5294,2011-08-13,3,0,8,11,0,6,0,2,0.74,0.697,0.7,0.194,114,192,306,306,True
5295,2011-08-13,3,0,8,12,0,6,0,2,0.66,0.5909,0.89,0.1642,114,246,360,360,True
5296,2011-08-13,3,0,8,13,0,6,0,2,0.74,0.7121,0.74,0.3284,61,92,153,153,True
5297,2011-08-13,3,0,8,14,0,6,0,1,0.74,0.697,0.7,0.2537,113,146,259,259,True
5298,2011-08-13,3,0,8,15,0,6,0,3,0.68,0.6364,0.79,0.3582,114,208,322,322,True
5299,2011-08-13,3,0,8,16,0,6,0,2,0.7,0.6667,0.74,0.2836,114,133,247,247,True
5300,2011-08-13,3,0,8,17,0,6,0,2,0.72,0.697,0.74,0.2537,97,172,269,269,True
5301,2011-08-13,3,0,8,18,0,6,0,1,0.7,0.6667,0.74,0.2239,114,169,283,283,True
5302,2011-08-13,3,0,8,19,0,6,0,2,0.68,0.6364,0.79,0.2836,67,170,237,237,True
5303,2011-08-13,3,0,8,20,0,6,0,2,0.68,0.6364,0.83,0.2239,78,105,183,183,True
5304,2011-08-13,3,0,8,21,0,6,0,2,0.68,0.6364,0.83,0.3881,40,127,167,167,True
5305,2011-08-13,3,0,8,22,0,6,0,2,0.68,0.6364,0.83,0.3881,36,118,154,154,True
5306,2011-08-13,3,0,8,23,0,6,0,2,0.66,0.6061,0.83,0.3284,25,95,120,120,True
5307,2011-08-14,3,0,8,0,0,0,0,3,0.66,0.6061,0.83,0.2985,19,71,90,90,True
5308,2011-08-14,3,0,8,1,0,0,0,3,0.64,0.5758,0.89,0.2239,16,57,73,73,True
5309,2011-08-14,3,0,8,2,0,0,0,3,0.64,0.5758,0.89,0.2239,13,49,62,62,True
5310,2011-08-14,3,0,8,3,0,0,0,2,0.64,0.5606,0.94,0.2537,5,22,27,27,True
5311,2011-08-14,3,0,8,4,0,0,0,3,0.64,0.5606,0.94,0.194,1,2,3,3,True
5312,2011-08-14,3,0,8,5,0,0,0,2,0.64,0.5606,0.94,0.1642,1,9,10,10,True
5313,2011-08-14,3,0,8,6,0,0,0,2,0.64,0.5606,0.94,0.1045,2,4,6,6,True
5314,2011-08-14,3,0,8,7,0,0,0,2,0.66,0.5909,0.89,0.194,4,20,24,24,True
5315,2011-08-14,3,0,8,8,0,0,0,2,0.66,0.5909,0.89,0.2836,20,21,41,41,True
5316,2011-08-14,3,0,8,9,0,0,0,3,0.66,0.5909,0.89,0.2836,27,76,103,103,True
5317,2011-08-14,3,0,8,10,0,0,0,1,0.7,0.6667,0.79,0.2239,67,116,183,183,True
5318,2011-08-14,3,0,8,11,0,0,0,1,0.7,0.6667,0.79,0.194,81,117,198,198,True
5319,2011-08-14,3,0,8,12,0,0,0,2,0.7,0.6667,0.79,0.2239,98,183,281,281,True
5320,2011-08-14,3,0,8,13,0,0,0,1,0.72,0.697,0.74,0.2537,114,233,347,347,True
5321,2011-08-14,3,0,8,14,0,0,0,1,0.74,0.697,0.7,0.194,114,244,358,358,True
5322,2011-08-14,3,0,8,15,0,0,0,1,0.74,0.697,0.66,0.194,114,203,317,317,True
5323,2011-08-14,3,0,8,16,0,0,0,1,0.74,0.697,0.66,0.1642,114,176,290,290,True
5324,2011-08-14,3,0,8,17,0,0,0,1,0.76,0.7121,0.62,0.1343,114,196,310,310,True
5325,2011-08-14,3,0,8,18,0,0,0,1,0.74,0.697,0.66,0.1642,114,222,336,336,True
5326,2011-08-14,3,0,8,19,0,0,0,1,0.72,0.697,0.74,0.2239,75,184,259,259,True
5327,2011-08-14,3,0,8,20,0,0,0,1,0.7,0.6667,0.84,0.1642,67,126,193,193,True
5328,2011-08-14,3,0,8,21,0,0,0,3,0.6,0.5455,0.88,0.4775,51,104,155,155,True
5329,2011-08-14,3,0,8,22,0,0,0,3,0.6,0.5455,0.88,0.4775,14,25,39,39,True
5330,2011-08-14,3,0,8,23,0,0,0,3,0.6,0.5606,0.83,0.0,5,22,27,27,True
5331,2011-08-15,3,0,8,0,0,1,1,3,0.6,0.5455,0.88,0.0896,7,18,25,25,True
5332,2011-08-15,3,0,8,1,0,1,1,2,0.6,0.5455,0.88,0.1343,1,9,10,10,True
5333,2011-08-15,3,0,8,2,0,1,1,2,0.6,0.5606,0.83,0.0,0,3,3,3,True
5334,2011-08-15,3,0,8,3,0,1,1,1,0.6,0.5606,0.83,0.194,1,6,7,7,True
5335,2011-08-15,3,0,8,4,0,1,1,1,0.6,0.5606,0.83,0.1343,1,4,5,5,True
5336,2011-08-15,3,0,8,5,0,1,1,2,0.6,0.5455,0.88,0.194,3,14,17,17,True
5337,2011-08-15,3,0,8,6,0,1,1,1,0.6,0.5455,0.88,0.2537,3,87,90,90,True
5338,2011-08-15,3,0,8,7,0,1,1,1,0.6,0.5455,0.88,0.2537,10,248,258,258,True
5339,2011-08-15,3,0,8,8,0,1,1,1,0.64,0.5909,0.78,0.3284,29,326,355,355,True
5340,2011-08-15,3,0,8,9,0,1,1,1,0.64,0.5909,0.78,0.3284,52,170,222,222,True
5341,2011-08-15,3,0,8,10,0,1,1,1,0.68,0.6364,0.69,0.2836,54,87,141,141,True
5342,2011-08-15,3,0,8,11,0,1,1,2,0.72,0.6818,0.62,0.2537,41,112,153,153,True
5343,2011-08-15,3,0,8,12,0,1,1,1,0.74,0.6818,0.58,0.2836,62,116,178,178,True
5344,2011-08-15,3,0,8,13,0,1,1,1,0.78,0.7121,0.52,0.2836,53,140,193,193,True
5345,2011-08-15,3,0,8,14,0,1,1,1,0.74,0.6818,0.55,0.0896,56,95,151,151,True
5346,2011-08-15,3,0,8,15,0,1,1,3,0.74,0.6818,0.55,0.2985,49,133,182,182,True
5347,2011-08-15,3,0,8,16,0,1,1,1,0.74,0.6818,0.55,0.3284,58,225,283,283,True
5348,2011-08-15,3,0,8,17,0,1,1,1,0.74,0.6667,0.51,0.2836,59,471,530,530,True
5349,2011-08-15,3,0,8,18,0,1,1,1,0.7,0.6515,0.65,0.194,70,413,483,483,True
5350,2011-08-15,3,0,8,19,0,1,1,1,0.7,0.6515,0.65,0.0,54,343,397,397,True
5351,2011-08-15,3,0,8,20,0,1,1,1,0.66,0.6212,0.74,0.1343,45,240,285,285,True
5352,2011-08-15,3,0,8,21,0,1,1,1,0.66,0.6212,0.65,0.194,34,150,184,184,True
5353,2011-08-15,3,0,8,22,0,1,1,1,0.66,0.6212,0.69,0.2537,22,76,98,98,True
5354,2011-08-15,3,0,8,23,0,1,1,1,0.64,0.6061,0.69,0.2239,11,77,88,88,True
5355,2011-08-16,3,0,8,0,0,2,1,1,0.64,0.6061,0.69,0.1045,8,23,31,31,True
5356,2011-08-16,3,0,8,1,0,2,1,1,0.64,0.6061,0.69,0.1642,4,12,16,16,True
5357,2011-08-16,3,0,8,2,0,2,1,1,0.62,0.5909,0.73,0.2239,1,3,4,4,True
5358,2011-08-16,3,0,8,3,0,2,1,1,0.62,0.5909,0.73,0.2239,1,5,6,6,True
5359,2011-08-16,3,0,8,4,0,2,1,1,0.64,0.6061,0.69,0.2985,0,5,5,5,True
5360,2011-08-16,3,0,8,5,0,2,1,1,0.62,0.5909,0.73,0.2836,1,29,30,30,True
5361,2011-08-16,3,0,8,6,0,2,1,1,0.62,0.5909,0.73,0.3284,4,115,119,119,True
5362,2011-08-16,3,0,8,7,0,2,1,1,0.64,0.6061,0.69,0.2537,18,328,346,346,True
5363,2011-08-16,3,0,8,8,0,2,1,1,0.7,0.6515,0.58,0.4478,24,417,441,441,True
5364,2011-08-16,3,0,8,9,0,2,1,1,0.68,0.6364,0.61,0.2836,27,171,198,198,True
5365,2011-08-16,3,0,8,10,0,2,1,1,0.7,0.6515,0.58,0.3881,28,83,111,111,True
5366,2011-08-16,3,0,8,11,0,2,1,1,0.74,0.6667,0.51,0.2239,40,110,150,150,True
5367,2011-08-16,3,0,8,12,0,2,1,1,0.76,0.6818,0.48,0.3284,42,120,162,162,True
5368,2011-08-16,3,0,8,13,0,2,1,1,0.76,0.6818,0.48,0.2985,45,147,192,192,True
5369,2011-08-16,3,0,8,14,0,2,1,1,0.76,0.6818,0.45,0.4179,65,117,182,182,True
5370,2011-08-16,3,0,8,15,0,2,1,1,0.8,0.7121,0.41,0.2985,36,123,159,159,True
5371,2011-08-16,3,0,8,16,0,2,1,1,0.8,0.7121,0.41,0.2239,55,248,303,303,True
5372,2011-08-16,3,0,8,17,0,2,1,1,0.76,0.6818,0.45,0.3284,75,499,574,574,True
5373,2011-08-16,3,0,8,18,0,2,1,1,0.76,0.6818,0.45,0.2239,54,499,553,553,True
5374,2011-08-16,3,0,8,19,0,2,1,1,0.74,0.6667,0.48,0.194,56,320,376,376,True
5375,2011-08-16,3,0,8,20,0,2,1,1,0.74,0.6667,0.51,0.0,48,232,280,280,True
5376,2011-08-16,3,0,8,21,0,2,1,1,0.72,0.6667,0.54,0.0,38,177,215,215,True
5377,2011-08-16,3,0,8,22,0,2,1,1,0.7,0.6515,0.61,0.0,31,121,152,152,True
5378,2011-08-16,3,0,8,23,0,2,1,1,0.66,0.6212,0.65,0.1343,20,57,77,77,True
5379,2011-08-17,3,0,8,0,0,3,1,1,0.66,0.6212,0.69,0.0896,8,16,24,24,True
5380,2011-08-17,3,0,8,1,0,3,1,1,0.64,0.6061,0.73,0.1642,2,12,14,14,True
5381,2011-08-17,3,0,8,2,0,3,1,1,0.66,0.6212,0.69,0.0,0,6,6,6,True
5382,2011-08-17,3,0,8,3,0,3,1,1,0.64,0.5909,0.78,0.0,1,4,5,5,True
5383,2011-08-17,3,0,8,4,0,3,1,1,0.64,0.6061,0.73,0.0,0,5,5,5,True
5384,2011-08-17,3,0,8,5,0,3,1,1,0.64,0.6061,0.73,0.0,0,28,28,28,True
5385,2011-08-17,3,0,8,6,0,3,1,1,0.62,0.5909,0.78,0.0,4,101,105,105,True
5386,2011-08-17,3,0,8,7,0,3,1,1,0.66,0.6212,0.65,0.0896,12,296,308,308,True
5387,2011-08-17,3,0,8,8,0,3,1,1,0.7,0.6515,0.54,0.1642,35,452,487,487,True
5388,2011-08-17,3,0,8,9,0,3,1,1,0.74,0.6667,0.48,0.0896,31,178,209,209,True
5389,2011-08-17,3,0,8,10,0,3,1,1,0.76,0.6818,0.43,0.0896,27,91,118,118,True
5390,2011-08-17,3,0,8,11,0,3,1,1,0.78,0.697,0.43,0.1045,20,108,128,128,True
5391,2011-08-17,3,0,8,12,0,3,1,1,0.8,0.7273,0.43,0.2836,26,163,189,189,True
5392,2011-08-17,3,0,8,13,0,3,1,1,0.8,0.7121,0.41,0.194,38,138,176,176,True
5393,2011-08-17,3,0,8,14,0,3,1,1,0.82,0.7273,0.36,0.1642,54,138,192,192,True
5394,2011-08-17,3,0,8,15,0,3,1,1,0.8,0.7273,0.43,0.1343,42,117,159,159,True
5395,2011-08-17,3,0,8,16,0,3,1,1,0.82,0.7424,0.43,0.2239,62,238,300,300,True
5396,2011-08-17,3,0,8,17,0,3,1,1,0.8,0.7424,0.49,0.2239,46,499,545,545,True
5397,2011-08-17,3,0,8,18,0,3,1,1,0.76,0.697,0.55,0.2537,86,470,556,556,True
5398,2011-08-17,3,0,8,19,0,3,1,1,0.76,0.697,0.55,0.2239,50,297,347,347,True
5399,2011-08-17,3,0,8,20,0,3,1,1,0.74,0.6818,0.58,0.2537,37,243,280,280,True
5400,2011-08-17,3,0,8,21,0,3,1,1,0.72,0.6818,0.62,0.2239,38,192,230,230,True
5401,2011-08-17,3,0,8,22,0,3,1,1,0.7,0.6515,0.65,0.194,29,142,171,171,True
5402,2011-08-17,3,0,8,23,0,3,1,1,0.7,0.6515,0.65,0.2836,20,85,105,105,True
5403,2011-08-18,3,0,8,0,0,4,1,1,0.68,0.6364,0.65,0.1343,18,38,56,56,True
5404,2011-08-18,3,0,8,1,0,4,1,2,0.66,0.6212,0.65,0.1642,13,11,24,24,True
5405,2011-08-18,3,0,8,2,0,4,1,1,0.66,0.6212,0.65,0.2239,2,4,6,6,True
5406,2011-08-18,3,0,8,3,0,4,1,1,0.66,0.6212,0.69,0.2836,0,6,6,6,True
5407,2011-08-18,3,0,8,4,0,4,1,1,0.64,0.6061,0.73,0.2239,0,9,9,9,True
5408,2011-08-18,3,0,8,5,0,4,1,1,0.64,0.5909,0.78,0.2836,0,27,27,27,True
5409,2011-08-18,3,0,8,6,0,4,1,2,0.64,0.5909,0.78,0.2537,6,97,103,103,True
5410,2011-08-18,3,0,8,7,0,4,1,1,0.64,0.5909,0.78,0.2985,19,289,308,308,True
5411,2011-08-18,3,0,8,8,0,4,1,1,0.66,0.6212,0.74,0.2836,27,393,420,420,True
5412,2011-08-18,3,0,8,9,0,4,1,1,0.72,0.6818,0.66,0.2537,42,186,228,228,True
5413,2011-08-18,3,0,8,10,0,4,1,1,0.74,0.697,0.66,0.2537,37,92,129,129,True
5414,2011-08-18,3,0,8,11,0,4,1,1,0.76,0.7121,0.58,0.2537,44,97,141,141,True
5415,2011-08-18,3,0,8,12,0,4,1,1,0.8,0.7424,0.52,0.2836,34,139,173,173,True
5416,2011-08-18,3,0,8,13,0,4,1,1,0.8,0.7424,0.52,0.3582,33,154,187,187,True
5417,2011-08-18,3,0,8,14,0,4,1,1,0.82,0.7576,0.46,0.3284,67,115,182,182,True
5418,2011-08-18,3,0,8,15,0,4,1,1,0.8,0.7273,0.46,0.3582,56,118,174,174,True
5419,2011-08-18,3,0,8,16,0,4,1,1,0.8,0.7273,0.46,0.3582,49,196,245,245,True
5420,2011-08-18,3,0,8,17,0,4,1,3,0.8,0.7273,0.46,0.2985,44,365,409,409,True
5421,2011-08-18,3,0,8,18,0,4,1,3,0.76,0.697,0.55,0.2537,48,226,274,274,True
5422,2011-08-18,3,0,8,19,0,4,1,1,0.66,0.6061,0.83,0.1045,26,115,141,141,True
5423,2011-08-18,3,0,8,20,0,4,1,1,0.66,0.6061,0.83,0.1045,24,141,165,165,True
5424,2011-08-18,3,0,8,21,0,4,1,2,0.68,0.6364,0.79,0.0,12,137,149,149,True
5425,2011-08-18,3,0,8,22,0,4,1,2,0.7,0.6667,0.74,0.1045,18,117,135,135,True
5426,2011-08-18,3,0,8,23,0,4,1,2,0.7,0.6667,0.74,0.1343,20,94,114,114,True
5427,2011-08-19,3,0,8,0,0,5,1,3,0.68,0.6364,0.69,0.194,9,53,62,62,True
5428,2011-08-19,3,0,8,1,0,5,1,3,0.64,0.5758,0.89,0.0,1,19,20,20,True
5429,2011-08-19,3,0,8,2,0,5,1,3,0.64,0.5758,0.83,0.0,0,8,8,8,True
5430,2011-08-19,3,0,8,3,0,5,1,1,0.64,0.5909,0.78,0.0,2,1,3,3,True
5431,2011-08-19,3,0,8,4,0,5,1,1,0.64,0.5758,0.83,0.0,1,7,8,8,True
5432,2011-08-19,3,0,8,5,0,5,1,1,0.64,0.5758,0.83,0.0,1,16,17,17,True
5433,2011-08-19,3,0,8,6,0,5,1,1,0.64,0.5758,0.83,0.0,2,91,93,93,True
5434,2011-08-19,3,0,8,7,0,5,1,2,0.66,0.6061,0.83,0.0896,12,251,263,263,True
5435,2011-08-19,3,0,8,8,0,5,1,2,0.66,0.6061,0.83,0.0,30,368,398,398,True
5436,2011-08-19,3,0,8,9,0,5,1,1,0.7,0.6515,0.65,0.1343,31,187,218,218,True
5437,2011-08-19,3,0,8,10,0,5,1,1,0.72,0.6818,0.62,0.0896,57,108,165,165,True
5438,2011-08-19,3,0,8,11,0,5,1,2,0.72,0.6818,0.66,0.0896,45,120,165,165,True
5439,2011-08-19,3,0,8,12,0,5,1,2,0.74,0.6818,0.62,0.0896,54,168,222,222,True
5440,2011-08-19,3,0,8,13,0,5,1,2,0.76,0.7121,0.62,0.194,63,169,232,232,True
5441,2011-08-19,3,0,8,14,0,5,1,1,0.78,0.7273,0.55,0.194,78,142,220,220,True
5442,2011-08-19,3,0,8,15,0,5,1,1,0.8,0.7424,0.49,0.1045,66,156,222,222,True
5443,2011-08-19,3,0,8,16,0,5,1,1,0.8,0.7424,0.49,0.0,66,261,327,327,True
5444,2011-08-19,3,0,8,17,0,5,1,1,0.76,0.7121,0.58,0.4775,85,442,527,527,True
5445,2011-08-19,3,0,8,18,0,5,1,1,0.76,0.7121,0.58,0.4775,88,337,425,425,True
5446,2011-08-19,3,0,8,19,0,5,1,3,0.62,0.5909,0.73,0.4627,33,132,165,165,True
5447,2011-08-19,3,0,8,20,0,5,1,3,0.62,0.5758,0.83,0.2985,12,46,58,58,True
5448,2011-08-19,3,0,8,21,0,5,1,1,0.62,0.5758,0.83,0.1343,18,89,107,107,True
5449,2011-08-19,3,0,8,22,0,5,1,1,0.6,0.5455,0.88,0.1343,25,97,122,122,True
5450,2011-08-19,3,0,8,23,0,5,1,2,0.6,0.5455,0.88,0.0896,18,88,106,106,True
5451,2011-08-20,3,0,8,0,0,6,0,1,0.6,0.5455,0.88,0.0,21,107,128,128,True
5452,2011-08-20,3,0,8,1,0,6,0,1,0.62,0.5758,0.83,0.0,12,35,47,47,True
5453,2011-08-20,3,0,8,2,0,6,0,1,0.62,0.5909,0.78,0.0,10,59,69,69,True
5454,2011-08-20,3,0,8,3,0,6,0,1,0.62,0.5909,0.78,0.0,9,42,51,51,True
5455,2011-08-20,3,0,8,4,0,6,0,2,0.6,0.5455,0.88,0.0,1,6,7,7,True
5456,2011-08-20,3,0,8,5,0,6,0,1,0.6,0.5606,0.83,0.0,0,8,8,8,True
5457,2011-08-20,3,0,8,6,0,6,0,2,0.6,0.5606,0.83,0.1343,6,18,24,24,True
5458,2011-08-20,3,0,8,7,0,6,0,1,0.62,0.5758,0.83,0.0,8,36,44,44,True
5459,2011-08-20,3,0,8,8,0,6,0,1,0.66,0.6212,0.69,0.0,27,106,133,133,True
5460,2011-08-20,3,0,8,9,0,6,0,1,0.7,0.6515,0.65,0.0,51,139,190,190,True
5461,2011-08-20,3,0,8,10,0,6,0,1,0.72,0.6818,0.62,0.1045,114,192,306,306,True
5462,2011-08-20,3,0,8,11,0,6,0,1,0.72,0.6667,0.58,0.0,114,223,337,337,True
5463,2011-08-20,3,0,8,12,0,6,0,1,0.74,0.6818,0.58,0.1343,114,253,367,367,True
5464,2011-08-20,3,0,8,13,0,6,0,1,0.76,0.697,0.55,0.1343,114,220,334,334,True
5465,2011-08-20,3,0,8,14,0,6,0,1,0.8,0.7424,0.49,0.194,114,228,342,342,True
5466,2011-08-20,3,0,8,15,0,6,0,1,0.8,0.7273,0.43,0.194,114,215,329,329,True
5467,2011-08-20,3,0,8,16,0,6,0,1,0.8,0.7273,0.46,0.194,114,222,336,336,True
5468,2011-08-20,3,0,8,17,0,6,0,1,0.8,0.7424,0.49,0.194,114,203,317,317,True
5469,2011-08-20,3,0,8,18,0,6,0,1,0.76,0.7121,0.58,0.2537,114,225,339,339,True
5470,2011-08-20,3,0,8,19,0,6,0,1,0.74,0.6818,0.62,0.194,109,182,291,291,True
5471,2011-08-20,3,0,8,20,0,6,0,1,0.74,0.6818,0.62,0.2239,78,170,248,248,True
5472,2011-08-20,3,0,8,21,0,6,0,1,0.72,0.6818,0.7,0.2239,81,144,225,225,True
5473,2011-08-20,3,0,8,22,0,6,0,2,0.7,0.6667,0.74,0.194,77,146,223,223,True
5474,2011-08-20,3,0,8,23,0,6,0,1,0.7,0.6667,0.74,0.1343,59,98,157,157,True
5475,2011-08-21,3,0,8,0,0,0,0,1,0.7,0.6667,0.74,0.194,6,68,74,74,True
5476,2011-08-21,3,0,8,1,0,0,0,1,0.68,0.6364,0.79,0.2239,17,69,86,86,True
5477,2011-08-21,3,0,8,2,0,0,0,1,0.68,0.6364,0.79,0.194,13,51,64,64,True
5478,2011-08-21,3,0,8,3,0,0,0,1,0.66,0.6061,0.83,0.2239,25,26,51,51,True
5479,2011-08-21,3,0,8,4,0,0,0,1,0.68,0.6364,0.83,0.2239,1,5,6,6,True
5480,2011-08-21,3,0,8,5,0,0,0,1,0.66,0.5909,0.89,0.2985,0,8,8,8,True
5481,2011-08-21,3,0,8,6,0,0,0,1,0.66,0.5909,0.89,0.2836,4,10,14,14,True
5482,2011-08-21,3,0,8,7,0,0,0,1,0.68,0.6364,0.83,0.2985,12,19,31,31,True
5483,2011-08-21,3,0,8,8,0,0,0,1,0.7,0.6667,0.79,0.2239,30,62,92,92,True
5484,2011-08-21,3,0,8,9,0,0,0,1,0.72,0.697,0.74,0.2239,80,151,231,231,True
5485,2011-08-21,3,0,8,10,0,0,0,1,0.74,0.7121,0.74,0.2537,97,177,274,274,True
5486,2011-08-21,3,0,8,11,0,0,0,1,0.8,0.7879,0.63,0.2836,114,181,295,295,True
5487,2011-08-21,3,0,8,12,0,0,0,1,0.82,0.803,0.59,0.2836,114,239,353,353,True
5488,2011-08-21,3,0,8,13,0,0,0,1,0.8,0.7727,0.59,0.4179,94,216,310,310,True
5489,2011-08-21,3,0,8,14,0,0,0,3,0.7,0.6667,0.79,0.3881,78,157,235,235,True
5490,2011-08-21,3,0,8,15,0,0,0,1,0.7,0.6667,0.84,0.2836,17,51,68,68,True
5491,2011-08-21,3,0,8,16,0,0,0,1,0.72,0.697,0.79,0.1642,97,161,258,258,True
5492,2011-08-21,3,0,8,17,0,0,0,1,0.72,0.697,0.79,0.1343,91,179,270,270,True
5493,2011-08-21,3,0,8,18,0,0,0,1,0.72,0.697,0.79,0.2537,96,215,311,311,True
5494,2011-08-21,3,0,8,19,0,0,0,1,0.72,0.6818,0.7,0.2537,81,201,282,282,True
5495,2011-08-21,3,0,8,20,0,0,0,1,0.7,0.6667,0.79,0.2537,41,140,181,181,True
5496,2011-08-21,3,0,8,21,0,0,0,1,0.7,0.6667,0.79,0.2537,45,93,138,138,True
5497,2011-08-21,3,0,8,22,0,0,0,2,0.7,0.6667,0.79,0.194,37,97,134,134,True
5498,2011-08-21,3,0,8,23,0,0,0,1,0.7,0.6667,0.74,0.1642,20,48,68,68,True
5499,2011-08-22,3,0,8,0,0,1,1,1,0.68,0.6364,0.79,0.1642,18,22,40,40,True
5500,2011-08-22,3,0,8,1,0,1,1,1,0.68,0.6364,0.79,0.0896,8,13,21,21,True
5501,2011-08-22,3,0,8,2,0,1,1,2,0.7,0.6515,0.65,0.1045,2,6,8,8,True
5502,2011-08-22,3,0,8,3,0,1,1,3,0.7,0.6515,0.65,0.1343,0,5,5,5,True
5503,2011-08-22,3,0,8,4,0,1,1,1,0.68,0.6364,0.65,0.194,2,10,12,12,True
5504,2011-08-22,3,0,8,5,0,1,1,1,0.66,0.6212,0.65,0.3582,1,23,24,24,True
5505,2011-08-22,3,0,8,6,0,1,1,1,0.66,0.6212,0.61,0.2985,6,106,112,112,True
5506,2011-08-22,3,0,8,7,0,1,1,1,0.66,0.6212,0.61,0.3284,11,270,281,281,True
5507,2011-08-22,3,0,8,8,0,1,1,1,0.66,0.6212,0.61,0.3284,20,331,351,351,True
5508,2011-08-22,3,0,8,9,0,1,1,1,0.68,0.6364,0.54,0.2537,36,151,187,187,True
5509,2011-08-22,3,0,8,10,0,1,1,1,0.7,0.6515,0.48,0.2836,36,85,121,121,True
5510,2011-08-22,3,0,8,11,0,1,1,1,0.72,0.6515,0.34,0.3284,46,85,131,131,True
5511,2011-08-22,3,0,8,12,0,1,1,1,0.74,0.6515,0.35,0.3881,54,153,207,207,True
5512,2011-08-22,3,0,8,13,0,1,1,1,0.74,0.6515,0.3,0.4627,47,158,205,205,True
5513,2011-08-22,3,0,8,14,0,1,1,1,0.74,0.6515,0.3,0.3881,88,137,225,225,True
5514,2011-08-22,3,0,8,15,0,1,1,1,0.74,0.6515,0.3,0.2985,72,127,199,199,True
5515,2011-08-22,3,0,8,16,0,1,1,1,0.74,0.6515,0.3,0.3881,66,254,320,320,True
5516,2011-08-22,3,0,8,17,0,1,1,1,0.74,0.6515,0.27,0.3284,82,499,581,581,True
5517,2011-08-22,3,0,8,18,0,1,1,1,0.72,0.6515,0.28,0.2985,72,499,571,571,True
5518,2011-08-22,3,0,8,19,0,1,1,1,0.7,0.6364,0.3,0.2836,66,350,416,416,True
5519,2011-08-22,3,0,8,20,0,1,1,1,0.66,0.6212,0.34,0.194,21,247,268,268,True
5520,2011-08-22,3,0,8,21,0,1,1,1,0.64,0.6212,0.38,0.194,28,180,208,208,True
5521,2011-08-22,3,0,8,22,0,1,1,1,0.64,0.6212,0.38,0.2985,32,121,153,153,True
5522,2011-08-22,3,0,8,23,0,1,1,1,0.62,0.6212,0.41,0.2537,19,45,64,64,True
5523,2011-08-23,3,0,8,0,0,2,1,1,0.6,0.6212,0.43,0.194,13,22,35,35,True
5524,2011-08-23,3,0,8,1,0,2,1,1,0.58,0.5455,0.49,0.194,6,13,19,19,True
5525,2011-08-23,3,0,8,2,0,2,1,1,0.56,0.5303,0.52,0.194,2,4,6,6,True
5526,2011-08-23,3,0,8,3,0,2,1,1,0.56,0.5303,0.52,0.2836,2,4,6,6,True
5527,2011-08-23,3,0,8,4,0,2,1,1,0.54,0.5152,0.56,0.1642,0,5,5,5,True
5528,2011-08-23,3,0,8,5,0,2,1,1,0.54,0.5152,0.56,0.194,1,35,36,36,True
5529,2011-08-23,3,0,8,6,0,2,1,1,0.54,0.5152,0.6,0.194,3,111,114,114,True
5530,2011-08-23,3,0,8,7,0,2,1,1,0.6,0.6212,0.49,0.194,11,333,344,344,True
5531,2011-08-23,3,0,8,8,0,2,1,2,0.62,0.6212,0.5,0.0,43,461,504,504,True
5532,2011-08-23,3,0,8,9,0,2,1,2,0.66,0.6212,0.44,0.0,34,191,225,225,True
5533,2011-08-23,3,0,8,10,0,2,1,1,0.7,0.6364,0.37,0.0,56,92,148,148,True
5534,2011-08-23,3,0,8,11,0,2,1,1,0.7,0.6364,0.34,0.1045,62,124,186,186,True
5535,2011-08-23,3,0,8,12,0,2,1,1,0.7,0.6364,0.39,0.0896,60,177,237,237,True
5536,2011-08-23,3,0,8,13,0,2,1,1,0.72,0.6515,0.3,0.1045,70,164,234,234,True
5537,2011-08-23,3,0,8,14,0,2,1,1,0.72,0.6515,0.3,0.0896,114,499,613,613,True
5538,2011-08-23,3,0,8,15,0,2,1,1,0.72,0.6515,0.34,0.2239,114,423,537,537,True
5539,2011-08-23,3,0,8,16,0,2,1,1,0.72,0.6515,0.32,0.1343,114,311,425,425,True
5540,2011-08-23,3,0,8,17,0,2,1,1,0.72,0.6515,0.34,0.2239,114,339,453,453,True
5541,2011-08-23,3,0,8,18,0,2,1,1,0.72,0.6515,0.34,0.194,98,421,519,519,True
5542,2011-08-23,3,0,8,19,0,2,1,1,0.66,0.6212,0.5,0.2239,70,297,367,367,True
5543,2011-08-23,3,0,8,20,0,2,1,1,0.64,0.6212,0.53,0.2537,54,206,260,260,True
5544,2011-08-23,3,0,8,21,0,2,1,1,0.62,0.6212,0.57,0.0,38,173,211,211,True
5545,2011-08-23,3,0,8,22,0,2,1,1,0.62,0.6212,0.57,0.1343,46,145,191,191,True
5546,2011-08-23,3,0,8,23,0,2,1,1,0.62,0.6061,0.61,0.1343,19,61,80,80,True
5547,2011-08-24,3,0,8,0,0,3,1,1,0.62,0.6212,0.57,0.1343,9,29,38,38,True
5548,2011-08-24,3,0,8,1,0,3,1,1,0.6,0.6061,0.6,0.1045,7,17,24,24,True
5549,2011-08-24,3,0,8,2,0,3,1,1,0.58,0.5455,0.68,0.1343,2,4,6,6,True
5550,2011-08-24,3,0,8,3,0,3,1,1,0.58,0.5455,0.68,0.1343,0,1,1,1,True
5551,2011-08-24,3,0,8,4,0,3,1,1,0.56,0.5303,0.73,0.1045,0,7,7,7,True
5552,2011-08-24,3,0,8,5,0,3,1,1,0.56,0.5303,0.73,0.1045,1,26,27,27,True
5553,2011-08-24,3,0,8,6,0,3,1,1,0.56,0.5303,0.73,0.0,3,105,108,108,True
5554,2011-08-24,3,0,8,7,0,3,1,1,0.6,0.6061,0.64,0.0896,11,297,308,308,True
5555,2011-08-24,3,0,8,8,0,3,1,1,0.62,0.6061,0.69,0.1343,32,436,468,468,True
5556,2011-08-24,3,0,8,9,0,3,1,1,0.64,0.6061,0.69,0.2537,44,169,213,213,True
5557,2011-08-24,3,0,8,10,0,3,1,1,0.7,0.6515,0.58,0.2836,51,95,146,146,True
5558,2011-08-24,3,0,8,11,0,3,1,1,0.72,0.6667,0.54,0.2985,57,128,185,185,True
5559,2011-08-24,3,0,8,12,0,3,1,1,0.74,0.6818,0.55,0.3284,60,175,235,235,True
5560,2011-08-24,3,0,8,13,0,3,1,1,0.76,0.6818,0.48,0.4179,56,180,236,236,True
5561,2011-08-24,3,0,8,14,0,3,1,1,0.76,0.6818,0.48,0.4179,77,127,204,204,True
5562,2011-08-24,3,0,8,15,0,3,1,1,0.76,0.6818,0.48,0.4478,63,141,204,204,True
5563,2011-08-24,3,0,8,16,0,3,1,1,0.76,0.697,0.52,0.4179,49,222,271,271,True
5564,2011-08-24,3,0,8,17,0,3,1,1,0.76,0.697,0.52,0.3582,83,484,567,567,True
5565,2011-08-24,3,0,8,18,0,3,1,1,0.74,0.6818,0.55,0.2985,102,499,601,601,True
5566,2011-08-24,3,0,8,19,0,3,1,1,0.74,0.6818,0.55,0.2985,93,347,440,440,True
5567,2011-08-24,3,0,8,20,0,3,1,1,0.72,0.6667,0.58,0.2985,45,289,334,334,True
5568,2011-08-24,3,0,8,21,0,3,1,1,0.7,0.6515,0.61,0.3582,47,189,236,236,True
5569,2011-08-24,3,0,8,22,0,3,1,1,0.7,0.6515,0.65,0.3582,41,140,181,181,True
5570,2011-08-24,3,0,8,23,0,3,1,1,0.68,0.6364,0.69,0.2985,16,54,70,70,True
5571,2011-08-25,3,0,8,0,0,4,1,1,0.68,0.6364,0.74,0.2985,11,41,52,52,True
5572,2011-08-25,3,0,8,1,0,4,1,1,0.68,0.6364,0.69,0.3881,4,11,15,15,True
5573,2011-08-25,3,0,8,2,0,4,1,1,0.68,0.6364,0.69,0.3881,3,2,5,5,True
5574,2011-08-25,3,0,8,3,0,4,1,1,0.66,0.6212,0.74,0.3284,2,2,4,4,True
5575,2011-08-25,3,0,8,4,0,4,1,1,0.66,0.6061,0.78,0.3881,1,6,7,7,True
5576,2011-08-25,3,0,8,5,0,4,1,1,0.66,0.6061,0.83,0.4179,1,25,26,26,True
5577,2011-08-25,3,0,8,6,0,4,1,1,0.66,0.6061,0.83,0.3284,1,101,102,102,True
5578,2011-08-25,3,0,8,7,0,4,1,2,0.68,0.6364,0.79,0.3284,17,296,313,313,True
5579,2011-08-25,3,0,8,8,0,4,1,2,0.7,0.6667,0.74,0.2985,23,461,484,484,True
5580,2011-08-25,3,0,8,9,0,4,1,2,0.72,0.6818,0.7,0.2985,21,141,162,162,True
5581,2011-08-25,3,0,8,10,0,4,1,2,0.74,0.697,0.66,0.2985,37,105,142,142,True
5582,2011-08-25,3,0,8,11,0,4,1,3,0.7,0.6667,0.79,0.0,39,112,151,151,True
5583,2011-08-25,3,0,8,12,0,4,1,3,0.7,0.6667,0.79,0.0,9,32,41,41,True
5584,2011-08-25,3,0,8,13,0,4,1,1,0.7,0.6667,0.79,0.1045,7,30,37,37,True
5585,2011-08-25,3,0,8,14,0,4,1,2,0.72,0.697,0.74,0.0,27,86,113,113,True
5586,2011-08-25,3,0,8,15,0,4,1,2,0.74,0.697,0.7,0.0,28,104,132,132,True
5587,2011-08-25,3,0,8,16,0,4,1,1,0.72,0.7121,0.84,0.0,16,105,121,121,True
5588,2011-08-25,3,0,8,17,0,4,1,1,0.72,0.7121,0.84,0.0,28,284,312,312,True
5589,2011-08-25,3,0,8,18,0,4,1,2,0.72,0.7121,0.84,0.1343,31,377,408,408,True
5590,2011-08-25,3,0,8,19,0,4,1,2,0.66,0.6061,0.78,0.3284,31,241,272,272,True
5591,2011-08-25,3,0,8,20,0,4,1,1,0.64,0.5909,0.78,0.3582,33,192,225,225,True
5592,2011-08-25,3,0,8,21,0,4,1,1,0.64,0.5909,0.78,0.2836,29,158,187,187,True
5593,2011-08-25,3,0,8,22,0,4,1,1,0.62,0.5758,0.83,0.0,21,126,147,147,True
5594,2011-08-25,3,0,8,23,0,4,1,1,0.62,0.5758,0.83,0.0896,15,69,84,84,True
5595,2011-08-26,3,0,8,0,0,5,1,1,0.62,0.5758,0.83,0.1343,9,42,51,51,True
5596,2011-08-26,3,0,8,1,0,5,1,1,0.62,0.5758,0.83,0.0,10,13,23,23,True
5597,2011-08-26,3,0,8,2,0,5,1,1,0.62,0.5606,0.88,0.1343,4,16,20,20,True
5598,2011-08-26,3,0,8,3,0,5,1,1,0.6,0.5455,0.88,0.1045,3,8,11,11,True
5599,2011-08-26,3,0,8,4,0,5,1,1,0.62,0.5606,0.88,0.0,2,6,8,8,True
5600,2011-08-26,3,0,8,5,0,5,1,2,0.62,0.5606,0.88,0.0,3,23,26,26,True
5601,2011-08-26,3,0,8,6,0,5,1,1,0.62,0.5606,0.88,0.0,5,100,105,105,True
5602,2011-08-26,3,0,8,7,0,5,1,1,0.64,0.5758,0.83,0.0,3,263,266,266,True
5603,2011-08-26,3,0,8,8,0,5,1,1,0.66,0.6061,0.83,0.1045,17,387,404,404,True
5604,2011-08-26,3,0,8,9,0,5,1,1,0.7,0.6667,0.74,0.0,39,191,230,230,True
5605,2011-08-26,3,0,8,10,0,5,1,1,0.74,0.697,0.66,0.0896,34,89,123,123,True
5606,2011-08-26,3,0,8,11,0,5,1,2,0.76,0.7121,0.62,0.0,63,151,214,214,True
5607,2011-08-26,3,0,8,12,0,5,1,2,0.76,0.7273,0.66,0.1045,70,173,243,243,True
5608,2011-08-26,3,0,8,13,0,5,1,2,0.78,0.7424,0.59,0.1045,72,165,237,237,True
5609,2011-08-26,3,0,8,14,0,5,1,1,0.8,0.7727,0.59,0.0,55,164,219,219,True
5610,2011-08-26,3,0,8,15,0,5,1,2,0.8,0.7727,0.59,0.194,53,196,249,249,True
5611,2011-08-26,3,0,8,16,0,5,1,1,0.78,0.7424,0.62,0.1045,50,293,343,343,True
5612,2011-08-26,3,0,8,17,0,5,1,1,0.74,0.7121,0.74,0.2537,56,433,489,489,True
5613,2011-08-26,3,0,8,18,0,5,1,2,0.74,0.7121,0.74,0.1343,40,370,410,410,True
5614,2011-08-26,3,0,8,19,0,5,1,1,0.72,0.697,0.79,0.1045,55,235,290,290,True
5615,2011-08-26,3,0,8,20,0,5,1,1,0.72,0.697,0.79,0.0896,39,183,222,222,True
5616,2011-08-26,3,0,8,21,0,5,1,1,0.72,0.697,0.79,0.1642,38,152,190,190,True
5617,2011-08-26,3,0,8,22,0,5,1,1,0.72,0.697,0.79,0.1045,26,126,152,152,True
5618,2011-08-26,3,0,8,23,0,5,1,1,0.7,0.6667,0.84,0.0896,22,114,136,136,True
5619,2011-08-27,3,0,8,0,0,6,0,1,0.7,0.6667,0.84,0.1045,33,112,145,145,True
5620,2011-08-27,3,0,8,1,0,6,0,1,0.7,0.6667,0.84,0.1642,13,51,64,64,True
5621,2011-08-27,3,0,8,2,0,6,0,1,0.7,0.6667,0.84,0.194,18,59,77,77,True
5622,2011-08-27,3,0,8,3,0,6,0,2,0.7,0.6667,0.84,0.2239,8,22,30,30,True
5623,2011-08-27,3,0,8,4,0,6,0,2,0.7,0.6667,0.84,0.2239,1,3,4,4,True
5624,2011-08-27,3,0,8,5,0,6,0,2,0.7,0.6667,0.84,0.2985,1,11,12,12,True
5625,2011-08-27,3,0,8,6,0,6,0,2,0.7,0.6667,0.84,0.2985,3,15,18,18,True
5626,2011-08-27,3,0,8,7,0,6,0,2,0.7,0.6667,0.84,0.3582,2,26,28,28,True
5627,2011-08-27,3,0,8,8,0,6,0,2,0.7,0.6667,0.84,0.2537,14,62,76,76,True
5628,2011-08-27,3,0,8,9,0,6,0,2,0.7,0.6667,0.84,0.4179,28,128,156,156,True
5629,2011-08-27,3,0,8,10,0,6,0,2,0.7,0.6667,0.79,0.4627,51,154,205,205,True
5630,2011-08-27,3,0,8,11,0,6,0,3,0.66,0.5909,0.89,0.4179,15,73,88,88,True
5631,2011-08-27,3,0,8,12,0,6,0,3,0.66,0.6061,0.83,0.4775,11,65,76,76,True
5632,2011-08-27,3,0,8,13,0,6,0,3,0.66,0.6061,0.83,0.3881,10,33,43,43,True
5633,2011-08-27,3,0,8,14,0,6,0,3,0.64,0.5758,0.89,0.4775,4,19,23,23,True
5634,2011-08-27,3,0,8,15,0,6,0,3,0.64,0.5758,0.89,0.4775,2,28,30,30,True
5635,2011-08-27,3,0,8,16,0,6,0,3,0.64,0.5758,0.89,0.4775,10,14,24,24,True
5636,2011-08-27,3,0,8,17,0,6,0,3,0.64,0.5758,0.89,0.4775,2,14,16,16,True
5637,2011-08-28,3,0,8,7,0,0,0,3,0.62,0.5758,0.83,0.3582,0,1,1,1,True
5638,2011-08-28,3,0,8,8,0,0,0,3,0.62,0.5758,0.83,0.4179,2,6,8,8,True
5639,2011-08-28,3,0,8,9,0,0,0,1,0.66,0.6212,0.74,0.4179,7,46,53,53,True
5640,2011-08-28,3,0,8,10,0,0,0,1,0.7,0.6515,0.61,0.4775,27,115,142,142,True
5641,2011-08-28,3,0,8,11,0,0,0,1,0.7,0.6515,0.58,0.3881,59,178,237,237,True
5642,2011-08-28,3,0,8,12,0,0,0,1,0.74,0.6667,0.51,0.3881,88,218,306,306,True
5643,2011-08-28,3,0,8,13,0,0,0,1,0.76,0.6818,0.45,0.3582,114,302,416,416,True
5644,2011-08-28,3,0,8,14,0,0,0,1,0.78,0.697,0.43,0.4179,114,290,404,404,True
5645,2011-08-28,3,0,8,15,0,0,0,1,0.78,0.697,0.43,0.3582,114,314,428,428,True
5646,2011-08-28,3,0,8,16,0,0,0,1,0.8,0.7121,0.36,0.3881,114,295,409,409,True
5647,2011-08-28,3,0,8,17,0,0,0,1,0.76,0.6818,0.4,0.2985,114,253,367,367,True
5648,2011-08-28,3,0,8,18,0,0,0,1,0.74,0.6667,0.42,0.2239,114,257,371,371,True
5649,2011-08-28,3,0,8,19,0,0,0,1,0.72,0.6667,0.48,0.1045,114,247,361,361,True
5650,2011-08-28,3,0,8,20,0,0,0,1,0.72,0.6515,0.45,0.1045,64,150,214,214,True
5651,2011-08-28,3,0,8,21,0,0,0,1,0.66,0.6212,0.61,0.1343,60,126,186,186,True
5652,2011-08-28,3,0,8,22,0,0,0,1,0.64,0.6061,0.69,0.1045,25,73,98,98,True
5653,2011-08-28,3,0,8,23,0,0,0,1,0.62,0.5909,0.73,0.1045,16,48,64,64,True
5654,2011-08-29,3,0,8,0,0,1,1,1,0.62,0.5909,0.73,0.1045,13,21,34,34,True
5655,2011-08-29,3,0,8,1,0,1,1,1,0.6,0.5909,0.69,0.1045,5,15,20,20,True
5656,2011-08-29,3,0,8,2,0,1,1,1,0.6,0.5909,0.69,0.194,8,5,13,13,True
5657,2011-08-29,3,0,8,3,0,1,1,1,0.6,0.5909,0.69,0.1045,1,5,6,6,True
5658,2011-08-29,3,0,8,4,0,1,1,1,0.56,0.5303,0.68,0.1343,0,3,3,3,True
5659,2011-08-29,3,0,8,5,0,1,1,1,0.56,0.5303,0.73,0.1343,0,17,17,17,True
5660,2011-08-29,3,0,8,6,0,1,1,1,0.56,0.5303,0.73,0.1343,3,99,102,102,True
5661,2011-08-29,3,0,8,7,0,1,1,1,0.6,0.6061,0.6,0.2239,11,273,284,284,True
5662,2011-08-29,3,0,8,8,0,1,1,1,0.62,0.6212,0.57,0.2537,20,384,404,404,True
5663,2011-08-29,3,0,8,9,0,1,1,1,0.62,0.6212,0.53,0.2537,22,166,188,188,True
5664,2011-08-29,3,0,8,10,0,1,1,1,0.66,0.6212,0.47,0.2239,42,73,115,115,True
5665,2011-08-29,3,0,8,11,0,1,1,1,0.66,0.6212,0.47,0.1642,38,100,138,138,True
5666,2011-08-29,3,0,8,12,0,1,1,2,0.68,0.6364,0.44,0.1642,48,159,207,207,True
5667,2011-08-29,3,0,8,13,0,1,1,2,0.7,0.6364,0.39,0.0,48,170,218,218,True
5668,2011-08-29,3,0,8,14,0,1,1,1,0.7,0.6364,0.42,0.0,55,127,182,182,True
5669,2011-08-29,3,0,8,15,0,1,1,1,0.7,0.6364,0.42,0.1642,56,164,220,220,True
5670,2011-08-29,3,0,8,16,0,1,1,1,0.72,0.6515,0.42,0.1642,56,226,282,282,True
5671,2011-08-29,3,0,8,17,0,1,1,2,0.7,0.6364,0.47,0.2239,67,499,566,566,True
5672,2011-08-29,3,0,8,18,0,1,1,1,0.66,0.6212,0.47,0.2537,60,487,547,547,True
5673,2011-08-29,3,0,8,19,0,1,1,1,0.66,0.6212,0.47,0.2537,50,317,367,367,True
5674,2011-08-29,3,0,8,20,0,1,1,1,0.64,0.6212,0.53,0.1642,50,227,277,277,True
5675,2011-08-29,3,0,8,21,0,1,1,1,0.64,0.6212,0.53,0.194,34,168,202,202,True
5676,2011-08-29,3,0,8,22,0,1,1,1,0.62,0.6212,0.57,0.1343,23,119,142,142,True
5677,2011-08-29,3,0,8,23,0,1,1,1,0.6,0.6061,0.6,0.0896,19,56,75,75,True
5678,2011-08-30,3,0,8,0,0,2,1,1,0.56,0.5303,0.73,0.1343,10,17,27,27,True
5679,2011-08-30,3,0,8,1,0,2,1,1,0.56,0.5303,0.68,0.1045,6,7,13,13,True
5680,2011-08-30,3,0,8,2,0,2,1,1,0.54,0.5152,0.73,0.1045,2,8,10,10,True
5681,2011-08-30,3,0,8,3,0,2,1,1,0.54,0.5152,0.73,0.194,2,2,4,4,True
5682,2011-08-30,3,0,8,4,0,2,1,1,0.52,0.5,0.77,0.1642,0,6,6,6,True
5683,2011-08-30,3,0,8,5,0,2,1,1,0.52,0.5,0.77,0.0896,1,27,28,28,True
5684,2011-08-30,3,0,8,6,0,2,1,1,0.54,0.5152,0.73,0.1045,4,115,119,119,True
5685,2011-08-30,3,0,8,7,0,2,1,1,0.56,0.5303,0.68,0.1343,19,338,357,357,True
5686,2011-08-30,3,0,8,8,0,2,1,1,0.62,0.6212,0.57,0.1343,34,459,493,493,True
5687,2011-08-30,3,0,8,9,0,2,1,1,0.66,0.6212,0.5,0.2239,38,180,218,218,True
5688,2011-08-30,3,0,8,10,0,2,1,1,0.7,0.6364,0.39,0.2239,28,109,137,137,True
5689,2011-08-30,3,0,8,11,0,2,1,1,0.72,0.6515,0.37,0.194,60,115,175,175,True
5690,2011-08-30,3,0,8,12,0,2,1,1,0.72,0.6515,0.37,0.0,65,172,237,237,True
5691,2011-08-30,3,0,8,13,0,2,1,1,0.74,0.6515,0.35,0.1045,59,170,229,229,True
5692,2011-08-30,3,0,8,14,0,2,1,1,0.74,0.6515,0.33,0.1642,58,151,209,209,True
5693,2011-08-30,3,0,8,15,0,2,1,1,0.74,0.6515,0.35,0.2239,34,162,196,196,True
5694,2011-08-30,3,0,8,16,0,2,1,1,0.74,0.6515,0.37,0.1642,42,295,337,337,True
5695,2011-08-30,3,0,8,17,0,2,1,1,0.72,0.6515,0.42,0.194,62,499,561,561,True
5696,2011-08-30,3,0,8,18,0,2,1,1,0.7,0.6364,0.45,0.1642,60,499,559,559,True
5697,2011-08-30,3,0,8,19,0,2,1,1,0.66,0.6212,0.5,0.0896,68,397,465,465,True
5698,2011-08-30,3,0,8,20,0,2,1,1,0.66,0.6212,0.5,0.0,39,259,298,298,True
5699,2011-08-30,3,0,8,21,0,2,1,1,0.64,0.6061,0.65,0.0896,43,180,223,223,True
5700,2011-08-30,3,0,8,22,0,2,1,1,0.62,0.6061,0.61,0.0,22,121,143,143,True
5701,2011-08-30,3,0,8,23,0,2,1,1,0.62,0.6061,0.61,0.0,19,74,93,93,True
5702,2011-08-31,3,0,8,0,0,3,1,1,0.6,0.5909,0.69,0.0,8,24,32,32,True
5703,2011-08-31,3,0,8,1,0,3,1,1,0.6,0.5909,0.69,0.0,2,13,15,15,True
5704,2011-08-31,3,0,8,2,0,3,1,1,0.56,0.5303,0.73,0.0,1,5,6,6,True
5705,2011-08-31,3,0,8,3,0,3,1,1,0.56,0.5303,0.78,0.0,2,4,6,6,True
5706,2011-08-31,3,0,8,4,0,3,1,1,0.56,0.5303,0.73,0.0,0,5,5,5,True
5707,2011-08-31,3,0,8,5,0,3,1,1,0.54,0.5152,0.83,0.0896,2,25,27,27,True
5708,2011-08-31,3,0,8,6,0,3,1,1,0.54,0.5152,0.77,0.0,4,107,111,111,True
5709,2011-08-31,3,0,8,7,0,3,1,1,0.6,0.5758,0.78,0.0,12,316,328,328,True
5710,2011-08-31,3,0,8,8,0,3,1,1,0.62,0.6061,0.69,0.0,27,440,467,467,True
5711,2011-08-31,3,0,8,9,0,3,1,1,0.64,0.6061,0.69,0.0896,27,217,244,244,True
5712,2011-08-31,3,0,8,10,0,3,1,1,0.7,0.6364,0.45,0.1045,33,105,138,138,True
5713,2011-08-31,3,0,8,11,0,3,1,1,0.72,0.6515,0.42,0.1343,28,143,171,171,True
5714,2011-08-31,3,0,8,12,0,3,1,1,0.74,0.6667,0.43,0.1343,68,192,260,260,True
5715,2011-08-31,3,0,8,13,0,3,1,1,0.74,0.6515,0.37,0.1045,39,182,221,221,True
5716,2011-08-31,3,0,8,14,0,3,1,1,0.74,0.6515,0.4,0.1343,48,148,196,196,True
5717,2011-08-31,3,0,8,15,0,3,1,1,0.74,0.6515,0.4,0.1343,34,138,172,172,True
5718,2011-08-31,3,0,8,16,0,3,1,1,0.74,0.6667,0.42,0.1343,46,263,309,309,True
5719,2011-08-31,3,0,8,17,0,3,1,1,0.72,0.6515,0.45,0.1343,83,499,582,582,True
5720,2011-08-31,3,0,8,18,0,3,1,1,0.7,0.6515,0.51,0.2239,70,495,565,565,True
5721,2011-08-31,3,0,8,19,0,3,1,1,0.84,0.7727,0.47,0.2537,53,393,446,446,True
5722,2011-08-31,3,0,8,20,0,3,1,1,0.66,0.6212,0.57,0.1343,30,259,289,289,True
5723,2011-08-31,3,0,8,21,0,3,1,1,0.66,0.6212,0.61,0.0896,27,174,201,201,True
5724,2011-08-31,3,0,8,22,0,3,1,1,0.64,0.6061,0.69,0.0,20,137,157,157,True
5725,2011-08-31,3,0,8,23,0,3,1,1,0.6,0.5758,0.78,0.1045,24,60,84,84,True
5726,2011-09-01,3,0,9,0,0,4,1,1,0.6,0.5758,0.78,0.1045,18,33,51,51,True
5727,2011-09-01,3,0,9,1,0,4,1,1,0.6,0.5909,0.73,0.0896,7,14,21,21,True
5728,2011-09-01,3,0,9,2,0,4,1,1,0.58,0.5455,0.78,0.0896,14,11,25,25,True
5729,2011-09-01,3,0,9,3,0,4,1,1,0.58,0.5455,0.78,0.0896,7,7,14,14,True
5730,2011-09-01,3,0,9,4,0,4,1,1,0.56,0.5303,0.83,0.0896,0,7,7,7,True
5731,2011-09-01,3,0,9,5,0,4,1,1,0.56,0.5303,0.73,0.0896,1,22,23,23,True
5732,2011-09-01,3,0,9,6,0,4,1,1,0.6,0.5758,0.78,0.0,2,103,105,105,True
5733,2011-09-01,3,0,9,7,0,4,1,1,0.6,0.5758,0.78,0.0,7,335,342,342,True
5734,2011-09-01,3,0,9,8,0,4,1,1,0.62,0.5909,0.73,0.1343,31,467,498,498,True
5735,2011-09-01,3,0,9,9,0,4,1,1,0.64,0.6061,0.69,0.1045,29,178,207,207,True
5736,2011-09-01,3,0,9,10,0,4,1,1,0.68,0.6364,0.61,0.1343,46,92,138,138,True
5737,2011-09-01,3,0,9,11,0,4,1,1,0.72,0.6667,0.51,0.1343,51,141,192,192,True
5738,2011-09-01,3,0,9,12,0,4,1,2,0.72,0.6667,0.51,0.1343,64,165,229,229,True
5739,2011-09-01,3,0,9,13,0,4,1,2,0.72,0.6667,0.48,0.0896,50,169,219,219,True
5740,2011-09-01,3,0,9,14,0,4,1,3,0.72,0.6667,0.54,0.2537,54,144,198,198,True
5741,2011-09-01,3,0,9,15,0,4,1,1,0.72,0.6667,0.51,0.1343,39,135,174,174,True
5742,2011-09-01,3,0,9,16,0,4,1,1,0.74,0.6667,0.51,0.194,55,253,308,308,True
5743,2011-09-01,3,0,9,17,0,4,1,1,0.72,0.6667,0.54,0.2537,61,499,560,560,True
5744,2011-09-01,3,0,9,18,0,4,1,1,0.72,0.6667,0.54,0.2239,69,462,531,531,True
5745,2011-09-01,3,0,9,19,0,4,1,1,0.7,0.6515,0.58,0.1642,79,364,443,443,True
5746,2011-09-01,3,0,9,20,0,4,1,1,0.66,0.6212,0.61,0.2239,33,247,280,280,True
5747,2011-09-01,3,0,9,21,0,4,1,2,0.66,0.6212,0.57,0.194,17,160,177,177,True
5748,2011-09-01,3,0,9,22,0,4,1,2,0.66,0.6212,0.57,0.2239,34,145,179,179,True
5749,2011-09-01,3,0,9,23,0,4,1,1,0.64,0.6061,0.65,0.2537,15,111,126,126,True
5750,2011-09-02,3,0,9,0,0,5,1,1,0.64,0.6061,0.65,0.194,6,58,64,64,True
5751,2011-09-02,3,0,9,1,0,5,1,3,0.62,0.5909,0.73,0.1045,4,28,32,32,True
5752,2011-09-02,3,0,9,2,0,5,1,3,0.62,0.5909,0.73,0.1045,9,11,20,20,True
5753,2011-09-02,3,0,9,3,0,5,1,2,0.6,0.5606,0.83,0.1642,4,4,8,8,True
5754,2011-09-02,3,0,9,4,0,5,1,1,0.6,0.5606,0.83,0.0896,2,2,4,4,True
5755,2011-09-02,3,0,9,5,0,5,1,2,0.6,0.5606,0.83,0.1343,0,20,20,20,True
5756,2011-09-02,3,0,9,6,0,5,1,1,0.6,0.5606,0.83,0.1343,3,73,76,76,True
5757,2011-09-02,3,0,9,7,0,5,1,1,0.6,0.5606,0.83,0.1045,6,253,259,259,True
5758,2011-09-02,3,0,9,8,0,5,1,1,0.62,0.5909,0.78,0.194,22,434,456,456,True
5759,2011-09-02,3,0,9,9,0,5,1,2,0.62,0.5758,0.83,0.1045,30,190,220,220,True
5760,2011-09-02,3,0,9,10,0,5,1,2,0.64,0.6061,0.76,0.1642,34,106,140,140,True
5761,2011-09-02,3,0,9,11,0,5,1,2,0.66,0.6212,0.74,0.1045,51,141,192,192,True
5762,2011-09-02,3,0,9,12,0,5,1,2,0.66,0.6212,0.69,0.2239,82,178,260,260,True
5763,2011-09-02,3,0,9,13,0,5,1,2,0.68,0.6364,0.65,0.1343,72,207,279,279,True
5764,2011-09-02,3,0,9,14,0,5,1,2,0.7,0.6515,0.61,0.1045,75,208,283,283,True
5765,2011-09-02,3,0,9,15,0,5,1,2,0.7,0.6515,0.61,0.2537,69,277,346,346,True
5766,2011-09-02,3,0,9,16,0,5,1,2,0.7,0.6515,0.61,0.1343,82,299,381,381,True
5767,2011-09-02,3,0,9,17,0,5,1,2,0.68,0.6364,0.65,0.1642,78,377,455,455,True
5768,2011-09-02,3,0,9,18,0,5,1,2,0.68,0.6364,0.65,0.194,50,305,355,355,True
5769,2011-09-02,3,0,9,19,0,5,1,1,0.66,0.6212,0.69,0.1343,67,220,287,287,True
5770,2011-09-02,3,0,9,20,0,5,1,1,0.64,0.6061,0.73,0.0,38,158,196,196,True
5771,2011-09-02,3,0,9,21,0,5,1,2,0.64,0.6061,0.73,0.0896,28,121,149,149,True
5772,2011-09-02,3,0,9,22,0,5,1,2,0.64,0.6061,0.73,0.1642,33,114,147,147,True
5773,2011-09-02,3,0,9,23,0,5,1,2,0.64,0.6061,0.73,0.1642,30,68,98,98,True
5774,2011-09-03,3,0,9,0,0,6,0,2,0.64,0.6061,0.73,0.1045,22,65,87,87,True
5775,2011-09-03,3,0,9,1,0,6,0,2,0.64,0.6061,0.69,0.2537,17,57,74,74,True
5776,2011-09-03,3,0,9,2,0,6,0,2,0.64,0.6061,0.69,0.2239,15,26,41,41,True
5777,2011-09-03,3,0,9,3,0,6,0,1,0.62,0.5909,0.73,0.1642,17,18,35,35,True
5778,2011-09-03,3,0,9,4,0,6,0,1,0.62,0.5909,0.73,0.1642,3,4,7,7,True
5779,2011-09-03,3,0,9,5,0,6,0,1,0.62,0.6061,0.69,0.194,3,9,12,12,True
5780,2011-09-03,3,0,9,6,0,6,0,1,0.62,0.5909,0.73,0.1642,4,19,23,23,True
5781,2011-09-03,3,0,9,7,0,6,0,1,0.62,0.5909,0.73,0.194,5,33,38,38,True
5782,2011-09-03,3,0,9,8,0,6,0,1,0.64,0.6061,0.69,0.1642,24,65,89,89,True
5783,2011-09-03,3,0,9,9,0,6,0,2,0.66,0.6212,0.69,0.2537,83,118,201,201,True
5784,2011-09-03,3,0,9,10,0,6,0,3,0.66,0.6212,0.65,0.2537,90,168,258,258,True
5785,2011-09-03,3,0,9,11,0,6,0,3,0.66,0.6212,0.69,0.2836,66,128,194,194,True
5786,2011-09-03,3,0,9,12,0,6,0,1,0.7,0.6515,0.61,0.2239,97,160,257,257,True
5787,2011-09-03,3,0,9,13,0,6,0,1,0.7,0.6515,0.65,0.2239,114,200,314,314,True
5788,2011-09-03,3,0,9,14,0,6,0,2,0.72,0.6818,0.66,0.1642,114,176,290,290,True
5789,2011-09-03,3,0,9,15,0,6,0,1,0.72,0.6818,0.7,0.1642,114,201,315,315,True
5790,2011-09-03,3,0,9,16,0,6,0,1,0.72,0.6818,0.7,0.194,114,188,302,302,True
5791,2011-09-03,3,0,9,17,0,6,0,1,0.72,0.6818,0.7,0.2239,114,201,315,315,True
5792,2011-09-03,3,0,9,18,0,6,0,1,0.72,0.6818,0.7,0.1642,114,179,293,293,True
5793,2011-09-03,3,0,9,19,0,6,0,1,0.7,0.6667,0.74,0.1343,114,148,262,262,True
5794,2011-09-03,3,0,9,20,0,6,0,1,0.7,0.6667,0.79,0.1642,99,120,219,219,True
5795,2011-09-03,3,0,9,21,0,6,0,1,0.68,0.6364,0.83,0.1343,71,93,164,164,True
5796,2011-09-03,3,0,9,22,0,6,0,1,0.68,0.6364,0.83,0.1045,66,96,162,162,True
5797,2011-09-03,3,0,9,23,0,6,0,1,0.66,0.6212,0.85,0.1343,46,77,123,123,True
5798,2011-09-04,3,0,9,0,0,0,0,1,0.66,0.5909,0.89,0.194,33,76,109,109,True
5799,2011-09-04,3,0,9,1,0,0,0,1,0.66,0.6061,0.83,0.1343,37,38,75,75,True
5800,2011-09-04,3,0,9,2,0,0,0,1,0.66,0.6061,0.83,0.194,17,43,60,60,True
5801,2011-09-04,3,0,9,3,0,0,0,1,0.64,0.5758,0.89,0.194,20,23,43,43,True
5802,2011-09-04,3,0,9,4,0,0,0,1,0.64,0.5758,0.83,0.1642,0,4,4,4,True
5803,2011-09-04,3,0,9,5,0,0,0,1,0.64,0.5758,0.83,0.1343,1,5,6,6,True
5804,2011-09-04,3,0,9,6,0,0,0,1,0.64,0.5758,0.84,0.2239,0,3,3,3,True
5805,2011-09-04,3,0,9,7,0,0,0,1,0.66,0.6061,0.78,0.194,10,20,30,30,True
5806,2011-09-04,3,0,9,8,0,0,0,1,0.66,0.6061,0.78,0.1642,21,49,70,70,True
5807,2011-09-04,3,0,9,9,0,0,0,1,0.66,0.6061,0.78,0.1642,87,102,189,189,True
5808,2011-09-04,3,0,9,10,0,0,0,1,0.7,0.6667,0.74,0.1343,114,147,261,261,True
5809,2011-09-04,3,0,9,11,0,0,0,1,0.74,0.697,0.7,0.1642,114,163,277,277,True
5810,2011-09-04,3,0,9,12,0,0,0,1,0.76,0.7273,0.66,0.1642,114,221,335,335,True
5811,2011-09-04,3,0,9,13,0,0,0,2,0.78,0.7424,0.62,0.2836,114,174,288,288,True
5812,2011-09-04,3,0,9,14,0,0,0,1,0.78,0.7576,0.66,0.3284,114,156,270,270,True
5813,2011-09-04,3,0,9,15,0,0,0,1,0.78,0.7576,0.66,0.2836,114,192,306,306,True
5814,2011-09-04,3,0,9,16,0,0,0,1,0.8,0.7727,0.59,0.2239,114,141,255,255,True
5815,2011-09-04,3,0,9,17,0,0,0,1,0.76,0.7273,0.66,0.2239,114,172,286,286,True
5816,2011-09-04,3,0,9,18,0,0,0,1,0.76,0.7273,0.66,0.194,114,169,283,283,True
5817,2011-09-04,3,0,9,19,0,0,0,1,0.74,0.697,0.7,0.194,114,150,264,264,True
5818,2011-09-04,3,0,9,20,0,0,0,1,0.74,0.697,0.7,0.2985,104,125,229,229,True
5819,2011-09-04,3,0,9,21,0,0,0,1,0.72,0.697,0.74,0.2537,104,103,207,207,True
5820,2011-09-04,3,0,9,22,0,0,0,2,0.72,0.697,0.74,0.2836,70,85,155,155,True
5821,2011-09-04,3,0,9,23,0,0,0,2,0.72,0.6818,0.7,0.1642,46,58,104,104,True
5822,2011-09-05,3,0,9,0,1,1,0,2,0.7,0.6667,0.74,0.2239,31,66,97,97,True
5823,2011-09-05,3,0,9,1,1,1,0,2,0.68,0.6364,0.79,0.1045,19,35,54,54,True
5824,2011-09-05,3,0,9,2,1,1,0,2,0.68,0.6364,0.79,0.1642,17,22,39,39,True
5825,2011-09-05,3,0,9,3,1,1,0,2,0.68,0.6364,0.74,0.2985,4,12,16,16,True
5826,2011-09-05,3,0,9,4,1,1,0,2,0.68,0.6364,0.69,0.2836,3,5,8,8,True
5827,2011-09-05,3,0,9,5,1,1,0,2,0.66,0.6212,0.74,0.1642,2,4,6,6,True
5828,2011-09-05,3,0,9,6,1,1,0,2,0.66,0.6212,0.74,0.1343,6,5,11,11,True
5829,2011-09-05,3,0,9,7,1,1,0,1,0.66,0.6212,0.74,0.1642,11,30,41,41,True
5830,2011-09-05,3,0,9,8,1,1,0,2,0.66,0.6061,0.78,0.194,45,56,101,101,True
5831,2011-09-05,3,0,9,9,1,1,0,3,0.68,0.6364,0.74,0.1642,63,89,152,152,True
5832,2011-09-05,3,0,9,10,1,1,0,2,0.7,0.6515,0.7,0.1642,107,137,244,244,True
5833,2011-09-05,3,0,9,11,1,1,0,2,0.7,0.6667,0.74,0.1642,101,207,308,308,True
5834,2011-09-05,3,0,9,12,1,1,0,2,0.72,0.6818,0.7,0.194,114,212,326,326,True
5835,2011-09-05,3,0,9,13,1,1,0,2,0.74,0.697,0.7,0.1343,114,235,349,349,True
5836,2011-09-05,3,0,9,14,1,1,0,1,0.74,0.697,0.7,0.1642,114,212,326,326,True
5837,2011-09-05,3,0,9,15,1,1,0,2,0.68,0.6364,0.79,0.2836,111,142,253,253,True
5838,2011-09-05,3,0,9,16,1,1,0,2,0.68,0.6364,0.79,0.2836,92,192,284,284,True
5839,2011-09-05,3,0,9,17,1,1,0,2,0.66,0.5909,0.89,0.1045,37,77,114,114,True
5840,2011-09-05,3,0,9,18,1,1,0,1,0.66,0.5909,0.89,0.0896,31,92,123,123,True
5841,2011-09-05,3,0,9,19,1,1,0,3,0.66,0.5909,0.94,0.1045,52,123,175,175,True
5842,2011-09-05,3,0,9,20,1,1,0,3,0.66,0.5909,0.94,0.2537,26,56,82,82,True
5843,2011-09-05,3,0,9,21,1,1,0,2,0.66,0.5909,0.94,0.2985,20,40,60,60,True
5844,2011-09-05,3,0,9,22,1,1,0,2,0.6,0.5455,0.88,0.4775,15,49,64,64,True
5845,2011-09-05,3,0,9,23,1,1,0,3,0.56,0.5303,0.88,0.3881,3,17,20,20,True
5846,2011-09-06,3,0,9,0,0,2,1,3,0.54,0.5152,0.94,0.3582,1,7,8,8,True
5847,2011-09-06,3,0,9,2,0,2,1,3,0.54,0.5152,0.94,0.2537,0,2,2,2,True
5848,2011-09-06,3,0,9,3,0,2,1,3,0.54,0.5152,0.94,0.2985,1,0,1,1,True
5849,2011-09-06,3,0,9,4,0,2,1,2,0.54,0.5152,0.94,0.2985,1,3,4,4,True
5850,2011-09-06,3,0,9,5,0,2,1,3,0.54,0.5152,0.88,0.3582,1,20,21,21,True
5851,2011-09-06,3,0,9,6,0,2,1,2,0.54,0.5152,0.88,0.3284,0,72,72,72,True
5852,2011-09-06,3,0,9,7,0,2,1,2,0.54,0.5152,0.83,0.3582,6,166,172,172,True
5853,2011-09-06,3,0,9,8,0,2,1,3,0.54,0.5152,0.83,0.3881,15,349,364,364,True
5854,2011-09-06,3,0,9,9,0,2,1,2,0.54,0.5152,0.81,0.4179,18,167,185,185,True
5855,2011-09-06,3,0,9,10,0,2,1,3,0.54,0.5152,0.83,0.3582,16,90,106,106,True
5856,2011-09-06,3,0,9,11,0,2,1,3,0.54,0.5152,0.83,0.3881,11,78,89,89,True
5857,2011-09-06,3,0,9,12,0,2,1,3,0.54,0.5152,0.83,0.3881,16,51,67,67,True
5858,2011-09-06,3,0,9,13,0,2,1,3,0.54,0.5152,0.88,0.2985,5,24,29,29,True
5859,2011-09-06,3,0,9,14,0,2,1,3,0.54,0.5152,0.88,0.2836,3,21,24,24,True
5860,2011-09-06,3,0,9,15,0,2,1,3,0.54,0.5152,0.94,0.3881,18,71,89,89,True
5861,2011-09-06,3,0,9,16,0,2,1,3,0.54,0.5152,0.94,0.3881,11,95,106,106,True
5862,2011-09-06,3,0,9,17,0,2,1,2,0.54,0.5152,0.88,0.3881,15,276,291,291,True
5863,2011-09-06,3,0,9,18,0,2,1,2,0.54,0.5152,0.88,0.3881,22,351,373,373,True
5864,2011-09-06,3,0,9,19,0,2,1,2,0.54,0.5152,0.88,0.4179,12,269,281,281,True
5865,2011-09-06,3,0,9,20,0,2,1,3,0.54,0.5152,0.88,0.2985,13,150,163,163,True
5866,2011-09-06,3,0,9,21,0,2,1,3,0.54,0.5152,0.88,0.2836,12,109,121,121,True
5867,2011-09-06,3,0,9,22,0,2,1,2,0.54,0.5152,0.94,0.3284,5,79,84,84,True
5868,2011-09-06,3,0,9,23,0,2,1,3,0.54,0.5152,0.94,0.2537,2,56,58,58,True
5869,2011-09-07,3,0,9,0,0,3,1,2,0.54,0.5152,0.94,0.2239,1,12,13,13,True
5870,2011-09-07,3,0,9,1,0,3,1,3,0.54,0.5152,0.94,0.2537,2,3,5,5,True
5871,2011-09-07,3,0,9,2,0,3,1,2,0.54,0.5152,0.94,0.2239,2,4,6,6,True
5872,2011-09-07,3,0,9,3,0,3,1,3,0.56,0.5303,0.94,0.1343,1,1,2,2,True
5873,2011-09-07,3,0,9,4,0,3,1,3,0.56,0.5303,0.94,0.1642,0,4,4,4,True
5874,2011-09-07,3,0,9,5,0,3,1,2,0.56,0.5303,1.0,0.1343,1,15,16,16,True
5875,2011-09-07,3,0,9,6,0,3,1,3,0.6,0.5455,0.88,0.1045,1,74,75,75,True
5876,2011-09-07,3,0,9,7,0,3,1,3,0.6,0.5455,0.88,0.0896,3,83,86,86,True
5877,2011-09-07,3,0,9,8,0,3,1,3,0.62,0.5455,0.94,0.0896,9,319,328,328,True
5878,2011-09-07,3,0,9,9,0,3,1,3,0.6,0.5455,0.88,0.1343,14,176,190,190,True
5879,2011-09-07,3,0,9,10,0,3,1,3,0.6,0.5455,0.88,0.1343,3,63,66,66,True
5880,2011-09-07,3,0,9,11,0,3,1,3,0.6,0.5152,0.94,0.0,1,9,10,10,True
5881,2011-09-07,3,0,9,12,0,3,1,3,0.56,0.5303,0.94,0.0,1,21,22,22,True
5882,2011-09-07,3,0,9,13,0,3,1,3,0.6,0.5455,0.88,0.0,2,9,11,11,True
5883,2011-09-07,3,0,9,14,0,3,1,3,0.6,0.5152,0.93,0.0,1,24,25,25,True
5884,2011-09-07,3,0,9,15,0,3,1,3,0.62,0.5455,0.94,0.1045,3,55,58,58,True
5885,2011-09-07,3,0,9,16,0,3,1,1,0.64,0.5758,0.89,0.0,7,137,144,144,True
5886,2011-09-07,3,0,9,17,0,3,1,3,0.64,0.5758,0.89,0.0,21,264,285,285,True
5887,2011-09-07,3,0,9,18,0,3,1,3,0.64,0.5758,0.89,0.0,18,219,237,237,True
5888,2011-09-07,3,0,9,19,0,3,1,2,0.64,0.5758,0.89,0.0,14,212,226,226,True
5889,2011-09-07,3,0,9,20,0,3,1,3,0.64,0.5758,0.89,0.0896,3,93,96,96,True
5890,2011-09-07,3,0,9,21,0,3,1,3,0.64,0.5758,0.89,0.0896,4,34,38,38,True
5891,2011-09-07,3,0,9,22,0,3,1,3,0.62,0.5455,0.94,0.1642,3,26,29,29,True
5892,2011-09-07,3,0,9,23,0,3,1,3,0.62,0.5455,0.94,0.194,3,21,24,24,True
5893,2011-09-08,3,0,9,0,0,4,1,3,0.6,0.5,1.0,0.194,3,11,14,14,True
5894,2011-09-08,3,0,9,1,0,4,1,3,0.62,0.5455,0.94,0.1045,0,4,4,4,True
5895,2011-09-08,3,0,9,3,0,4,1,3,0.62,0.5455,0.94,0.0,0,2,2,2,True
5896,2011-09-08,3,0,9,4,0,4,1,2,0.62,0.5455,0.94,0.0896,0,3,3,3,True
5897,2011-09-08,3,0,9,5,0,4,1,3,0.62,0.5455,0.94,0.0896,1,13,14,14,True
5898,2011-09-08,3,0,9,6,0,4,1,3,0.62,0.5455,0.94,0.1642,1,55,56,56,True
5899,2011-09-08,3,0,9,7,0,4,1,3,0.62,0.5455,0.94,0.1045,7,172,179,179,True
5900,2011-09-08,3,0,9,8,0,4,1,3,0.62,0.5455,0.94,0.1343,7,188,195,195,True
5901,2011-09-08,3,0,9,9,0,4,1,2,0.62,0.5152,1.0,0.2537,4,65,69,69,True
5902,2011-09-08,3,0,9,10,0,4,1,2,0.64,0.5606,0.94,0.1045,8,57,65,65,True
5903,2011-09-08,3,0,9,11,0,4,1,2,0.64,0.5606,0.94,0.2239,16,82,98,98,True
5904,2011-09-08,3,0,9,12,0,4,1,2,0.66,0.5909,0.94,0.2239,17,85,102,102,True
5905,2011-09-08,3,0,9,13,0,4,1,2,0.68,0.6364,0.83,0.3881,14,112,126,126,True
5906,2011-09-08,3,0,9,14,0,4,1,2,0.7,0.6667,0.79,0.3582,15,105,120,120,True
5907,2011-09-08,3,0,9,15,0,4,1,3,0.66,0.5909,0.89,0.2985,24,115,139,139,True
5908,2011-09-08,3,0,9,16,0,4,1,3,0.64,0.5606,0.94,0.2836,5,151,156,156,True
5909,2011-09-08,3,0,9,17,0,4,1,3,0.64,0.5606,0.94,0.2836,11,102,113,113,True
5910,2011-09-08,3,0,9,18,0,4,1,3,0.64,0.5606,0.94,0.3582,2,66,68,68,True
5911,2011-09-08,3,0,9,19,0,4,1,3,0.62,0.5152,1.0,0.3284,1,51,52,52,True
5912,2011-09-08,3,0,9,20,0,4,1,2,0.62,0.5455,0.94,0.1642,6,83,89,89,True
5913,2011-09-08,3,0,9,21,0,4,1,3,0.64,0.5606,0.94,0.1045,6,76,82,82,True
5914,2011-09-08,3,0,9,22,0,4,1,3,0.62,0.5152,1.0,0.0896,5,65,70,70,True
5915,2011-09-08,3,0,9,23,0,4,1,3,0.62,0.5152,1.0,0.0896,0,26,26,26,True
5916,2011-09-09,3,0,9,0,0,5,1,3,0.64,0.5606,0.94,0.194,1,15,16,16,True
5917,2011-09-09,3,0,9,1,0,5,1,2,0.62,0.5152,1.0,0.1642,0,8,8,8,True
5918,2011-09-09,3,0,9,2,0,5,1,2,0.62,0.5152,1.0,0.2537,1,7,8,8,True
5919,2011-09-09,3,0,9,3,0,5,1,2,0.62,0.5455,0.94,0.2537,1,1,2,2,True
5920,2011-09-09,3,0,9,4,0,5,1,3,0.62,0.5455,0.94,0.1642,0,3,3,3,True
5921,2011-09-09,3,0,9,5,0,5,1,2,0.62,0.5455,0.94,0.1343,0,14,14,14,True
5922,2011-09-09,3,0,9,6,0,5,1,2,0.62,0.5152,1.0,0.1343,3,54,57,57,True
5923,2011-09-09,3,0,9,7,0,5,1,3,0.62,0.5152,1.0,0.2537,4,104,108,108,True
5924,2011-09-09,3,0,9,8,0,5,1,3,0.62,0.5455,0.94,0.1642,12,276,288,288,True
5925,2011-09-09,3,0,9,9,0,5,1,3,0.62,0.5455,0.94,0.1642,5,131,136,136,True
5926,2011-09-09,3,0,9,10,0,5,1,2,0.62,0.5152,1.0,0.0,2,27,29,29,True
5927,2011-09-09,3,0,9,11,0,5,1,2,0.62,0.5455,0.94,0.0,6,66,72,72,True
5928,2011-09-09,3,0,9,12,0,5,1,1,0.64,0.5606,0.94,0.0,4,71,75,75,True
5929,2011-09-09,3,0,9,13,0,5,1,1,0.7,0.6667,0.79,0.0896,14,108,122,122,True
5930,2011-09-09,3,0,9,14,0,5,1,1,0.72,0.697,0.74,0.0896,29,119,148,148,True
5931,2011-09-09,3,0,9,15,0,5,1,1,0.74,0.697,0.66,0.0,27,161,188,188,True
5932,2011-09-09,3,0,9,16,0,5,1,1,0.74,0.697,0.66,0.1343,41,244,285,285,True
5933,2011-09-09,3,0,9,17,0,5,1,1,0.7,0.6667,0.79,0.2537,54,451,505,505,True
5934,2011-09-09,3,0,9,18,0,5,1,1,0.7,0.6667,0.79,0.194,33,377,410,410,True
5935,2011-09-09,3,0,9,19,0,5,1,1,0.66,0.5909,0.89,0.1642,33,316,349,349,True
5936,2011-09-09,3,0,9,20,0,5,1,1,0.64,0.5606,0.94,0.0896,30,180,210,210,True
5937,2011-09-09,3,0,9,21,0,5,1,1,0.66,0.5909,0.89,0.0,49,154,203,203,True
5938,2011-09-09,3,0,9,22,0,5,1,1,0.62,0.5455,0.94,0.0,33,127,160,160,True
5939,2011-09-09,3,0,9,23,0,5,1,1,0.62,0.5455,0.94,0.0896,35,113,148,148,True
5940,2011-09-10,3,0,9,0,0,6,0,1,0.62,0.5455,0.94,0.0,32,84,116,116,True
5941,2011-09-10,3,0,9,1,0,6,0,2,0.62,0.5455,0.94,0.0,16,67,83,83,True
5942,2011-09-10,3,0,9,2,0,6,0,2,0.6,0.5,0.97,0.1045,18,46,64,64,True
5943,2011-09-10,3,0,9,3,0,6,0,1,0.58,0.5455,1.0,0.1343,8,29,37,37,True
5944,2011-09-10,3,0,9,4,0,6,0,1,0.58,0.5455,0.94,0.0896,3,4,7,7,True
5945,2011-09-10,3,0,9,5,0,6,0,1,0.58,0.5455,0.94,0.1343,2,6,8,8,True
5946,2011-09-10,3,0,9,6,0,6,0,1,0.58,0.5455,0.94,0.1642,0,6,6,6,True
5947,2011-09-10,3,0,9,7,0,6,0,1,0.6,0.5455,0.88,0.1343,9,43,52,52,True
5948,2011-09-10,3,0,9,8,0,6,0,1,0.62,0.5758,0.83,0.1642,16,103,119,119,True
5949,2011-09-10,3,0,9,9,0,6,0,1,0.64,0.5909,0.78,0.2985,39,168,207,207,True
5950,2011-09-10,3,0,9,10,0,6,0,1,0.7,0.6515,0.65,0.2537,85,233,318,318,True
5951,2011-09-10,3,0,9,11,0,6,0,1,0.72,0.6818,0.62,0.2537,108,252,360,360,True
5952,2011-09-10,3,0,9,12,0,6,0,1,0.72,0.6818,0.62,0.2239,114,260,374,374,True
5953,2011-09-10,3,0,9,13,0,6,0,1,0.74,0.6818,0.55,0.2836,114,239,353,353,True
5954,2011-09-10,3,0,9,14,0,6,0,1,0.74,0.6818,0.55,0.2836,114,230,344,344,True
5955,2011-09-10,3,0,9,15,0,6,0,1,0.74,0.6818,0.55,0.2239,114,263,377,377,True
5956,2011-09-10,3,0,9,16,0,6,0,1,0.74,0.6818,0.55,0.194,114,261,375,375,True
5957,2011-09-10,3,0,9,17,0,6,0,1,0.74,0.6818,0.55,0.2239,114,275,389,389,True
5958,2011-09-10,3,0,9,18,0,6,0,1,0.72,0.6667,0.58,0.194,114,241,355,355,True
5959,2011-09-10,3,0,9,19,0,6,0,1,0.7,0.6515,0.58,0.1343,101,214,315,315,True
5960,2011-09-10,3,0,9,20,0,6,0,1,0.66,0.6212,0.69,0.1045,78,167,245,245,True
5961,2011-09-10,3,0,9,21,0,6,0,1,0.64,0.5909,0.78,0.0896,59,171,230,230,True
5962,2011-09-10,3,0,9,22,0,6,0,1,0.64,0.5909,0.78,0.0,49,126,175,175,True
5963,2011-09-10,3,0,9,23,0,6,0,2,0.62,0.5606,0.88,0.0,32,107,139,139,True
5964,2011-09-11,3,0,9,0,0,0,0,1,0.62,0.5606,0.88,0.0,29,79,108,108,True
5965,2011-09-11,3,0,9,1,0,0,0,2,0.62,0.5606,0.88,0.0,22,66,88,88,True
5966,2011-09-11,3,0,9,2,0,0,0,2,0.62,0.5909,0.78,0.194,16,60,76,76,True
5967,2011-09-11,3,0,9,3,0,0,0,2,0.62,0.5909,0.78,0.0896,15,30,45,45,True
5968,2011-09-11,3,0,9,4,0,0,0,1,0.6,0.5606,0.83,0.1343,3,6,9,9,True
5969,2011-09-11,3,0,9,5,0,0,0,1,0.6,0.5606,0.83,0.1343,15,24,39,39,True
5970,2011-09-11,3,0,9,6,0,0,0,1,0.58,0.5455,0.88,0.1045,4,16,20,20,True
5971,2011-09-11,3,0,9,7,0,0,0,1,0.6,0.5455,0.88,0.0,9,28,37,37,True
5972,2011-09-11,3,0,9,8,0,0,0,1,0.64,0.5909,0.78,0.0,25,69,94,94,True
5973,2011-09-11,3,0,9,9,0,0,0,1,0.66,0.6212,0.74,0.0,59,168,227,227,True
5974,2011-09-11,3,0,9,10,0,0,0,1,0.7,0.6515,0.65,0.0,114,214,328,328,True
5975,2011-09-11,3,0,9,11,0,0,0,1,0.7,0.6515,0.65,0.0,114,258,372,372,True
5976,2011-09-11,3,0,9,12,0,0,0,1,0.7,0.6515,0.65,0.0,113,298,411,411,True
5977,2011-09-11,3,0,9,13,0,0,0,1,0.74,0.6818,0.58,0.1045,114,231,345,345,True
5978,2011-09-11,3,0,9,14,0,0,0,1,0.72,0.6667,0.58,0.2836,114,222,336,336,True
5979,2011-09-11,3,0,9,15,0,0,0,1,0.74,0.6667,0.51,0.2985,114,270,384,384,True
5980,2011-09-11,3,0,9,16,0,0,0,1,0.72,0.6667,0.51,0.2985,114,303,417,417,True
5981,2011-09-11,3,0,9,17,0,0,0,1,0.72,0.6667,0.51,0.1343,114,228,342,342,True
5982,2011-09-11,3,0,9,18,0,0,0,1,0.68,0.6364,0.65,0.2985,110,229,339,339,True
5983,2011-09-11,3,0,9,19,0,0,0,1,0.64,0.6061,0.69,0.1045,101,232,333,333,True
5984,2011-09-11,3,0,9,20,0,0,0,1,0.62,0.5909,0.73,0.1045,65,161,226,226,True
5985,2011-09-11,3,0,9,21,0,0,0,1,0.64,0.6061,0.69,0.0,45,114,159,159,True
5986,2011-09-11,3,0,9,22,0,0,0,1,0.62,0.6061,0.69,0.3881,21,74,95,95,True
5987,2011-09-11,3,0,9,23,0,0,0,3,0.58,0.5455,0.78,0.0896,12,33,45,45,True
5988,2011-09-12,3,0,9,0,0,1,1,1,0.56,0.5303,0.88,0.0896,5,11,16,16,True
5989,2011-09-12,3,0,9,1,0,1,1,1,0.56,0.5303,0.88,0.0,1,11,12,12,True
5990,2011-09-12,3,0,9,2,0,1,1,1,0.56,0.5303,0.88,0.0,2,0,2,2,True
5991,2011-09-12,3,0,9,4,0,1,1,1,0.54,0.5152,0.94,0.1045,0,4,4,4,True
5992,2011-09-12,3,0,9,5,0,1,1,1,0.56,0.5303,0.83,0.0,1,23,24,24,True
5993,2011-09-12,3,0,9,6,0,1,1,1,0.56,0.5303,0.83,0.0,1,108,109,109,True
5994,2011-09-12,3,0,9,7,0,1,1,1,0.58,0.5455,0.83,0.0,12,300,312,312,True
5995,2011-09-12,3,0,9,8,0,1,1,1,0.6,0.5758,0.78,0.0896,26,382,408,408,True
5996,2011-09-12,3,0,9,9,0,1,1,1,0.64,0.6061,0.69,0.0,21,155,176,176,True
5997,2011-09-12,3,0,9,10,0,1,1,1,0.68,0.6364,0.62,0.1642,40,89,129,129,True
5998,2011-09-12,3,0,9,11,0,1,1,1,0.7,0.6515,0.58,0.194,34,131,165,165,True
5999,2011-09-12,3,0,9,12,0,1,1,1,0.72,0.6667,0.51,0.194,37,147,184,184,True
6000,2011-09-12,3,0,9,13,0,1,1,1,0.72,0.6667,0.54,0.1045,43,120,163,163,True
6001,2011-09-12,3,0,9,14,0,1,1,1,0.74,0.6667,0.51,0.1642,60,129,189,189,True
6002,2011-09-12,3,0,9,15,0,1,1,1,0.74,0.6667,0.48,0.0896,60,152,212,212,True
6003,2011-09-12,3,0,9,16,0,1,1,1,0.72,0.6667,0.48,0.0,60,238,298,298,True
6004,2011-09-12,3,0,9,17,0,1,1,1,0.72,0.6667,0.51,0.1642,75,499,574,574,True
6005,2011-09-12,3,0,9,18,0,1,1,1,0.7,0.6515,0.54,0.194,56,499,555,555,True
6006,2011-09-12,3,0,9,19,0,1,1,1,0.68,0.6364,0.57,0.1343,63,373,436,436,True
6007,2011-09-12,3,0,9,20,0,1,1,1,0.66,0.6212,0.65,0.0,41,258,299,299,True
6008,2011-09-12,3,0,9,21,0,1,1,1,0.64,0.6061,0.73,0.0896,29,166,195,195,True
6009,2011-09-12,3,0,9,22,0,1,1,1,0.62,0.5758,0.83,0.1642,16,134,150,150,True
6010,2011-09-12,3,0,9,23,0,1,1,1,0.62,0.5758,0.83,0.1045,7,62,69,69,True
6011,2011-09-13,3,0,9,0,0,2,1,1,0.6,0.5455,0.88,0.1045,7,19,26,26,True
6012,2011-09-13,3,0,9,1,0,2,1,1,0.58,0.5455,0.83,0.1045,4,6,10,10,True
6013,2011-09-13,3,0,9,2,0,2,1,1,0.6,0.5758,0.78,0.0,2,0,2,2,True
6014,2011-09-13,3,0,9,3,0,2,1,1,0.58,0.5455,0.83,0.0,2,2,4,4,True
6015,2011-09-13,3,0,9,4,0,2,1,1,0.56,0.5303,0.88,0.0,2,6,8,8,True
6016,2011-09-13,3,0,9,5,0,2,1,1,0.56,0.5303,0.88,0.0,1,19,20,20,True
6017,2011-09-13,3,0,9,6,0,2,1,1,0.56,0.5303,0.88,0.1045,6,116,122,122,True
6018,2011-09-13,3,0,9,7,0,2,1,1,0.58,0.5455,0.83,0.0896,14,348,362,362,True
6019,2011-09-13,3,0,9,8,0,2,1,1,0.6,0.5606,0.81,0.1045,26,399,425,425,True
6020,2011-09-13,3,0,9,9,0,2,1,1,0.64,0.6061,0.69,0.0896,35,179,214,214,True
6021,2011-09-13,3,0,9,10,0,2,1,1,0.68,0.6364,0.69,0.1343,42,93,135,135,True
6022,2011-09-13,3,0,9,11,0,2,1,1,0.7,0.6515,0.61,0.1642,33,120,153,153,True
6023,2011-09-13,3,0,9,12,0,2,1,1,0.72,0.6667,0.58,0.2239,43,144,187,187,True
6024,2011-09-13,3,0,9,13,0,2,1,1,0.74,0.6667,0.51,0.2836,48,136,184,184,True
6025,2011-09-13,3,0,9,14,0,2,1,1,0.74,0.6667,0.51,0.3284,51,139,190,190,True
6026,2011-09-13,3,0,9,15,0,2,1,1,0.74,0.6667,0.51,0.2985,35,145,180,180,True
6027,2011-09-13,3,0,9,16,0,2,1,1,0.74,0.6667,0.51,0.2239,41,251,292,292,True
6028,2011-09-13,3,0,9,17,0,2,1,1,0.74,0.6667,0.51,0.2239,72,499,571,571,True
6029,2011-09-13,3,0,9,18,0,2,1,1,0.7,0.6515,0.61,0.1642,67,472,539,539,True
6030,2011-09-13,3,0,9,19,0,2,1,1,0.68,0.6364,0.69,0.1642,55,341,396,396,True
6031,2011-09-13,3,0,9,20,0,2,1,1,0.66,0.6212,0.74,0.194,31,241,272,272,True
6032,2011-09-13,3,0,9,21,0,2,1,1,0.64,0.5909,0.78,0.1642,45,200,245,245,True
6033,2011-09-13,3,0,9,22,0,2,1,1,0.64,0.5909,0.78,0.1343,24,120,144,144,True
6034,2011-09-13,3,0,9,23,0,2,1,1,0.64,0.5909,0.78,0.1045,15,59,74,74,True
6035,2011-09-14,3,0,9,0,0,3,1,1,0.62,0.5909,0.78,0.0896,5,28,33,33,True
6036,2011-09-14,3,0,9,1,0,3,1,1,0.62,0.5909,0.78,0.0896,1,7,8,8,True
6037,2011-09-14,3,0,9,2,0,3,1,1,0.6,0.5606,0.83,0.0,1,4,5,5,True
6038,2011-09-14,3,0,9,3,0,3,1,1,0.6,0.5455,0.88,0.1343,1,7,8,8,True
6039,2011-09-14,3,0,9,4,0,3,1,1,0.6,0.5606,0.83,0.0896,1,8,9,9,True
6040,2011-09-14,3,0,9,5,0,3,1,1,0.58,0.5455,0.88,0.1045,1,30,31,31,True
6041,2011-09-14,3,0,9,6,0,3,1,1,0.58,0.5455,0.88,0.1045,7,138,145,145,True
6042,2011-09-14,3,0,9,7,0,3,1,1,0.6,0.5606,0.83,0.1045,20,350,370,370,True
6043,2011-09-14,3,0,9,8,0,3,1,1,0.62,0.5758,0.83,0.1642,33,396,429,429,True
6044,2011-09-14,3,0,9,9,0,3,1,1,0.64,0.5909,0.78,0.1642,19,183,202,202,True
6045,2011-09-14,3,0,9,10,0,3,1,1,0.7,0.6515,0.7,0.1343,27,115,142,142,True
6046,2011-09-14,3,0,9,11,0,3,1,1,0.72,0.6818,0.66,0.1642,43,121,164,164,True
6047,2011-09-14,3,0,9,12,0,3,1,1,0.74,0.6818,0.58,0.2239,56,156,212,212,True
6048,2011-09-14,3,0,9,13,0,3,1,1,0.76,0.697,0.55,0.2537,39,139,178,178,True
6049,2011-09-14,3,0,9,14,0,3,1,1,0.78,0.7121,0.52,0.2239,19,105,124,124,True
6050,2011-09-14,3,0,9,15,0,3,1,1,0.78,0.7121,0.49,0.2537,30,146,176,176,True
6051,2011-09-14,3,0,9,16,0,3,1,1,0.76,0.697,0.52,0.2836,36,241,277,277,True
6052,2011-09-14,3,0,9,17,0,3,1,1,0.76,0.697,0.52,0.2836,87,499,586,586,True
6053,2011-09-14,3,0,9,18,0,3,1,1,0.72,0.6818,0.62,0.1642,83,499,582,582,True
6054,2011-09-14,3,0,9,19,0,3,1,2,0.7,0.6515,0.7,0.1045,44,337,381,381,True
6055,2011-09-14,3,0,9,20,0,3,1,2,0.72,0.6667,0.58,0.4179,40,221,261,261,True
6056,2011-09-14,3,0,9,21,0,3,1,2,0.66,0.6212,0.65,0.2239,24,189,213,213,True
6057,2011-09-14,3,0,9,22,0,3,1,2,0.66,0.6212,0.65,0.1343,20,140,160,160,True
6058,2011-09-14,3,0,9,23,0,3,1,2,0.64,0.6061,0.69,0.1045,10,62,72,72,True
6059,2011-09-15,3,0,9,0,0,4,1,1,0.64,0.6061,0.69,0.1343,3,34,37,37,True
6060,2011-09-15,3,0,9,1,0,4,1,1,0.64,0.6061,0.69,0.1642,0,20,20,20,True
6061,2011-09-15,3,0,9,2,0,4,1,1,0.62,0.5909,0.73,0.1045,0,5,5,5,True
6062,2011-09-15,3,0,9,3,0,4,1,1,0.62,0.5909,0.73,0.0896,3,5,8,8,True
6063,2011-09-15,3,0,9,4,0,4,1,1,0.6,0.5758,0.78,0.1045,2,5,7,7,True
6064,2011-09-15,3,0,9,5,0,4,1,1,0.6,0.5758,0.78,0.0,1,30,31,31,True
6065,2011-09-15,3,0,9,6,0,4,1,2,0.6,0.5606,0.83,0.2537,5,119,124,124,True
6066,2011-09-15,3,0,9,7,0,4,1,2,0.62,0.5909,0.78,0.194,17,321,338,338,True
6067,2011-09-15,3,0,9,8,0,4,1,1,0.64,0.6061,0.73,0.1343,27,364,391,391,True
6068,2011-09-15,3,0,9,9,0,4,1,2,0.64,0.6061,0.73,0.3582,23,186,209,209,True
6069,2011-09-15,3,0,9,10,0,4,1,2,0.66,0.6212,0.69,0.2537,25,96,121,121,True
6070,2011-09-15,3,0,9,11,0,4,1,2,0.68,0.6364,0.65,0.1343,39,120,159,159,True
6071,2011-09-15,3,0,9,12,0,4,1,2,0.66,0.6212,0.69,0.2985,31,148,179,179,True
6072,2011-09-15,3,0,9,13,0,4,1,2,0.64,0.6061,0.65,0.2836,38,151,189,189,True
6073,2011-09-15,3,0,9,14,0,4,1,2,0.64,0.6061,0.65,0.4179,36,134,170,170,True
6074,2011-09-15,3,0,9,15,0,4,1,2,0.6,0.5909,0.69,0.4179,25,110,135,135,True
6075,2011-09-15,3,0,9,16,0,4,1,2,0.54,0.5152,0.77,0.4627,29,193,222,222,True
6076,2011-09-15,3,0,9,17,0,4,1,3,0.48,0.4697,0.82,0.4627,31,230,261,261,True
6077,2011-09-15,3,0,9,18,0,4,1,3,0.48,0.4697,0.67,0.4775,22,222,244,244,True
6078,2011-09-15,3,0,9,19,0,4,1,1,0.46,0.4545,0.67,0.4627,20,212,232,232,True
6079,2011-09-15,3,0,9,20,0,4,1,1,0.46,0.4545,0.63,0.3284,25,223,248,248,True
6080,2011-09-15,3,0,9,21,0,4,1,1,0.46,0.4545,0.63,0.3284,11,134,145,145,True
6081,2011-09-15,3,0,9,22,0,4,1,1,0.44,0.4394,0.67,0.2836,7,108,115,115,True
6082,2011-09-15,3,0,9,23,0,4,1,1,0.44,0.4394,0.67,0.2239,8,61,69,69,True
6083,2011-09-16,3,0,9,0,0,5,1,1,0.42,0.4242,0.71,0.2239,5,43,48,48,True
6084,2011-09-16,3,0,9,1,0,5,1,1,0.42,0.4242,0.67,0.194,7,19,26,26,True
6085,2011-09-16,3,0,9,2,0,5,1,1,0.4,0.4091,0.71,0.2836,3,7,10,10,True
6086,2011-09-16,3,0,9,3,0,5,1,1,0.4,0.4091,0.71,0.2537,2,4,6,6,True
6087,2011-09-16,3,0,9,4,0,5,1,1,0.4,0.4091,0.71,0.2836,1,3,4,4,True
6088,2011-09-16,3,0,9,5,0,5,1,1,0.38,0.3939,0.76,0.194,2,30,32,32,True
6089,2011-09-16,3,0,9,6,0,5,1,1,0.38,0.3939,0.71,0.2239,6,87,93,93,True
6090,2011-09-16,3,0,9,7,0,5,1,1,0.4,0.4091,0.71,0.2836,16,283,299,299,True
6091,2011-09-16,3,0,9,8,0,5,1,1,0.42,0.4242,0.67,0.2239,23,386,409,409,True
6092,2011-09-16,3,0,9,9,0,5,1,1,0.46,0.4545,0.55,0.2537,21,189,210,210,True
6093,2011-09-16,3,0,9,10,0,5,1,2,0.5,0.4848,0.51,0.2836,36,104,140,140,True
6094,2011-09-16,3,0,9,11,0,5,1,2,0.5,0.4848,0.51,0.1343,40,139,179,179,True
6095,2011-09-16,3,0,9,12,0,5,1,2,0.52,0.5,0.45,0.0,39,212,251,251,True
6096,2011-09-16,3,0,9,13,0,5,1,2,0.54,0.5152,0.42,0.0,55,168,223,223,True
6097,2011-09-16,3,0,9,14,0,5,1,2,0.54,0.5152,0.45,0.1642,49,176,225,225,True
6098,2011-09-16,3,0,9,15,0,5,1,2,0.54,0.5152,0.45,0.2239,38,165,203,203,True
6099,2011-09-16,3,0,9,16,0,5,1,2,0.52,0.5,0.48,0.1642,67,291,358,358,True
6100,2011-09-16,3,0,9,17,0,5,1,2,0.52,0.5,0.48,0.1343,86,480,566,566,True
6101,2011-09-16,3,0,9,18,0,5,1,2,0.52,0.5,0.52,0.1642,55,427,482,482,True
6102,2011-09-16,3,0,9,19,0,5,1,2,0.5,0.4848,0.55,0.1642,59,256,315,315,True
6103,2011-09-16,3,0,9,20,0,5,1,2,0.5,0.4848,0.55,0.0,41,184,225,225,True
6104,2011-09-16,3,0,9,21,0,5,1,2,0.5,0.4848,0.63,0.0,39,124,163,163,True
6105,2011-09-16,3,0,9,22,0,5,1,1,0.48,0.4697,0.67,0.0896,32,135,167,167,True
6106,2011-09-16,3,0,9,23,0,5,1,1,0.5,0.4848,0.59,0.0,20,106,126,126,True
6107,2011-09-17,3,0,9,0,0,6,0,1,0.46,0.4545,0.72,0.1642,28,80,108,108,True
6108,2011-09-17,3,0,9,1,0,6,0,1,0.46,0.4545,0.72,0.1045,28,52,80,80,True
6109,2011-09-17,3,0,9,2,0,6,0,1,0.46,0.4545,0.82,0.0896,18,61,79,79,True
6110,2011-09-17,3,0,9,3,0,6,0,1,0.46,0.4545,0.72,0.1343,7,21,28,28,True
6111,2011-09-17,3,0,9,4,0,6,0,1,0.46,0.4545,0.72,0.1343,1,4,5,5,True
6112,2011-09-17,3,0,9,5,0,6,0,1,0.46,0.4545,0.72,0.1642,2,3,5,5,True
6113,2011-09-17,3,0,9,6,0,6,0,2,0.46,0.4545,0.72,0.2239,5,17,22,22,True
6114,2011-09-17,3,0,9,7,0,6,0,2,0.46,0.4545,0.77,0.194,4,33,37,37,True
6115,2011-09-17,3,0,9,8,0,6,0,2,0.46,0.4545,0.77,0.2537,27,81,108,108,True
6116,2011-09-17,3,0,9,9,0,6,0,2,0.48,0.4697,0.67,0.2239,32,145,177,177,True
6117,2011-09-17,3,0,9,10,0,6,0,2,0.5,0.4848,0.68,0.2836,72,177,249,249,True
6118,2011-09-17,3,0,9,11,0,6,0,2,0.52,0.5,0.68,0.2239,114,248,362,362,True
6119,2011-09-17,3,0,9,12,0,6,0,2,0.52,0.5,0.67,0.2239,114,257,371,371,True
6120,2011-09-17,3,0,9,13,0,6,0,2,0.52,0.5,0.68,0.194,114,225,339,339,True
6121,2011-09-17,3,0,9,14,0,6,0,2,0.52,0.5,0.72,0.194,114,174,288,288,True
6122,2011-09-17,3,0,9,15,0,6,0,2,0.52,0.5,0.72,0.194,114,206,320,320,True
6123,2011-09-17,3,0,9,16,0,6,0,1,0.54,0.5152,0.68,0.2537,114,189,303,303,True
6124,2011-09-17,3,0,9,17,0,6,0,1,0.52,0.5,0.72,0.2239,114,218,332,332,True
6125,2011-09-17,3,0,9,18,0,6,0,2,0.52,0.5,0.72,0.2239,95,234,329,329,True
6126,2011-09-17,3,0,9,19,0,6,0,1,0.52,0.5,0.68,0.1343,70,186,256,256,True
6127,2011-09-17,3,0,9,20,0,6,0,1,0.52,0.5,0.68,0.1343,43,133,176,176,True
6128,2011-09-17,3,0,9,21,0,6,0,2,0.5,0.4848,0.72,0.194,49,121,170,170,True
6129,2011-09-17,3,0,9,22,0,6,0,1,0.5,0.4848,0.72,0.2239,31,112,143,143,True
6130,2011-09-17,3,0,9,23,0,6,0,1,0.46,0.4545,0.82,0.1642,36,100,136,136,True
6131,2011-09-18,3,0,9,0,0,0,0,1,0.46,0.4545,0.77,0.2239,24,88,112,112,True
6132,2011-09-18,3,0,9,1,0,0,0,1,0.46,0.4545,0.77,0.2239,13,66,79,79,True
6133,2011-09-18,3,0,9,2,0,0,0,1,0.44,0.4394,0.82,0.2537,21,68,89,89,True
6134,2011-09-18,3,0,9,3,0,0,0,1,0.44,0.4394,0.82,0.194,11,25,36,36,True
6135,2011-09-18,3,0,9,4,0,0,0,1,0.44,0.4394,0.77,0.2239,1,0,1,1,True
6136,2011-09-18,3,0,9,5,0,0,0,1,0.44,0.4394,0.77,0.2239,1,5,6,6,True
6137,2011-09-18,3,0,9,6,0,0,0,1,0.44,0.4394,0.77,0.2537,2,10,12,12,True
6138,2011-09-18,3,0,9,7,0,0,0,1,0.46,0.4545,0.72,0.2239,15,29,44,44,True
6139,2011-09-18,3,0,9,8,0,0,0,1,0.46,0.4545,0.72,0.2537,16,53,69,69,True
6140,2011-09-18,3,0,9,9,0,0,0,1,0.48,0.4697,0.67,0.2537,46,94,140,140,True
6141,2011-09-18,3,0,9,10,0,0,0,1,0.5,0.4848,0.72,0.1642,82,178,260,260,True
6142,2011-09-18,3,0,9,11,0,0,0,1,0.52,0.5,0.68,0.2239,114,201,315,315,True
6143,2011-09-18,3,0,9,12,0,0,0,1,0.54,0.5152,0.64,0.1343,114,229,343,343,True
6144,2011-09-18,3,0,9,13,0,0,0,1,0.56,0.5303,0.6,0.1343,114,214,328,328,True
6145,2011-09-18,3,0,9,14,0,0,0,2,0.58,0.5455,0.56,0.1343,114,184,298,298,True
6146,2011-09-18,3,0,9,15,0,0,0,2,0.58,0.5455,0.6,0.1343,114,233,347,347,True
6147,2011-09-18,3,0,9,16,0,0,0,2,0.56,0.5303,0.64,0.1642,114,235,349,349,True
6148,2011-09-18,3,0,9,17,0,0,0,2,0.56,0.5303,0.64,0.194,95,230,325,325,True
6149,2011-09-18,3,0,9,18,0,0,0,2,0.56,0.5303,0.6,0.1045,66,223,289,289,True
6150,2011-09-18,3,0,9,19,0,0,0,2,0.54,0.5152,0.68,0.1045,54,191,245,245,True
6151,2011-09-18,3,0,9,20,0,0,0,2,0.54,0.5152,0.68,0.0896,44,136,180,180,True
6152,2011-09-18,3,0,9,21,0,0,0,2,0.54,0.5152,0.68,0.0896,37,110,147,147,True
6153,2011-09-18,3,0,9,22,0,0,0,2,0.54,0.5152,0.68,0.0896,9,75,84,84,True
6154,2011-09-18,3,0,9,23,0,0,0,1,0.54,0.5152,0.68,0.194,10,44,54,54,True
6155,2011-09-19,3,0,9,0,0,1,1,2,0.52,0.5,0.72,0.1642,14,23,37,37,True
6156,2011-09-19,3,0,9,1,0,1,1,2,0.52,0.5,0.72,0.1045,3,7,10,10,True
6157,2011-09-19,3,0,9,2,0,1,1,2,0.52,0.5,0.72,0.1343,6,7,13,13,True
6158,2011-09-19,3,0,9,3,0,1,1,2,0.5,0.4848,0.77,0.1343,1,4,5,5,True
6159,2011-09-19,3,0,9,4,0,1,1,2,0.5,0.4848,0.77,0.1642,2,6,8,8,True
6160,2011-09-19,3,0,9,5,0,1,1,2,0.5,0.4848,0.77,0.194,2,26,28,28,True
6161,2011-09-19,3,0,9,6,0,1,1,1,0.5,0.4848,0.77,0.2239,6,107,113,113,True
6162,2011-09-19,3,0,9,7,0,1,1,2,0.5,0.4848,0.82,0.2239,20,312,332,332,True
6163,2011-09-19,3,0,9,8,0,1,1,2,0.52,0.5,0.77,0.1343,29,391,420,420,True
6164,2011-09-19,3,0,9,9,0,1,1,2,0.54,0.5152,0.68,0.1642,32,183,215,215,True
6165,2011-09-19,3,0,9,10,0,1,1,2,0.56,0.5303,0.64,0.1343,21,84,105,105,True
6166,2011-09-19,3,0,9,11,0,1,1,2,0.58,0.5455,0.64,0.1642,41,98,139,139,True
6167,2011-09-19,3,0,9,12,0,1,1,2,0.58,0.5455,0.6,0.0896,51,138,189,189,True
6168,2011-09-19,3,0,9,13,0,1,1,2,0.6,0.6061,0.6,0.0,53,124,177,177,True
6169,2011-09-19,3,0,9,14,0,1,1,2,0.6,0.6061,0.6,0.194,45,143,188,188,True
6170,2011-09-19,3,0,9,15,0,1,1,2,0.6,0.6061,0.6,0.2239,44,143,187,187,True
6171,2011-09-19,3,0,9,16,0,1,1,2,0.6,0.6061,0.6,0.1642,55,208,263,263,True
6172,2011-09-19,3,0,9,17,0,1,1,2,0.58,0.5455,0.64,0.1343,85,483,568,568,True
6173,2011-09-19,3,0,9,18,0,1,1,2,0.56,0.5303,0.68,0.1343,56,484,540,540,True
6174,2011-09-19,3,0,9,19,0,1,1,2,0.56,0.5303,0.68,0.1045,41,333,374,374,True
6175,2011-09-19,3,0,9,20,0,1,1,2,0.56,0.5303,0.68,0.1343,27,204,231,231,True
6176,2011-09-19,3,0,9,21,0,1,1,2,0.56,0.5303,0.68,0.1642,19,181,200,200,True
6177,2011-09-19,3,0,9,22,0,1,1,2,0.56,0.5303,0.68,0.1642,25,104,129,129,True
6178,2011-09-19,3,0,9,23,0,1,1,2,0.56,0.5303,0.73,0.194,13,55,68,68,True
6179,2011-09-20,3,0,9,0,0,2,1,2,0.56,0.5303,0.73,0.1642,4,21,25,25,True
6180,2011-09-20,3,0,9,1,0,2,1,2,0.54,0.5152,0.88,0.1642,3,11,14,14,True
6181,2011-09-20,3,0,9,2,0,2,1,2,0.54,0.5152,0.88,0.1642,1,4,5,5,True
6182,2011-09-20,3,0,9,3,0,2,1,2,0.54,0.5152,0.83,0.2239,0,3,3,3,True
6183,2011-09-20,3,0,9,4,0,2,1,1,0.54,0.5152,0.88,0.194,2,4,6,6,True
6184,2011-09-20,3,0,9,5,0,2,1,2,0.54,0.5152,0.88,0.194,1,21,22,22,True
6185,2011-09-20,3,0,9,6,0,2,1,2,0.54,0.5152,0.88,0.194,3,111,114,114,True
6186,2011-09-20,3,0,9,7,0,2,1,2,0.54,0.5152,0.88,0.1642,23,306,329,329,True
6187,2011-09-20,3,0,9,8,0,2,1,3,0.54,0.5152,0.94,0.2537,13,196,209,209,True
6188,2011-09-20,3,0,9,9,0,2,1,3,0.54,0.5152,0.94,0.2239,5,64,69,69,True
6189,2011-09-20,3,0,9,10,0,2,1,3,0.56,0.5303,0.88,0.1642,4,26,30,30,True
6190,2011-09-20,3,0,9,11,0,2,1,3,0.56,0.5303,0.88,0.1642,8,48,56,56,True
6191,2011-09-20,3,0,9,12,0,2,1,2,0.56,0.5303,0.94,0.1642,13,47,60,60,True
6192,2011-09-20,3,0,9,13,0,2,1,2,0.56,0.5303,0.94,0.1343,22,81,103,103,True
6193,2011-09-20,3,0,9,14,0,2,1,2,0.58,0.5455,0.88,0.194,27,85,112,112,True
6194,2011-09-20,3,0,9,15,0,2,1,2,0.62,0.5909,0.78,0.1045,34,158,192,192,True
6195,2011-09-20,3,0,9,16,0,2,1,2,0.6,0.5606,0.83,0.1642,23,241,264,264,True
6196,2011-09-20,3,0,9,17,0,2,1,1,0.6,0.5606,0.83,0.1045,66,445,511,511,True
6197,2011-09-20,3,0,9,18,0,2,1,1,0.6,0.5606,0.83,0.1045,39,453,492,492,True
6198,2011-09-20,3,0,9,19,0,2,1,1,0.58,0.5455,0.88,0.0,43,294,337,337,True
6199,2011-09-20,3,0,9,20,0,2,1,1,0.56,0.5303,0.94,0.0,41,212,253,253,True
6200,2011-09-20,3,0,9,21,0,2,1,1,0.56,0.5303,0.94,0.0,29,177,206,206,True
6201,2011-09-20,3,0,9,22,0,2,1,1,0.56,0.5303,0.94,0.0,23,125,148,148,True
6202,2011-09-20,3,0,9,23,0,2,1,1,0.56,0.5303,0.94,0.0,11,70,81,81,True
6203,2011-09-21,3,0,9,0,0,3,1,1,0.54,0.5152,1.0,0.0,7,20,27,27,True
6204,2011-09-21,3,0,9,1,0,3,1,1,0.54,0.5152,0.94,0.0,0,17,17,17,True
6205,2011-09-21,3,0,9,2,0,3,1,1,0.54,0.5152,0.94,0.0,1,5,6,6,True
6206,2011-09-21,3,0,9,3,0,3,1,2,0.54,0.5152,0.94,0.0896,0,6,6,6,True
6207,2011-09-21,3,0,9,4,0,3,1,2,0.54,0.5152,1.0,0.1343,2,5,7,7,True
6208,2011-09-21,3,0,9,5,0,3,1,2,0.54,0.5152,1.0,0.1642,1,30,31,31,True
6209,2011-09-21,3,0,9,6,0,3,1,2,0.54,0.5152,1.0,0.194,5,112,117,117,True
6210,2011-09-21,3,0,9,7,0,3,1,2,0.54,0.5152,1.0,0.194,18,312,330,330,True
6211,2011-09-21,3,0,9,8,0,3,1,2,0.54,0.5152,1.0,0.1045,18,444,462,462,True
6212,2011-09-21,3,0,9,9,0,3,1,2,0.56,0.5303,1.0,0.0896,21,187,208,208,True
6213,2011-09-21,3,0,9,10,0,3,1,2,0.6,0.5455,0.88,0.0,30,103,133,133,True
6214,2011-09-21,3,0,9,11,0,3,1,2,0.62,0.5758,0.83,0.1642,42,138,180,180,True
6215,2011-09-21,3,0,9,12,0,3,1,2,0.64,0.5909,0.78,0.0896,42,151,193,193,True
6216,2011-09-21,3,0,9,13,0,3,1,2,0.66,0.6212,0.74,0.1642,37,144,181,181,True
6217,2011-09-21,3,0,9,14,0,3,1,2,0.66,0.6212,0.74,0.194,40,139,179,179,True
6218,2011-09-21,3,0,9,15,0,3,1,2,0.66,0.6212,0.74,0.1045,43,142,185,185,True
6219,2011-09-21,3,0,9,16,0,3,1,2,0.66,0.6212,0.74,0.1045,51,230,281,281,True
6220,2011-09-21,3,0,9,17,0,3,1,3,0.66,0.6212,0.74,0.1642,61,475,536,536,True
6221,2011-09-21,3,0,9,18,0,3,1,3,0.64,0.5758,0.83,0.1642,24,384,408,408,True
6222,2011-09-21,3,0,9,19,0,3,1,3,0.62,0.5455,0.94,0.0,30,253,283,283,True
6223,2011-09-21,3,0,9,20,0,3,1,3,0.62,0.5455,0.94,0.0,11,149,160,160,True
6224,2011-09-21,3,0,9,21,0,3,1,2,0.6,0.5,1.0,0.0896,25,175,200,200,True
6225,2011-09-21,3,0,9,22,0,3,1,2,0.62,0.5455,0.94,0.0,15,112,127,127,True
6226,2011-09-21,3,0,9,23,0,3,1,1,0.6,0.5152,0.94,0.1045,15,80,95,95,True
6227,2011-09-22,3,0,9,0,0,4,1,1,0.6,0.5152,0.94,0.1045,11,30,41,41,True
6228,2011-09-22,3,0,9,1,0,4,1,2,0.6,0.5152,0.94,0.0896,5,6,11,11,True
6229,2011-09-22,3,0,9,2,0,4,1,2,0.6,0.5152,0.94,0.1045,2,8,10,10,True
6230,2011-09-22,3,0,9,3,0,4,1,2,0.6,0.5152,0.94,0.0896,5,7,12,12,True
6231,2011-09-22,3,0,9,4,0,4,1,2,0.6,0.5152,0.94,0.0896,0,2,2,2,True
6232,2011-09-22,3,0,9,5,0,4,1,2,0.6,0.5152,0.94,0.1045,2,28,30,30,True
6233,2011-09-22,3,0,9,6,0,4,1,2,0.6,0.5,1.0,0.1343,7,94,101,101,True
6234,2011-09-22,3,0,9,7,0,4,1,2,0.6,0.5,1.0,0.1045,16,295,311,311,True
6235,2011-09-22,3,0,9,8,0,4,1,2,0.6,0.5,1.0,0.1642,26,389,415,415,True
6236,2011-09-22,3,0,9,9,0,4,1,2,0.62,0.5455,0.94,0.194,35,168,203,203,True
6237,2011-09-22,3,0,9,10,0,4,1,2,0.64,0.5758,0.89,0.2239,19,101,120,120,True
6238,2011-09-22,3,0,9,11,0,4,1,2,0.64,0.5758,0.89,0.194,23,142,165,165,True
6239,2011-09-22,3,0,9,12,0,4,1,2,0.66,0.6061,0.83,0.1642,25,151,176,176,True
6240,2011-09-22,3,0,9,13,0,4,1,2,0.66,0.6061,0.83,0.194,38,155,193,193,True
6241,2011-09-22,3,0,9,14,0,4,1,2,0.66,0.6061,0.83,0.2239,41,142,183,183,True
6242,2011-09-22,3,0,9,15,0,4,1,2,0.68,0.6364,0.79,0.1642,32,149,181,181,True
6243,2011-09-22,3,0,9,16,0,4,1,2,0.68,0.6364,0.74,0.1343,39,262,301,301,True
6244,2011-09-22,3,0,9,17,0,4,1,2,0.66,0.6061,0.78,0.0896,50,499,549,549,True
6245,2011-09-22,3,0,9,18,0,4,1,2,0.64,0.5758,0.83,0.1045,50,499,549,549,True
6246,2011-09-22,3,0,9,19,0,4,1,2,0.64,0.5758,0.89,0.0896,32,388,420,420,True
6247,2011-09-22,3,0,9,20,0,4,1,2,0.62,0.5455,0.94,0.1343,35,250,285,285,True
6248,2011-09-22,3,0,9,21,0,4,1,2,0.64,0.5758,0.89,0.0896,27,194,221,221,True
6249,2011-09-22,3,0,9,22,0,4,1,2,0.62,0.5152,1.0,0.0896,21,166,187,187,True
6250,2011-09-22,3,0,9,23,0,4,1,2,0.62,0.5455,0.94,0.0,14,99,113,113,True
6251,2011-09-23,4,0,9,0,0,5,1,2,0.62,0.5455,0.94,0.0896,11,41,52,52,True
6252,2011-09-23,4,0,9,1,0,5,1,2,0.6,0.5,1.0,0.0,2,29,31,31,True
6253,2011-09-23,4,0,9,2,0,5,1,2,0.6,0.5,1.0,0.1045,6,14,20,20,True
6254,2011-09-23,4,0,9,3,0,5,1,2,0.6,0.5,1.0,0.0,3,5,8,8,True
6255,2011-09-23,4,0,9,4,0,5,1,3,0.6,0.5,1.0,0.0,6,7,13,13,True
6256,2011-09-23,4,0,9,5,0,5,1,2,0.62,0.5455,0.94,0.0,2,20,22,22,True
6257,2011-09-23,4,0,9,6,0,5,1,2,0.62,0.5455,0.94,0.0896,5,99,104,104,True
6258,2011-09-23,4,0,9,7,0,5,1,3,0.62,0.5455,0.94,0.1343,14,240,254,254,True
6259,2011-09-23,4,0,9,8,0,5,1,3,0.62,0.5455,0.94,0.1343,20,297,317,317,True
6260,2011-09-23,4,0,9,9,0,5,1,3,0.62,0.5152,1.0,0.1343,3,108,111,111,True
6261,2011-09-23,4,0,9,10,0,5,1,3,0.62,0.5152,1.0,0.1045,7,28,35,35,True
6262,2011-09-23,4,0,9,11,0,5,1,3,0.62,0.5152,1.0,0.1045,1,20,21,21,True
6263,2011-09-23,4,0,9,12,0,5,1,3,0.62,0.5455,0.94,0.1045,1,28,29,29,True
6264,2011-09-23,4,0,9,13,0,5,1,3,0.6,0.5,1.0,0.0896,7,27,34,34,True
6265,2011-09-23,4,0,9,14,0,5,1,3,0.6,0.5,1.0,0.0896,3,21,24,24,True
6266,2011-09-23,4,0,9,15,0,5,1,3,0.62,0.5455,0.94,0.1045,9,52,61,61,True
6267,2011-09-23,4,0,9,16,0,5,1,3,0.62,0.5455,0.94,0.0,5,51,56,56,True
6268,2011-09-23,4,0,9,17,0,5,1,2,0.6,0.5,1.0,0.0,13,86,99,99,True
6269,2011-09-23,4,0,9,18,0,5,1,1,0.6,0.5,1.0,0.0,14,220,234,234,True
6270,2011-09-23,4,0,9,19,0,5,1,1,0.62,0.5455,0.94,0.1343,16,232,248,248,True
6271,2011-09-23,4,0,9,20,0,5,1,1,0.6,0.5152,0.94,0.0,21,158,179,179,True
6272,2011-09-23,4,0,9,21,0,5,1,1,0.6,0.5,1.0,0.1642,17,121,138,138,True
6273,2011-09-23,4,0,9,22,0,5,1,1,0.6,0.5152,0.94,0.1642,31,126,157,157,True
6274,2011-09-23,4,0,9,23,0,5,1,2,0.58,0.5455,1.0,0.1343,41,107,148,148,True
6275,2011-09-24,4,0,9,0,0,6,0,1,0.58,0.5455,1.0,0.0896,7,86,93,93,True
6276,2011-09-24,4,0,9,1,0,6,0,2,0.58,0.5455,0.94,0.0896,18,61,79,79,True
6277,2011-09-24,4,0,9,2,0,6,0,2,0.58,0.5455,0.94,0.0896,14,54,68,68,True
6278,2011-09-24,4,0,9,3,0,6,0,1,0.58,0.5455,0.94,0.0,4,27,31,31,True
6279,2011-09-24,4,0,9,4,0,6,0,1,0.56,0.5303,0.94,0.1045,1,7,8,8,True
6280,2011-09-24,4,0,9,5,0,6,0,2,0.56,0.5303,0.94,0.1045,2,3,5,5,True
6281,2011-09-24,4,0,9,6,0,6,0,2,0.56,0.5303,0.94,0.1045,6,12,18,18,True
6282,2011-09-24,4,0,9,7,0,6,0,2,0.56,0.5303,0.88,0.1045,12,34,46,46,True
6283,2011-09-24,4,0,9,8,0,6,0,2,0.58,0.5455,0.9,0.0896,19,102,121,121,True
6284,2011-09-24,4,0,9,9,0,6,0,2,0.6,0.5455,0.88,0.0896,41,134,175,175,True
6285,2011-09-24,4,0,9,10,0,6,0,2,0.6,0.5455,0.88,0.0896,90,203,293,293,True
6286,2011-09-24,4,0,9,11,0,6,0,2,0.62,0.5758,0.83,0.0896,114,268,382,382,True
6287,2011-09-24,4,0,9,12,0,6,0,2,0.62,0.5758,0.83,0.0896,114,266,380,380,True
6288,2011-09-24,4,0,9,13,0,6,0,1,0.64,0.5909,0.78,0.0,114,290,404,404,True
6289,2011-09-24,4,0,9,14,0,6,0,2,0.66,0.6212,0.74,0.1343,114,226,340,340,True
6290,2011-09-24,4,0,9,15,0,6,0,2,0.66,0.6212,0.74,0.1343,114,284,398,398,True
6291,2011-09-24,4,0,9,16,0,6,0,2,0.64,0.5909,0.78,0.0896,114,282,396,396,True
6292,2011-09-24,4,0,9,17,0,6,0,1,0.66,0.6212,0.74,0.1045,114,246,360,360,True
6293,2011-09-24,4,0,9,18,0,6,0,1,0.64,0.5909,0.78,0.1045,114,243,357,357,True
6294,2011-09-24,4,0,9,19,0,6,0,1,0.62,0.5606,0.88,0.0,77,231,308,308,True
6295,2011-09-24,4,0,9,20,0,6,0,1,0.62,0.5758,0.83,0.0,77,166,243,243,True
6296,2011-09-24,4,0,9,21,0,6,0,1,0.62,0.5758,0.83,0.0896,66,156,222,222,True
6297,2011-09-24,4,0,9,22,0,6,0,2,0.62,0.5606,0.88,0.0,50,143,193,193,True
6298,2011-09-24,4,0,9,23,0,6,0,2,0.6,0.5455,0.88,0.0896,27,123,150,150,True
6299,2011-09-25,4,0,9,0,0,0,0,2,0.6,0.5455,0.88,0.0,37,136,173,173,True
6300,2011-09-25,4,0,9,1,0,0,0,2,0.6,0.5455,0.88,0.1045,31,93,124,124,True
6301,2011-09-25,4,0,9,2,0,0,0,3,0.6,0.5152,0.94,0.0,27,79,106,106,True
6302,2011-09-25,4,0,9,3,0,0,0,3,0.6,0.5152,0.94,0.0,20,39,59,59,True
6303,2011-09-25,4,0,9,4,0,0,0,3,0.6,0.5152,0.94,0.1343,3,5,8,8,True
6304,2011-09-25,4,0,9,5,0,0,0,1,0.6,0.5455,0.88,0.0896,1,2,3,3,True
6305,2011-09-25,4,0,9,6,0,0,0,2,0.6,0.5455,0.88,0.1045,4,13,17,17,True
6306,2011-09-25,4,0,9,7,0,0,0,2,0.6,0.5152,0.94,0.1343,15,23,38,38,True
6307,2011-09-25,4,0,9,8,0,0,0,2,0.62,0.5606,0.88,0.0,27,59,86,86,True
6308,2011-09-25,4,0,9,9,0,0,0,2,0.64,0.5758,0.83,0.0,55,100,155,155,True
6309,2011-09-25,4,0,9,10,0,0,0,2,0.64,0.5758,0.83,0.0,85,190,275,275,True
6310,2011-09-25,4,0,9,11,0,0,0,2,0.66,0.6061,0.78,0.1343,114,230,344,344,True
6311,2011-09-25,4,0,9,12,0,0,0,2,0.66,0.6061,0.78,0.0,114,270,384,384,True
6312,2011-09-25,4,0,9,13,0,0,0,2,0.68,0.6364,0.74,0.0,114,247,361,361,True
6313,2011-09-25,4,0,9,14,0,0,0,2,0.66,0.6061,0.78,0.0,114,231,345,345,True
6314,2011-09-25,4,0,9,15,0,0,0,2,0.66,0.6061,0.78,0.0,114,234,348,348,True
6315,2011-09-25,4,0,9,16,0,0,0,1,0.7,0.6515,0.7,0.0,114,320,434,434,True
6316,2011-09-25,4,0,9,17,0,0,0,1,0.68,0.6364,0.74,0.0,114,275,389,389,True
6317,2011-09-25,4,0,9,18,0,0,0,1,0.68,0.6364,0.74,0.0,114,279,393,393,True
6318,2011-09-25,4,0,9,19,0,0,0,1,0.64,0.5758,0.83,0.1343,87,242,329,329,True
6319,2011-09-25,4,0,9,20,0,0,0,1,0.64,0.5758,0.83,0.0896,51,135,186,186,True
6320,2011-09-25,4,0,9,21,0,0,0,1,0.62,0.5455,0.94,0.0896,24,113,137,137,True
6321,2011-09-25,4,0,9,22,0,0,0,1,0.62,0.5606,0.88,0.0896,20,84,104,104,True
6322,2011-09-25,4,0,9,23,0,0,0,2,0.62,0.5455,0.94,0.1045,12,67,79,79,True
6323,2011-09-26,4,0,9,0,0,1,1,2,0.62,0.5455,0.94,0.0,6,23,29,29,True
6324,2011-09-26,4,0,9,1,0,1,1,2,0.62,0.5606,0.88,0.1045,3,14,17,17,True
6325,2011-09-26,4,0,9,2,0,1,1,2,0.62,0.5606,0.88,0.1045,4,4,8,8,True
6326,2011-09-26,4,0,9,3,0,1,1,2,0.62,0.5455,0.94,0.0,0,5,5,5,True
6327,2011-09-26,4,0,9,4,0,1,1,2,0.62,0.5455,0.94,0.0896,2,4,6,6,True
6328,2011-09-26,4,0,9,5,0,1,1,2,0.62,0.5606,0.88,0.0,0,25,25,25,True
6329,2011-09-26,4,0,9,6,0,1,1,2,0.62,0.5455,0.94,0.0896,6,107,113,113,True
6330,2011-09-26,4,0,9,7,0,1,1,2,0.62,0.5455,0.94,0.0,17,315,332,332,True
6331,2011-09-26,4,0,9,8,0,1,1,2,0.62,0.5455,0.94,0.0,29,326,355,355,True
6332,2011-09-26,4,0,9,9,0,1,1,2,0.64,0.5758,0.89,0.194,44,161,205,205,True
6333,2011-09-26,4,0,9,10,0,1,1,2,0.64,0.5758,0.89,0.194,37,117,154,154,True
6334,2011-09-26,4,0,9,11,0,1,1,1,0.68,0.6364,0.79,0.2239,43,116,159,159,True
6335,2011-09-26,4,0,9,12,0,1,1,2,0.68,0.6364,0.79,0.1642,48,161,209,209,True
6336,2011-09-26,4,0,9,13,0,1,1,2,0.7,0.6667,0.74,0.1642,48,139,187,187,True
6337,2011-09-26,4,0,9,14,0,1,1,1,0.7,0.6515,0.7,0.1642,44,110,154,154,True
6338,2011-09-26,4,0,9,15,0,1,1,1,0.72,0.6818,0.62,0.1343,52,157,209,209,True
6339,2011-09-26,4,0,9,16,0,1,1,1,0.7,0.6515,0.65,0.1642,74,239,313,313,True
6340,2011-09-26,4,0,9,17,0,1,1,1,0.7,0.6515,0.7,0.1343,61,499,560,560,True
6341,2011-09-26,4,0,9,18,0,1,1,1,0.66,0.6061,0.83,0.1045,63,490,553,553,True
6342,2011-09-26,4,0,9,19,0,1,1,1,0.66,0.6061,0.82,0.0896,36,347,383,383,True
6343,2011-09-26,4,0,9,20,0,1,1,1,0.64,0.5758,0.89,0.1343,24,227,251,251,True
6344,2011-09-26,4,0,9,21,0,1,1,1,0.64,0.5758,0.89,0.1343,18,164,182,182,True
6345,2011-09-26,4,0,9,22,0,1,1,1,0.62,0.5455,0.94,0.1343,14,122,136,136,True
6346,2011-09-26,4,0,9,23,0,1,1,1,0.62,0.5455,0.94,0.1343,11,64,75,75,True
6347,2011-09-27,4,0,9,0,0,2,1,1,0.62,0.5455,0.94,0.1343,9,28,37,37,True
6348,2011-09-27,4,0,9,1,0,2,1,1,0.62,0.5455,0.94,0.1642,4,6,10,10,True
6349,2011-09-27,4,0,9,2,0,2,1,1,0.62,0.5455,0.94,0.1045,7,4,11,11,True
6350,2011-09-27,4,0,9,3,0,2,1,2,0.62,0.5455,0.94,0.0,5,5,10,10,True
6351,2011-09-27,4,0,9,4,0,2,1,3,0.62,0.5455,0.94,0.0896,5,3,8,8,True
6352,2011-09-27,4,0,9,5,0,2,1,3,0.62,0.5455,0.94,0.0896,0,24,24,24,True
6353,2011-09-27,4,0,9,6,0,2,1,2,0.62,0.5455,0.94,0.1045,8,116,124,124,True
6354,2011-09-27,4,0,9,7,0,2,1,2,0.62,0.5455,0.94,0.1045,15,234,249,249,True
6355,2011-09-27,4,0,9,8,0,2,1,2,0.64,0.5758,0.89,0.1045,27,400,427,427,True
6356,2011-09-27,4,0,9,9,0,2,1,3,0.64,0.5758,0.89,0.194,20,173,193,193,True
6357,2011-09-27,4,0,9,10,0,2,1,3,0.64,0.5606,0.94,0.1642,21,101,122,122,True
6358,2011-09-27,4,0,9,11,0,2,1,2,0.66,0.5909,0.89,0.1045,26,97,123,123,True
6359,2011-09-27,4,0,9,12,0,2,1,2,0.66,0.5909,0.89,0.1343,33,129,162,162,True
6360,2011-09-27,4,0,9,13,0,2,1,2,0.7,0.6667,0.74,0.2239,29,122,151,151,True
6361,2011-09-27,4,0,9,14,0,2,1,2,0.68,0.6364,0.79,0.1045,29,123,152,152,True
6362,2011-09-27,4,0,9,15,0,2,1,2,0.68,0.6364,0.83,0.0896,35,170,205,205,True
6363,2011-09-27,4,0,9,16,0,2,1,2,0.66,0.6061,0.83,0.194,33,225,258,258,True
6364,2011-09-27,4,0,9,17,0,2,1,2,0.66,0.5909,0.89,0.194,50,480,530,530,True
6365,2011-09-27,4,0,9,18,0,2,1,2,0.64,0.5758,0.89,0.2239,31,325,356,356,True
6366,2011-09-27,4,0,9,19,0,2,1,2,0.64,0.5758,0.89,0.1343,26,294,320,320,True
6367,2011-09-27,4,0,9,20,0,2,1,1,0.62,0.5909,0.78,0.0,17,221,238,238,True
6368,2011-09-27,4,0,9,21,0,2,1,1,0.6,0.5606,0.83,0.0,17,179,196,196,True
6369,2011-09-27,4,0,9,22,0,2,1,1,0.6,0.5455,0.88,0.0896,19,102,121,121,True
6370,2011-09-27,4,0,9,23,0,2,1,1,0.6,0.5455,0.88,0.0896,11,82,93,93,True
6371,2011-09-28,4,0,9,0,0,3,1,1,0.6,0.5455,0.88,0.0,7,29,36,36,True
6372,2011-09-28,4,0,9,1,0,3,1,1,0.6,0.5455,0.88,0.0,1,13,14,14,True
6373,2011-09-28,4,0,9,2,0,3,1,1,0.6,0.5455,0.88,0.2537,0,9,9,9,True
6374,2011-09-28,4,0,9,3,0,3,1,2,0.6,0.5152,0.94,0.0896,0,3,3,3,True
6375,2011-09-28,4,0,9,4,0,3,1,1,0.6,0.5455,0.88,0.0,1,3,4,4,True
6376,2011-09-28,4,0,9,5,0,3,1,2,0.6,0.5152,0.94,0.0,2,20,22,22,True
6377,2011-09-28,4,0,9,6,0,3,1,3,0.6,0.5152,0.94,0.1642,3,111,114,114,True
6378,2011-09-28,4,0,9,7,0,3,1,3,0.6,0.5152,0.94,0.1642,8,177,185,185,True
6379,2011-09-28,4,0,9,8,0,3,1,3,0.62,0.5455,0.94,0.2239,17,270,287,287,True
6380,2011-09-28,4,0,9,9,0,3,1,3,0.62,0.5455,0.94,0.2239,14,141,155,155,True
6381,2011-09-28,4,0,9,10,0,3,1,2,0.62,0.5455,0.94,0.0,20,109,129,129,True
6382,2011-09-28,4,0,9,11,0,3,1,2,0.66,0.6061,0.83,0.1045,24,127,151,151,True
6383,2011-09-28,4,0,9,12,0,3,1,2,0.68,0.6364,0.79,0.0,25,159,184,184,True
6384,2011-09-28,4,0,9,13,0,3,1,1,0.7,0.6667,0.74,0.2537,24,138,162,162,True
6385,2011-09-28,4,0,9,14,0,3,1,1,0.72,0.6818,0.62,0.2537,25,145,170,170,True
6386,2011-09-28,4,0,9,15,0,3,1,1,0.7,0.6515,0.7,0.1343,35,146,181,181,True
6387,2011-09-28,4,0,9,16,0,3,1,1,0.7,0.6515,0.7,0.194,39,241,280,280,True
6388,2011-09-28,4,0,9,17,0,3,1,1,0.7,0.6515,0.7,0.2239,64,499,563,563,True
6389,2011-09-28,4,0,9,18,0,3,1,3,0.66,0.6061,0.83,0.2537,65,459,524,524,True
6390,2011-09-28,4,0,9,19,0,3,1,3,0.66,0.6061,0.83,0.2537,57,315,372,372,True
6391,2011-09-28,4,0,9,20,0,3,1,3,0.6,0.5606,0.83,0.2985,11,91,102,102,True
6392,2011-09-28,4,0,9,21,0,3,1,3,0.6,0.5455,0.88,0.2537,7,67,74,74,True
6393,2011-09-28,4,0,9,22,0,3,1,1,0.6,0.5455,0.88,0.0896,19,68,87,87,True
6394,2011-09-28,4,0,9,23,0,3,1,1,0.6,0.5152,0.94,0.1343,12,59,71,71,True
6395,2011-09-29,4,0,9,0,0,4,1,1,0.6,0.5152,0.94,0.194,7,33,40,40,True
6396,2011-09-29,4,0,9,1,0,4,1,2,0.6,0.5,1.0,0.194,3,20,23,23,True
6397,2011-09-29,4,0,9,2,0,4,1,2,0.6,0.5,1.0,0.194,0,2,2,2,True
6398,2011-09-29,4,0,9,3,0,4,1,2,0.6,0.5152,0.94,0.194,0,8,8,8,True
6399,2011-09-29,4,0,9,4,0,4,1,2,0.6,0.5455,0.88,0.194,2,5,7,7,True
6400,2011-09-29,4,0,9,5,0,4,1,2,0.6,0.5455,0.88,0.1045,0,22,22,22,True
6401,2011-09-29,4,0,9,6,0,4,1,2,0.6,0.5455,0.88,0.0896,5,106,111,111,True
6402,2011-09-29,4,0,9,7,0,4,1,1,0.6,0.5455,0.88,0.1343,14,269,283,283,True
6403,2011-09-29,4,0,9,8,0,4,1,1,0.6,0.5606,0.83,0.0,29,402,431,431,True
6404,2011-09-29,4,0,9,9,0,4,1,1,0.62,0.5909,0.78,0.2537,27,198,225,225,True
6405,2011-09-29,4,0,9,10,0,4,1,1,0.64,0.6061,0.65,0.194,24,103,127,127,True
6406,2011-09-29,4,0,9,11,0,4,1,1,0.62,0.6061,0.61,0.194,36,122,158,158,True
6407,2011-09-29,4,0,9,12,0,4,1,1,0.66,0.6212,0.61,0.1642,38,157,195,195,True
6408,2011-09-29,4,0,9,13,0,4,1,1,0.64,0.6212,0.61,0.194,36,175,211,211,True
6409,2011-09-29,4,0,9,14,0,4,1,1,0.68,0.6364,0.51,0.2985,33,134,167,167,True
6410,2011-09-29,4,0,9,15,0,4,1,1,0.68,0.6364,0.45,0.3881,42,185,227,227,True
6411,2011-09-29,4,0,9,16,0,4,1,1,0.68,0.6364,0.41,0.3582,64,227,291,291,True
6412,2011-09-29,4,0,9,17,0,4,1,1,0.66,0.6212,0.47,0.2985,62,499,561,561,True
6413,2011-09-29,4,0,9,18,0,4,1,1,0.64,0.6212,0.41,0.2239,84,499,583,583,True
6414,2011-09-29,4,0,9,19,0,4,1,1,0.62,0.6212,0.5,0.0896,36,348,384,384,True
6415,2011-09-29,4,0,9,20,0,4,1,1,0.6,0.6212,0.53,0.0896,39,234,273,273,True
6416,2011-09-29,4,0,9,21,0,4,1,1,0.58,0.5455,0.56,0.0,30,195,225,225,True
6417,2011-09-29,4,0,9,22,0,4,1,1,0.56,0.5303,0.68,0.0,25,150,175,175,True
6418,2011-09-29,4,0,9,23,0,4,1,1,0.52,0.5,0.77,0.1045,17,64,81,81,True
6419,2011-09-30,4,0,9,0,0,5,1,1,0.52,0.5,0.83,0.1045,7,53,60,60,True
6420,2011-09-30,4,0,9,1,0,5,1,1,0.52,0.5,0.77,0.0896,5,18,23,23,True
6421,2011-09-30,4,0,9,2,0,5,1,1,0.52,0.5,0.83,0.1045,6,9,15,15,True
6422,2011-09-30,4,0,9,3,0,5,1,1,0.52,0.5,0.83,0.1045,0,3,3,3,True
6423,2011-09-30,4,0,9,4,0,5,1,1,0.52,0.5,0.83,0.194,2,6,8,8,True
6424,2011-09-30,4,0,9,5,0,5,1,1,0.52,0.5,0.83,0.194,3,23,26,26,True
6425,2011-09-30,4,0,9,6,0,5,1,1,0.52,0.5,0.83,0.2239,0,98,98,98,True
6426,2011-09-30,4,0,9,7,0,5,1,1,0.52,0.5,0.83,0.2239,14,283,297,297,True
6427,2011-09-30,4,0,9,8,0,5,1,1,0.54,0.5152,0.77,0.1343,31,425,456,456,True
6428,2011-09-30,4,0,9,9,0,5,1,1,0.56,0.5303,0.73,0.194,23,214,237,237,True
6429,2011-09-30,4,0,9,10,0,5,1,1,0.6,0.6061,0.64,0.0,46,122,168,168,True
6430,2011-09-30,4,0,9,11,0,5,1,1,0.64,0.6212,0.57,0.0896,49,168,217,217,True
6431,2011-09-30,4,0,9,12,0,5,1,2,0.64,0.6212,0.57,0.194,59,195,254,254,True
6432,2011-09-30,4,0,9,13,0,5,1,2,0.66,0.6212,0.47,0.3284,72,194,266,266,True
6433,2011-09-30,4,0,9,14,0,5,1,2,0.64,0.6212,0.47,0.2985,93,173,266,266,True
6434,2011-09-30,4,0,9,15,0,5,1,1,0.64,0.6212,0.5,0.2836,52,193,245,245,True
6435,2011-09-30,4,0,9,16,0,5,1,1,0.62,0.6212,0.53,0.2239,62,298,360,360,True
6436,2011-09-30,4,0,9,17,0,5,1,1,0.62,0.6212,0.53,0.194,94,497,591,591,True
6437,2011-09-30,4,0,9,18,0,5,1,1,0.58,0.5455,0.49,0.3582,62,449,511,511,True
6438,2011-09-30,4,0,9,19,0,5,1,1,0.54,0.5152,0.52,0.2836,42,332,374,374,True
6439,2011-09-30,4,0,9,20,0,5,1,1,0.54,0.5152,0.52,0.2836,28,202,230,230,True
6440,2011-09-30,4,0,9,21,0,5,1,1,0.52,0.5,0.55,0.194,27,179,206,206,True
6441,2011-09-30,4,0,9,22,0,5,1,1,0.52,0.5,0.55,0.3284,30,129,159,159,True
6442,2011-09-30,4,0,9,23,0,5,1,1,0.52,0.5,0.55,0.3284,23,109,132,132,True
6443,2011-10-01,4,0,10,0,0,6,0,1,0.5,0.4848,0.63,0.3881,24,106,130,130,True
6444,2011-10-01,4,0,10,1,0,6,0,1,0.48,0.4697,0.67,0.3284,11,47,58,58,True
6445,2011-10-01,4,0,10,2,0,6,0,1,0.46,0.4545,0.63,0.4179,21,46,67,67,True
6446,2011-10-01,4,0,10,3,0,6,0,1,0.46,0.4545,0.59,0.4179,8,17,25,25,True
6447,2011-10-01,4,0,10,4,0,6,0,1,0.44,0.4394,0.58,0.4179,2,6,8,8,True
6448,2011-10-01,4,0,10,5,0,6,0,2,0.44,0.4394,0.62,0.2985,1,4,5,5,True
6449,2011-10-01,4,0,10,6,0,6,0,1,0.42,0.4242,0.67,0.3284,4,15,19,19,True
6450,2011-10-01,4,0,10,7,0,6,0,3,0.42,0.4242,0.67,0.2537,6,30,36,36,True
6451,2011-10-01,4,0,10,8,0,6,0,2,0.4,0.4091,0.76,0.3284,9,58,67,67,True
6452,2011-10-01,4,0,10,9,0,6,0,3,0.4,0.4091,0.82,0.3582,17,112,129,129,True
6453,2011-10-01,4,0,10,10,0,6,0,3,0.4,0.4091,0.76,0.3582,21,100,121,121,True
6454,2011-10-01,4,0,10,11,0,6,0,3,0.38,0.3939,0.82,0.3284,30,102,132,132,True
6455,2011-10-01,4,0,10,12,0,6,0,2,0.4,0.4091,0.82,0.2537,28,130,158,158,True
6456,2011-10-01,4,0,10,13,0,6,0,2,0.4,0.4091,0.82,0.3284,27,98,125,125,True
6457,2011-10-01,4,0,10,14,0,6,0,2,0.42,0.4242,0.71,0.3582,33,147,180,180,True
6458,2011-10-01,4,0,10,15,0,6,0,2,0.42,0.4242,0.71,0.2836,41,154,195,195,True
6459,2011-10-01,4,0,10,16,0,6,0,2,0.4,0.4091,0.76,0.2985,58,165,223,223,True
6460,2011-10-01,4,0,10,17,0,6,0,3,0.4,0.4091,0.76,0.194,58,170,228,228,True
6461,2011-10-01,4,0,10,18,0,6,0,3,0.38,0.3939,0.87,0.2239,23,117,140,140,True
6462,2011-10-01,4,0,10,19,0,6,0,2,0.38,0.3939,0.82,0.194,27,99,126,126,True
6463,2011-10-01,4,0,10,20,0,6,0,3,0.36,0.3636,0.87,0.1045,8,58,66,66,True
6464,2011-10-01,4,0,10,21,0,6,0,3,0.36,0.3636,0.87,0.1045,3,53,56,56,True
6465,2011-10-01,4,0,10,22,0,6,0,2,0.36,0.3485,0.93,0.2239,12,58,70,70,True
6466,2011-10-01,4,0,10,23,0,6,0,3,0.36,0.3485,0.93,0.2239,8,57,65,65,True
6467,2011-10-02,4,0,10,0,0,0,0,3,0.36,0.3333,0.93,0.2985,4,43,47,47,True
6468,2011-10-02,4,0,10,1,0,0,0,3,0.34,0.3182,0.87,0.2537,1,23,24,24,True
6469,2011-10-02,4,0,10,2,0,0,0,3,0.34,0.303,0.87,0.2985,3,27,30,30,True
6470,2011-10-02,4,0,10,3,0,0,0,3,0.34,0.3182,0.87,0.2836,4,5,9,9,True
6471,2011-10-02,4,0,10,4,0,0,0,2,0.34,0.3182,0.87,0.2537,4,3,7,7,True
6472,2011-10-02,4,0,10,5,0,0,0,1,0.32,0.303,0.87,0.2836,0,7,7,7,True
6473,2011-10-02,4,0,10,6,0,0,0,1,0.32,0.3182,0.81,0.1642,2,13,15,15,True
6474,2011-10-02,4,0,10,7,0,0,0,1,0.34,0.3333,0.76,0.194,5,24,29,29,True
6475,2011-10-02,4,0,10,8,0,0,0,2,0.34,0.3333,0.76,0.194,14,50,64,64,True
6476,2011-10-02,4,0,10,9,0,0,0,1,0.36,0.3333,0.76,0.3582,19,96,115,115,True
6477,2011-10-02,4,0,10,10,0,0,0,2,0.36,0.3333,0.71,0.2836,60,188,248,248,True
6478,2011-10-02,4,0,10,11,0,0,0,2,0.38,0.3939,0.66,0.2537,74,218,292,292,True
6479,2011-10-02,4,0,10,12,0,0,0,2,0.4,0.4091,0.62,0.194,78,243,321,321,True
6480,2011-10-02,4,0,10,13,0,0,0,3,0.4,0.4091,0.62,0.2239,84,224,308,308,True
6481,2011-10-02,4,0,10,14,0,0,0,3,0.36,0.3485,0.81,0.1642,61,195,256,256,True
6482,2011-10-02,4,0,10,15,0,0,0,3,0.36,0.3333,0.81,0.2537,29,144,173,173,True
6483,2011-10-02,4,0,10,16,0,0,0,3,0.36,0.3485,0.87,0.194,44,162,206,206,True
6484,2011-10-02,4,0,10,17,0,0,0,3,0.36,0.3485,0.87,0.1642,32,135,167,167,True
6485,2011-10-02,4,0,10,18,0,0,0,2,0.36,0.3485,0.81,0.194,16,158,174,174,True
6486,2011-10-02,4,0,10,19,0,0,0,2,0.38,0.3939,0.76,0.1642,34,128,162,162,True
6487,2011-10-02,4,0,10,20,0,0,0,2,0.36,0.3333,0.76,0.2537,16,71,87,87,True
6488,2011-10-02,4,0,10,21,0,0,0,1,0.36,0.3485,0.71,0.2239,17,71,88,88,True
6489,2011-10-02,4,0,10,22,0,0,0,3,0.36,0.3636,0.81,0.0896,9,55,64,64,True
6490,2011-10-02,4,0,10,23,0,0,0,1,0.36,0.3636,0.81,0.0896,6,19,25,25,True
6491,2011-10-03,4,0,10,0,0,1,1,1,0.34,0.3485,0.87,0.1045,3,13,16,16,True
6492,2011-10-03,4,0,10,1,0,1,1,1,0.36,0.3636,0.81,0.0896,1,5,6,6,True
6493,2011-10-03,4,0,10,2,0,1,1,1,0.36,0.3636,0.76,0.1045,0,4,4,4,True
6494,2011-10-03,4,0,10,3,0,1,1,1,0.36,0.3788,0.81,0.0,1,6,7,7,True
6495,2011-10-03,4,0,10,4,0,1,1,1,0.34,0.3485,0.87,0.1045,2,6,8,8,True
6496,2011-10-03,4,0,10,5,0,1,1,2,0.36,0.3636,0.76,0.1045,4,17,21,21,True
6497,2011-10-03,4,0,10,6,0,1,1,2,0.36,0.3788,0.71,0.0,3,91,94,94,True
6498,2011-10-03,4,0,10,7,0,1,1,2,0.36,0.3485,0.71,0.1343,8,241,249,249,True
6499,2011-10-03,4,0,10,8,0,1,1,2,0.36,0.3636,0.71,0.1045,13,359,372,372,True
6500,2011-10-03,4,0,10,9,0,1,1,2,0.4,0.4091,0.66,0.0896,12,141,153,153,True
6501,2011-10-03,4,0,10,10,0,1,1,2,0.4,0.4091,0.66,0.1045,19,82,101,101,True
6502,2011-10-03,4,0,10,11,0,1,1,2,0.4,0.4091,0.71,0.2239,26,100,126,126,True
6503,2011-10-03,4,0,10,12,0,1,1,2,0.4,0.4091,0.71,0.1343,29,118,147,147,True
6504,2011-10-03,4,0,10,13,0,1,1,3,0.42,0.4242,0.67,0.1642,16,102,118,118,True
6505,2011-10-03,4,0,10,14,0,1,1,3,0.4,0.4091,0.76,0.0,26,94,120,120,True
6506,2011-10-03,4,0,10,15,0,1,1,3,0.4,0.4091,0.76,0.0,22,79,101,101,True
6507,2011-10-03,4,0,10,16,0,1,1,2,0.4,0.4091,0.76,0.1045,16,202,218,218,True
6508,2011-10-03,4,0,10,17,0,1,1,2,0.4,0.4091,0.76,0.1642,40,455,495,495,True
6509,2011-10-03,4,0,10,18,0,1,1,2,0.4,0.4091,0.76,0.1642,28,384,412,412,True
6510,2011-10-03,4,0,10,19,0,1,1,1,0.4,0.4091,0.76,0.0,15,300,315,315,True
6511,2011-10-03,4,0,10,20,0,1,1,3,0.4,0.4091,0.82,0.0,13,191,204,204,True
6512,2011-10-03,4,0,10,21,0,1,1,2,0.4,0.4091,0.82,0.0,10,128,138,138,True
6513,2011-10-03,4,0,10,22,0,1,1,2,0.4,0.4091,0.82,0.0,12,79,91,91,True
6514,2011-10-03,4,0,10,23,0,1,1,2,0.4,0.4091,0.82,0.1045,11,43,54,54,True
6515,2011-10-04,4,0,10,0,0,2,1,2,0.4,0.4091,0.87,0.0896,5,22,27,27,True
6516,2011-10-04,4,0,10,1,0,2,1,2,0.4,0.4091,0.87,0.1045,1,8,9,9,True
6517,2011-10-04,4,0,10,2,0,2,1,2,0.4,0.4091,0.87,0.0,1,2,3,3,True
6518,2011-10-04,4,0,10,3,0,2,1,1,0.4,0.4091,0.82,0.1045,3,3,6,6,True
6519,2011-10-04,4,0,10,4,0,2,1,1,0.4,0.4091,0.82,0.0896,3,4,7,7,True
6520,2011-10-04,4,0,10,5,0,2,1,1,0.4,0.4091,0.82,0.1343,2,25,27,27,True
6521,2011-10-04,4,0,10,6,0,2,1,1,0.4,0.4091,0.82,0.1045,3,109,112,112,True
6522,2011-10-04,4,0,10,7,0,2,1,1,0.42,0.4242,0.82,0.2836,11,298,309,309,True
6523,2011-10-04,4,0,10,8,0,2,1,1,0.44,0.4394,0.77,0.2239,28,372,400,400,True
6524,2011-10-04,4,0,10,9,0,2,1,1,0.46,0.4545,0.67,0.2537,19,168,187,187,True
6525,2011-10-04,4,0,10,10,0,2,1,1,0.48,0.4697,0.67,0.2836,19,107,126,126,True
6526,2011-10-04,4,0,10,11,0,2,1,1,0.54,0.5152,0.64,0.2836,22,102,124,124,True
6527,2011-10-04,4,0,10,12,0,2,1,1,0.56,0.5303,0.56,0.2985,39,160,199,199,True
6528,2011-10-04,4,0,10,13,0,2,1,1,0.56,0.5303,0.56,0.2985,20,153,173,173,True
6529,2011-10-04,4,0,10,14,0,2,1,1,0.58,0.5455,0.53,0.2537,27,156,183,183,True
6530,2011-10-04,4,0,10,15,0,2,1,1,0.58,0.5455,0.56,0.2836,28,166,194,194,True
6531,2011-10-04,4,0,10,16,0,2,1,1,0.58,0.5455,0.56,0.3284,36,273,309,309,True
6532,2011-10-04,4,0,10,17,0,2,1,1,0.56,0.5303,0.6,0.3881,55,499,554,554,True
6533,2011-10-04,4,0,10,18,0,2,1,1,0.54,0.5152,0.64,0.2836,68,456,524,524,True
6534,2011-10-04,4,0,10,19,0,2,1,1,0.52,0.5,0.68,0.2239,35,310,345,345,True
6535,2011-10-04,4,0,10,20,0,2,1,1,0.52,0.5,0.68,0.2239,25,236,261,261,True
6536,2011-10-04,4,0,10,21,0,2,1,1,0.5,0.4848,0.72,0.1343,22,144,166,166,True
6537,2011-10-04,4,0,10,22,0,2,1,1,0.5,0.4848,0.72,0.1343,8,106,114,114,True
6538,2011-10-04,4,0,10,23,0,2,1,1,0.48,0.4697,0.77,0.1343,6,60,66,66,True
6539,2011-10-05,4,0,10,0,0,3,1,1,0.48,0.4697,0.77,0.1343,7,36,43,43,True
6540,2011-10-05,4,0,10,1,0,3,1,1,0.48,0.4697,0.77,0.1642,4,7,11,11,True
6541,2011-10-05,4,0,10,2,0,3,1,1,0.46,0.4545,0.82,0.1642,1,2,3,3,True
6542,2011-10-05,4,0,10,3,0,3,1,1,0.46,0.4545,0.82,0.1045,1,5,6,6,True
6543,2011-10-05,4,0,10,4,0,3,1,1,0.44,0.4394,0.88,0.0,1,4,5,5,True
6544,2011-10-05,4,0,10,5,0,3,1,1,0.44,0.4394,0.82,0.1343,3,29,32,32,True
6545,2011-10-05,4,0,10,6,0,3,1,1,0.44,0.4394,0.82,0.1045,5,112,117,117,True
6546,2011-10-05,4,0,10,7,0,3,1,1,0.46,0.4545,0.77,0.1045,9,292,301,301,True
6547,2011-10-05,4,0,10,8,0,3,1,1,0.52,0.5,0.63,0.0,26,441,467,467,True
6548,2011-10-05,4,0,10,9,0,3,1,1,0.54,0.5152,0.6,0.2985,32,187,219,219,True
6549,2011-10-05,4,0,10,10,0,3,1,1,0.56,0.5303,0.56,0.3881,30,103,133,133,True
6550,2011-10-05,4,0,10,11,0,3,1,1,0.6,0.6212,0.46,0.2836,32,138,170,170,True
6551,2011-10-05,4,0,10,12,0,3,1,1,0.62,0.6212,0.43,0.3284,34,180,214,214,True
6552,2011-10-05,4,0,10,13,0,3,1,1,0.64,0.6212,0.41,0.2239,30,189,219,219,True
6553,2011-10-05,4,0,10,14,0,3,1,1,0.64,0.6212,0.41,0.2836,34,156,190,190,True
6554,2011-10-05,4,0,10,15,0,3,1,1,0.64,0.6212,0.47,0.2836,35,147,182,182,True
6555,2011-10-05,4,0,10,16,0,3,1,1,0.64,0.6212,0.47,0.3284,37,245,282,282,True
6556,2011-10-05,4,0,10,17,0,3,1,1,0.64,0.6212,0.47,0.2537,66,499,565,565,True
6557,2011-10-05,4,0,10,18,0,3,1,1,0.6,0.6212,0.53,0.1642,57,499,556,556,True
6558,2011-10-05,4,0,10,19,0,3,1,1,0.58,0.5455,0.56,0.1343,40,334,374,374,True
6559,2011-10-05,4,0,10,20,0,3,1,1,0.52,0.5,0.77,0.1642,18,228,246,246,True
6560,2011-10-05,4,0,10,21,0,3,1,1,0.5,0.4848,0.82,0.1045,28,173,201,201,True
6561,2011-10-05,4,0,10,22,0,3,1,1,0.52,0.5,0.72,0.0,20,134,154,154,True
6562,2011-10-05,4,0,10,23,0,3,1,1,0.5,0.4848,0.77,0.1045,9,64,73,73,True
6563,2011-10-06,4,0,10,0,0,4,1,1,0.5,0.4848,0.72,0.194,6,34,40,40,True
6564,2011-10-06,4,0,10,1,0,4,1,1,0.48,0.4697,0.63,0.194,5,17,22,22,True
6565,2011-10-06,4,0,10,2,0,4,1,1,0.46,0.4545,0.67,0.194,2,8,10,10,True
6566,2011-10-06,4,0,10,3,0,4,1,1,0.44,0.4394,0.67,0.2239,1,4,5,5,True
6567,2011-10-06,4,0,10,4,0,4,1,1,0.44,0.4394,0.62,0.2836,0,5,5,5,True
6568,2011-10-06,4,0,10,5,0,4,1,1,0.42,0.4242,0.62,0.194,0,24,24,24,True
6569,2011-10-06,4,0,10,6,0,4,1,1,0.4,0.4091,0.66,0.194,4,110,114,114,True
6570,2011-10-06,4,0,10,7,0,4,1,1,0.42,0.4242,0.62,0.194,15,287,302,302,True
6571,2011-10-06,4,0,10,8,0,4,1,1,0.44,0.4394,0.62,0.1642,20,437,457,457,True
6572,2011-10-06,4,0,10,9,0,4,1,1,0.46,0.4545,0.63,0.194,20,188,208,208,True
6573,2011-10-06,4,0,10,10,0,4,1,1,0.52,0.5,0.52,0.0,24,105,129,129,True
6574,2011-10-06,4,0,10,11,0,4,1,1,0.54,0.5152,0.49,0.0,29,115,144,144,True
6575,2011-10-06,4,0,10,12,0,4,1,1,0.56,0.5303,0.49,0.0896,46,180,226,226,True
6576,2011-10-06,4,0,10,13,0,4,1,1,0.56,0.5303,0.46,0.0896,33,158,191,191,True
6577,2011-10-06,4,0,10,14,0,4,1,1,0.58,0.5455,0.43,0.0896,56,139,195,195,True
6578,2011-10-06,4,0,10,15,0,4,1,1,0.58,0.5455,0.46,0.1343,62,157,219,219,True
6579,2011-10-06,4,0,10,16,0,4,1,1,0.58,0.5455,0.49,0.194,51,272,323,323,True
6580,2011-10-06,4,0,10,17,0,4,1,1,0.56,0.5303,0.52,0.1343,63,499,562,562,True
6581,2011-10-06,4,0,10,18,0,4,1,1,0.54,0.5152,0.64,0.0896,59,479,538,538,True
6582,2011-10-06,4,0,10,19,0,4,1,1,0.52,0.5,0.59,0.1045,38,305,343,343,True
6583,2011-10-06,4,0,10,20,0,4,1,1,0.5,0.4848,0.77,0.1045,29,231,260,260,True
6584,2011-10-06,4,0,10,21,0,4,1,1,0.46,0.4545,0.88,0.0896,34,161,195,195,True
6585,2011-10-06,4,0,10,22,0,4,1,1,0.46,0.4545,0.82,0.0,24,124,148,148,True
6586,2011-10-06,4,0,10,23,0,4,1,1,0.44,0.4394,0.88,0.0896,18,81,99,99,True
6587,2011-10-07,4,0,10,0,0,5,1,1,0.44,0.4394,0.88,0.0,19,48,67,67,True
6588,2011-10-07,4,0,10,1,0,5,1,1,0.44,0.4394,0.88,0.0,3,25,28,28,True
6589,2011-10-07,4,0,10,2,0,5,1,1,0.42,0.4242,0.88,0.0,0,5,5,5,True
6590,2011-10-07,4,0,10,3,0,5,1,1,0.4,0.4091,0.87,0.0,1,9,10,10,True
6591,2011-10-07,4,0,10,4,0,5,1,1,0.4,0.4091,0.87,0.1045,0,5,5,5,True
6592,2011-10-07,4,0,10,5,0,5,1,1,0.42,0.4242,0.82,0.0,3,24,27,27,True
6593,2011-10-07,4,0,10,6,0,5,1,1,0.42,0.4242,0.88,0.0,3,84,87,87,True
6594,2011-10-07,4,0,10,7,0,5,1,1,0.42,0.4242,0.94,0.0,5,237,242,242,True
6595,2011-10-07,4,0,10,8,0,5,1,1,0.46,0.4545,0.82,0.0,31,386,417,417,True
6596,2011-10-07,4,0,10,9,0,5,1,1,0.48,0.4697,0.77,0.0,34,207,241,241,True
6597,2011-10-07,4,0,10,10,0,5,1,1,0.52,0.5,0.68,0.0896,48,126,174,174,True
6598,2011-10-07,4,0,10,11,0,5,1,1,0.56,0.5303,0.63,0.0,80,150,230,230,True
6599,2011-10-07,4,0,10,12,0,5,1,1,0.6,0.6212,0.53,0.0,61,174,235,235,True
6600,2011-10-07,4,0,10,13,0,5,1,1,0.6,0.6212,0.46,0.0,95,210,305,305,True
6601,2011-10-07,4,0,10,14,0,5,1,1,0.62,0.6212,0.5,0.0,77,179,256,256,True
6602,2011-10-07,4,0,10,15,0,5,1,1,0.66,0.6212,0.41,0.0,68,202,270,270,True
6603,2011-10-07,4,0,10,16,0,5,1,1,0.64,0.6212,0.44,0.0,73,346,419,419,True
6604,2011-10-07,4,0,10,17,0,5,1,1,0.6,0.6212,0.56,0.2537,101,462,563,563,True
6605,2011-10-07,4,0,10,18,0,5,1,1,0.56,0.5303,0.6,0.0896,94,371,465,465,True
6606,2011-10-07,4,0,10,19,0,5,1,1,0.56,0.5303,0.52,0.0,51,243,294,294,True
6607,2011-10-07,4,0,10,20,0,5,1,1,0.54,0.5152,0.49,0.0,30,167,197,197,True
6608,2011-10-07,4,0,10,21,0,5,1,1,0.5,0.4848,0.68,0.0,22,144,166,166,True
6609,2011-10-07,4,0,10,22,0,5,1,1,0.5,0.4848,0.68,0.0,27,119,146,146,True
6610,2011-10-07,4,0,10,23,0,5,1,1,0.5,0.4848,0.63,0.0,23,113,136,136,True
6611,2011-10-08,4,0,10,0,0,6,0,1,0.48,0.4697,0.72,0.0,17,72,89,89,True
6612,2011-10-08,4,0,10,1,0,6,0,1,0.46,0.4545,0.82,0.0,14,51,65,65,True
6613,2011-10-08,4,0,10,2,0,6,0,1,0.46,0.4545,0.82,0.0,4,41,45,45,True
6614,2011-10-08,4,0,10,3,0,6,0,1,0.44,0.4394,0.88,0.0,4,16,20,20,True
6615,2011-10-08,4,0,10,4,0,6,0,1,0.42,0.4242,0.94,0.1343,3,7,10,10,True
6616,2011-10-08,4,0,10,5,0,6,0,1,0.42,0.4242,0.88,0.1045,1,7,8,8,True
6617,2011-10-08,4,0,10,6,0,6,0,1,0.42,0.4242,0.94,0.0,6,16,22,22,True
6618,2011-10-08,4,0,10,7,0,6,0,1,0.42,0.4242,0.94,0.0896,27,46,73,73,True
6619,2011-10-08,4,0,10,8,0,6,0,1,0.46,0.4545,0.82,0.0,14,89,103,103,True
6620,2011-10-08,4,0,10,9,0,6,0,1,0.5,0.4848,0.77,0.0,54,163,217,217,True
6621,2011-10-08,4,0,10,10,0,6,0,1,0.52,0.5,0.77,0.0,114,217,331,331,True
6622,2011-10-08,4,0,10,11,0,6,0,1,0.58,0.5455,0.56,0.0,114,221,335,335,True
6623,2011-10-08,4,0,10,12,0,6,0,1,0.62,0.6212,0.35,0.0,114,255,369,369,True
6624,2011-10-08,4,0,10,13,0,6,0,1,0.62,0.6212,0.46,0.1045,114,229,343,343,True
6625,2011-10-08,4,0,10,14,0,6,0,1,0.62,0.6212,0.5,0.0896,114,214,328,328,True
6626,2011-10-08,4,0,10,15,0,6,0,1,0.66,0.6212,0.39,0.0,114,234,348,348,True
6627,2011-10-08,4,0,10,16,0,6,0,1,0.64,0.6212,0.44,0.0896,114,230,344,344,True
6628,2011-10-08,4,0,10,17,0,6,0,1,0.62,0.6212,0.5,0.1343,114,219,333,333,True
6629,2011-10-08,4,0,10,18,0,6,0,1,0.6,0.6212,0.46,0.1045,114,224,338,338,True
6630,2011-10-08,4,0,10,19,0,6,0,1,0.54,0.5152,0.68,0.1343,76,172,248,248,True
6631,2011-10-08,4,0,10,20,0,6,0,1,0.52,0.5,0.77,0.1045,78,124,202,202,True
6632,2011-10-08,4,0,10,21,0,6,0,1,0.52,0.5,0.77,0.0,54,133,187,187,True
6633,2011-10-08,4,0,10,22,0,6,0,1,0.5,0.4848,0.77,0.0,45,104,149,149,True
6634,2011-10-08,4,0,10,23,0,6,0,1,0.48,0.4697,0.88,0.0,52,90,142,142,True
6635,2011-10-09,4,0,10,0,0,0,0,1,0.46,0.4545,0.88,0.0896,46,83,129,129,True
6636,2011-10-09,4,0,10,1,0,0,0,1,0.46,0.4545,0.88,0.0,15,63,78,78,True
6637,2011-10-09,4,0,10,2,0,0,0,1,0.46,0.4545,0.88,0.0,20,35,55,55,True
6638,2011-10-09,4,0,10,3,0,0,0,1,0.44,0.4394,0.88,0.0,10,20,30,30,True
6639,2011-10-09,4,0,10,4,0,0,0,1,0.44,0.4394,0.88,0.0,7,7,14,14,True
6640,2011-10-09,4,0,10,5,0,0,0,1,0.44,0.4394,0.88,0.0,1,14,15,15,True
6641,2011-10-09,4,0,10,6,0,0,0,1,0.44,0.4394,0.88,0.0,7,14,21,21,True
6642,2011-10-09,4,0,10,7,0,0,0,1,0.44,0.4394,0.86,0.0,18,26,44,44,True
6643,2011-10-09,4,0,10,8,0,0,0,1,0.46,0.4545,0.88,0.0,25,82,107,107,True
6644,2011-10-09,4,0,10,9,0,0,0,1,0.5,0.4848,0.77,0.0,66,119,185,185,True
6645,2011-10-09,4,0,10,10,0,0,0,1,0.56,0.5303,0.68,0.0896,114,210,324,324,True
6646,2011-10-09,4,0,10,11,0,0,0,1,0.62,0.6212,0.53,0.0896,114,234,348,348,True
6647,2011-10-09,4,0,10,12,0,0,0,1,0.64,0.6212,0.44,0.0896,114,243,357,357,True
6648,2011-10-09,4,0,10,13,0,0,0,1,0.66,0.6212,0.44,0.0896,114,193,307,307,True
6649,2011-10-09,4,0,10,14,0,0,0,1,0.68,0.6364,0.47,0.1642,114,228,342,342,True
6650,2011-10-09,4,0,10,15,0,0,0,1,0.68,0.6364,0.51,0.1642,114,209,323,323,True
6651,2011-10-09,4,0,10,16,0,0,0,1,0.66,0.6212,0.5,0.1343,114,247,361,361,True
6652,2011-10-09,4,0,10,17,0,0,0,1,0.62,0.6061,0.61,0.1045,114,230,344,344,True
6653,2011-10-09,4,0,10,18,0,0,0,1,0.64,0.6212,0.5,0.1045,114,228,342,342,True
6654,2011-10-09,4,0,10,19,0,0,0,1,0.56,0.5303,0.73,0.0896,114,186,300,300,True
6655,2011-10-09,4,0,10,20,0,0,0,1,0.56,0.5303,0.73,0.1045,59,134,193,193,True
6656,2011-10-09,4,0,10,21,0,0,0,1,0.54,0.5152,0.83,0.1045,53,120,173,173,True
6657,2011-10-09,4,0,10,22,0,0,0,2,0.52,0.5,0.94,0.0,48,104,152,152,True
6658,2011-10-09,4,0,10,23,0,0,0,1,0.5,0.4848,0.88,0.1045,38,85,123,123,True
6659,2011-10-10,4,0,10,0,1,1,0,1,0.5,0.4848,0.94,0.0,11,42,53,53,True
6660,2011-10-10,4,0,10,1,1,1,0,1,0.48,0.4697,0.88,0.0,4,30,34,34,True
6661,2011-10-10,4,0,10,2,1,1,0,1,0.48,0.4697,0.88,0.0,4,15,19,19,True
6662,2011-10-10,4,0,10,3,1,1,0,1,0.46,0.4545,0.88,0.0,2,9,11,11,True
6663,2011-10-10,4,0,10,4,1,1,0,1,0.46,0.4545,0.94,0.0,2,4,6,6,True
6664,2011-10-10,4,0,10,5,1,1,0,1,0.46,0.4545,0.94,0.0,2,19,21,21,True
6665,2011-10-10,4,0,10,6,1,1,0,1,0.44,0.4394,0.94,0.0,5,39,44,44,True
6666,2011-10-10,4,0,10,7,1,1,0,1,0.46,0.4545,0.88,0.0,12,102,114,114,True
6667,2011-10-10,4,0,10,8,1,1,0,1,0.52,0.5,0.83,0.0,27,227,254,254,True
6668,2011-10-10,4,0,10,9,1,1,0,1,0.54,0.5152,0.77,0.0,58,161,219,219,True
6669,2011-10-10,4,0,10,10,1,1,0,1,0.56,0.5303,0.73,0.1642,107,158,265,265,True
6670,2011-10-10,4,0,10,11,1,1,0,1,0.62,0.6061,0.69,0.0896,114,183,297,297,True
6671,2011-10-10,4,0,10,12,1,1,0,2,0.7,0.6515,0.48,0.0896,114,201,315,315,True
6672,2011-10-10,4,0,10,13,1,1,0,1,0.72,0.6515,0.37,0.0,114,219,333,333,True
6673,2011-10-10,4,0,10,14,1,1,0,1,0.74,0.6515,0.37,0.0,114,223,337,337,True
6674,2011-10-10,4,0,10,15,1,1,0,2,0.72,0.6515,0.42,0.1045,114,254,368,368,True
6675,2011-10-10,4,0,10,16,1,1,0,2,0.7,0.6364,0.45,0.0896,114,248,362,362,True
6676,2011-10-10,4,0,10,17,1,1,0,2,0.66,0.6212,0.54,0.1045,114,334,448,448,True
6677,2011-10-10,4,0,10,18,1,1,0,2,0.64,0.6212,0.53,0.0,108,365,473,473,True
6678,2011-10-10,4,0,10,19,1,1,0,2,0.58,0.5455,0.78,0.0896,69,267,336,336,True
6679,2011-10-10,4,0,10,20,1,1,0,1,0.6,0.5909,0.73,0.0,37,188,225,225,True
6680,2011-10-10,4,0,10,21,1,1,0,1,0.56,0.5303,0.88,0.0896,27,148,175,175,True
6681,2011-10-10,4,0,10,22,1,1,0,1,0.56,0.5303,0.88,0.0896,22,104,126,126,True
6682,2011-10-10,4,0,10,23,1,1,0,2,0.54,0.5152,0.88,0.1045,12,63,75,75,True
6683,2011-10-11,4,0,10,0,0,2,1,2,0.54,0.5152,0.88,0.0,14,16,30,30,True
6684,2011-10-11,4,0,10,1,0,2,1,2,0.52,0.5,0.94,0.0896,2,9,11,11,True
6685,2011-10-11,4,0,10,2,0,2,1,2,0.52,0.5,0.94,0.1343,1,4,5,5,True
6686,2011-10-11,4,0,10,3,0,2,1,2,0.52,0.5,0.88,0.1045,2,1,3,3,True
6687,2011-10-11,4,0,10,4,0,2,1,2,0.52,0.5,0.88,0.1343,0,5,5,5,True
6688,2011-10-11,4,0,10,5,0,2,1,2,0.52,0.5,0.88,0.0,0,20,20,20,True
6689,2011-10-11,4,0,10,6,0,2,1,1,0.52,0.5,0.83,0.0896,9,114,123,123,True
6690,2011-10-11,4,0,10,7,0,2,1,2,0.52,0.5,0.88,0.0896,19,333,352,352,True
6691,2011-10-11,4,0,10,8,0,2,1,2,0.56,0.5303,0.83,0.1045,31,375,406,406,True
6692,2011-10-11,4,0,10,9,0,2,1,2,0.6,0.5909,0.69,0.0,40,195,235,235,True
6693,2011-10-11,4,0,10,10,0,2,1,2,0.6,0.5909,0.69,0.1343,38,111,149,149,True
6694,2011-10-11,4,0,10,11,0,2,1,2,0.6,0.5909,0.73,0.1642,31,92,123,123,True
6695,2011-10-11,4,0,10,12,0,2,1,2,0.6,0.5909,0.73,0.1642,51,130,181,181,True
6696,2011-10-11,4,0,10,13,0,2,1,2,0.6,0.5909,0.73,0.194,42,138,180,180,True
6697,2011-10-11,4,0,10,14,0,2,1,3,0.6,0.5909,0.73,0.1045,54,117,171,171,True
6698,2011-10-11,4,0,10,15,0,2,1,2,0.6,0.5758,0.78,0.1642,36,139,175,175,True
6699,2011-10-11,4,0,10,16,0,2,1,2,0.6,0.5909,0.73,0.1642,63,257,320,320,True
6700,2011-10-11,4,0,10,17,0,2,1,2,0.6,0.5758,0.78,0.2537,70,499,569,569,True
6701,2011-10-11,4,0,10,18,0,2,1,2,0.6,0.5758,0.78,0.2239,46,493,539,539,True
6702,2011-10-11,4,0,10,19,0,2,1,2,0.58,0.5455,0.83,0.2239,33,285,318,318,True
6703,2011-10-11,4,0,10,20,0,2,1,2,0.58,0.5455,0.83,0.2239,31,203,234,234,True
6704,2011-10-11,4,0,10,21,0,2,1,2,0.58,0.5455,0.78,0.194,17,158,175,175,True
6705,2011-10-11,4,0,10,22,0,2,1,2,0.56,0.5303,0.83,0.194,27,120,147,147,True
6706,2011-10-11,4,0,10,23,0,2,1,2,0.56,0.5303,0.83,0.2836,10,47,57,57,True
6707,2011-10-12,4,0,10,0,0,3,1,2,0.56,0.5303,0.83,0.1343,2,23,25,25,True
6708,2011-10-12,4,0,10,1,0,3,1,3,0.56,0.5303,0.83,0.1343,2,8,10,10,True
6709,2011-10-12,4,0,10,2,0,3,1,2,0.56,0.5303,0.83,0.2836,0,2,2,2,True
6710,2011-10-12,4,0,10,3,0,3,1,3,0.54,0.5152,0.94,0.2985,0,2,2,2,True
6711,2011-10-12,4,0,10,4,0,3,1,3,0.54,0.5152,0.94,0.3881,1,6,7,7,True
6712,2011-10-12,4,0,10,5,0,3,1,2,0.54,0.5152,0.88,0.3284,0,22,22,22,True
6713,2011-10-12,4,0,10,6,0,3,1,2,0.54,0.5152,0.88,0.2537,5,107,112,112,True
6714,2011-10-12,4,0,10,7,0,3,1,2,0.54,0.5152,0.88,0.3881,15,244,259,259,True
6715,2011-10-12,4,0,10,8,0,3,1,2,0.54,0.5152,0.88,0.3881,27,377,404,404,True
6716,2011-10-12,4,0,10,9,0,3,1,2,0.54,0.5152,0.88,0.4478,14,183,197,197,True
6717,2011-10-12,4,0,10,10,0,3,1,2,0.54,0.5152,0.88,0.3881,15,98,113,113,True
6718,2011-10-12,4,0,10,11,0,3,1,3,0.54,0.5152,0.94,0.3284,18,102,120,120,True
6719,2011-10-12,4,0,10,12,0,3,1,3,0.54,0.5152,0.88,0.3284,9,53,62,62,True
6720,2011-10-12,4,0,10,13,0,3,1,3,0.54,0.5152,0.88,0.2239,25,76,101,101,True
6721,2011-10-12,4,0,10,14,0,3,1,3,0.54,0.5152,0.94,0.2836,8,70,78,78,True
6722,2011-10-12,4,0,10,15,0,3,1,3,0.54,0.5152,0.94,0.2537,3,42,45,45,True
6723,2011-10-12,4,0,10,16,0,3,1,2,0.56,0.5303,0.88,0.2239,5,50,55,55,True
6724,2011-10-12,4,0,10,17,0,3,1,3,0.54,0.5152,0.94,0.2239,16,235,251,251,True
6725,2011-10-12,4,0,10,18,0,3,1,3,0.54,0.5152,0.94,0.1343,11,161,172,172,True
6726,2011-10-12,4,0,10,19,0,3,1,3,0.54,0.5152,0.94,0.1343,7,102,109,109,True
6727,2011-10-12,4,0,10,20,0,3,1,3,0.54,0.5152,0.94,0.1045,9,81,90,90,True
6728,2011-10-12,4,0,10,21,0,3,1,3,0.54,0.5152,1.0,0.1045,9,74,83,83,True
6729,2011-10-12,4,0,10,22,0,3,1,3,0.54,0.5152,0.94,0.0896,3,40,43,43,True
6730,2011-10-12,4,0,10,23,0,3,1,3,0.54,0.5152,0.94,0.0896,13,41,54,54,True
6731,2011-10-13,4,0,10,0,0,4,1,2,0.54,0.5152,0.94,0.1343,1,14,15,15,True
6732,2011-10-13,4,0,10,1,0,4,1,2,0.54,0.5152,0.94,0.0,3,9,12,12,True
6733,2011-10-13,4,0,10,2,0,4,1,2,0.54,0.5152,0.94,0.0,0,4,4,4,True
6734,2011-10-13,4,0,10,3,0,4,1,2,0.54,0.5152,1.0,0.194,2,4,6,6,True
6735,2011-10-13,4,0,10,4,0,4,1,2,0.54,0.5152,1.0,0.1045,2,5,7,7,True
6736,2011-10-13,4,0,10,5,0,4,1,2,0.54,0.5152,1.0,0.1045,1,16,17,17,True
6737,2011-10-13,4,0,10,6,0,4,1,3,0.54,0.5152,1.0,0.0896,1,51,52,52,True
6738,2011-10-13,4,0,10,7,0,4,1,3,0.54,0.5152,1.0,0.1343,5,76,81,81,True
6739,2011-10-13,4,0,10,8,0,4,1,3,0.54,0.5152,1.0,0.0896,10,199,209,209,True
6740,2011-10-13,4,0,10,9,0,4,1,3,0.56,0.5303,1.0,0.1045,3,106,109,109,True
6741,2011-10-13,4,0,10,10,0,4,1,3,0.56,0.5303,1.0,0.1343,16,53,69,69,True
6742,2011-10-13,4,0,10,11,0,4,1,2,0.62,0.5758,0.83,0.0,8,76,84,84,True
6743,2011-10-13,4,0,10,12,0,4,1,2,0.62,0.5606,0.88,0.0,10,95,105,105,True
6744,2011-10-13,4,0,10,13,0,4,1,2,0.64,0.5758,0.83,0.1642,20,142,162,162,True
6745,2011-10-13,4,0,10,14,0,4,1,1,0.66,0.6061,0.78,0.194,22,111,133,133,True
6746,2011-10-13,4,0,10,15,0,4,1,1,0.66,0.6061,0.78,0.194,27,128,155,155,True
6747,2011-10-13,4,0,10,16,0,4,1,1,0.66,0.6212,0.74,0.2239,36,240,276,276,True
6748,2011-10-13,4,0,10,17,0,4,1,3,0.62,0.5758,0.83,0.2537,47,432,479,479,True
6749,2011-10-13,4,0,10,18,0,4,1,3,0.62,0.5758,0.83,0.2537,20,248,268,268,True
6750,2011-10-13,4,0,10,19,0,4,1,2,0.62,0.5758,0.83,0.1642,18,187,205,205,True
6751,2011-10-13,4,0,10,20,0,4,1,1,0.62,0.5758,0.83,0.2836,15,166,181,181,True
6752,2011-10-13,4,0,10,21,0,4,1,1,0.62,0.5758,0.83,0.194,8,115,123,123,True
6753,2011-10-13,4,0,10,22,0,4,1,1,0.62,0.5758,0.83,0.194,13,101,114,114,True
6754,2011-10-13,4,0,10,23,0,4,1,2,0.58,0.5455,0.88,0.194,2,45,47,47,True
6755,2011-10-14,4,0,10,0,0,5,1,1,0.58,0.5455,0.94,0.0896,10,29,39,39,True
6756,2011-10-14,4,0,10,1,0,5,1,1,0.58,0.5455,0.94,0.1343,8,16,24,24,True
6757,2011-10-14,4,0,10,2,0,5,1,1,0.56,0.5303,0.94,0.1642,0,6,6,6,True
6758,2011-10-14,4,0,10,3,0,5,1,1,0.56,0.5303,0.94,0.1343,1,6,7,7,True
6759,2011-10-14,4,0,10,4,0,5,1,1,0.56,0.5303,0.94,0.194,0,8,8,8,True
6760,2011-10-14,4,0,10,5,0,5,1,2,0.56,0.5303,0.94,0.1642,0,17,17,17,True
6761,2011-10-14,4,0,10,6,0,5,1,3,0.56,0.5303,0.88,0.194,4,90,94,94,True
6762,2011-10-14,4,0,10,7,0,5,1,3,0.56,0.5303,0.88,0.194,10,137,147,147,True
6763,2011-10-14,4,0,10,8,0,5,1,2,0.56,0.5303,0.9,0.1642,23,186,209,209,True
6764,2011-10-14,4,0,10,9,0,5,1,2,0.56,0.5303,0.94,0.2239,16,164,180,180,True
6765,2011-10-14,4,0,10,10,0,5,1,3,0.54,0.5152,0.88,0.3582,17,108,125,125,True
6766,2011-10-14,4,0,10,11,0,5,1,3,0.52,0.5,0.88,0.1642,11,76,87,87,True
6767,2011-10-14,4,0,10,12,0,5,1,3,0.52,0.5,0.88,0.1642,13,62,75,75,True
6768,2011-10-14,4,0,10,13,0,5,1,1,0.56,0.5303,0.73,0.3582,18,114,132,132,True
6769,2011-10-14,4,0,10,14,0,5,1,1,0.62,0.6212,0.43,0.3582,37,119,156,156,True
6770,2011-10-14,4,0,10,15,0,5,1,1,0.62,0.6212,0.43,0.2836,61,169,230,230,True
6771,2011-10-14,4,0,10,16,0,5,1,1,0.6,0.6212,0.43,0.2239,80,264,344,344,True
6772,2011-10-14,4,0,10,17,0,5,1,1,0.58,0.5455,0.46,0.4179,55,426,481,481,True
6773,2011-10-14,4,0,10,18,0,5,1,1,0.54,0.5152,0.39,0.2836,62,361,423,423,True
6774,2011-10-14,4,0,10,19,0,5,1,1,0.54,0.5152,0.39,0.3284,27,221,248,248,True
6775,2011-10-14,4,0,10,20,0,5,1,1,0.52,0.5,0.42,0.194,19,177,196,196,True
6776,2011-10-14,4,0,10,21,0,5,1,1,0.5,0.4848,0.45,0.194,22,156,178,178,True
6777,2011-10-14,4,0,10,22,0,5,1,1,0.46,0.4545,0.59,0.2239,20,123,143,143,True
6778,2011-10-14,4,0,10,23,0,5,1,1,0.46,0.4545,0.59,0.1642,15,80,95,95,True
6779,2011-10-15,4,0,10,0,0,6,0,1,0.46,0.4545,0.55,0.1045,18,88,106,106,True
6780,2011-10-15,4,0,10,1,0,6,0,1,0.46,0.4545,0.55,0.2537,9,64,73,73,True
6781,2011-10-15,4,0,10,2,0,6,0,1,0.46,0.4545,0.59,0.194,17,39,56,56,True
6782,2011-10-15,4,0,10,3,0,6,0,1,0.44,0.4394,0.62,0.194,5,18,23,23,True
6783,2011-10-15,4,0,10,4,0,6,0,1,0.42,0.4242,0.67,0.1343,0,6,6,6,True
6784,2011-10-15,4,0,10,5,0,6,0,1,0.42,0.4242,0.71,0.1642,1,6,7,7,True
6785,2011-10-15,4,0,10,6,0,6,0,1,0.4,0.4091,0.71,0.0,5,15,20,20,True
6786,2011-10-15,4,0,10,7,0,6,0,1,0.4,0.4091,0.76,0.1045,17,40,57,57,True
6787,2011-10-15,4,0,10,8,0,6,0,1,0.46,0.4545,0.59,0.2836,24,101,125,125,True
6788,2011-10-15,4,0,10,9,0,6,0,1,0.52,0.5,0.48,0.2985,50,157,207,207,True
6789,2011-10-15,4,0,10,10,0,6,0,1,0.54,0.5152,0.45,0.4478,114,207,321,321,True
6790,2011-10-15,4,0,10,11,0,6,0,1,0.56,0.5303,0.4,0.3881,114,221,335,335,True
6791,2011-10-15,4,0,10,12,0,6,0,1,0.58,0.5455,0.35,0.4775,114,261,375,375,True
6792,2011-10-15,4,0,10,13,0,6,0,1,0.6,0.6212,0.35,0.4627,114,223,337,337,True
6793,2011-10-15,4,0,10,14,0,6,0,1,0.6,0.6212,0.33,0.4627,114,230,344,344,True
6794,2011-10-15,4,0,10,15,0,6,0,1,0.62,0.6212,0.31,0.4775,114,211,325,325,True
6795,2011-10-15,4,0,10,16,0,6,0,1,0.62,0.6212,0.29,0.3881,114,264,378,378,True
6796,2011-10-15,4,0,10,17,0,6,0,1,0.58,0.5455,0.32,0.2836,114,264,378,378,True
6797,2011-10-15,4,0,10,18,0,6,0,1,0.54,0.5152,0.39,0.194,114,251,365,365,True
6798,2011-10-15,4,0,10,19,0,6,0,1,0.5,0.4848,0.51,0.1343,61,177,238,238,True
6799,2011-10-15,4,0,10,20,0,6,0,1,0.5,0.4848,0.48,0.1343,42,137,179,179,True
6800,2011-10-15,4,0,10,21,0,6,0,1,0.5,0.4848,0.42,0.2239,53,115,168,168,True
6801,2011-10-15,4,0,10,22,0,6,0,1,0.5,0.4848,0.36,0.1343,45,121,166,166,True
6802,2011-10-15,4,0,10,23,0,6,0,1,0.48,0.4697,0.41,0.1642,33,102,135,135,True
6803,2011-10-16,4,0,10,0,0,0,0,1,0.46,0.4545,0.44,0.1343,22,85,107,107,True
6804,2011-10-16,4,0,10,1,0,0,0,1,0.44,0.4394,0.47,0.1343,13,64,77,77,True
6805,2011-10-16,4,0,10,2,0,0,0,1,0.42,0.4242,0.54,0.1343,13,52,65,65,True
6806,2011-10-16,4,0,10,3,0,0,0,1,0.42,0.4242,0.54,0.1343,11,31,42,42,True
6807,2011-10-16,4,0,10,4,0,0,0,1,0.42,0.4242,0.54,0.194,5,7,12,12,True
6808,2011-10-16,4,0,10,5,0,0,0,1,0.42,0.4242,0.54,0.1642,1,6,7,7,True
6809,2011-10-16,4,0,10,6,0,0,0,1,0.38,0.3939,0.66,0.1642,3,7,10,10,True
6810,2011-10-16,4,0,10,7,0,0,0,1,0.4,0.4091,0.62,0.1343,9,39,48,48,True
6811,2011-10-16,4,0,10,8,0,0,0,1,0.44,0.4394,0.62,0.194,28,71,99,99,True
6812,2011-10-16,4,0,10,9,0,0,0,1,0.5,0.4848,0.45,0.2239,39,151,190,190,True
6813,2011-10-16,4,0,10,10,0,0,0,1,0.54,0.5152,0.45,0.2537,114,226,340,340,True
6814,2011-10-16,4,0,10,11,0,0,0,1,0.56,0.5303,0.35,0.2836,114,218,332,332,True
6815,2011-10-16,4,0,10,12,0,0,0,1,0.58,0.5455,0.35,0.2537,114,277,391,391,True
6816,2011-10-16,4,0,10,13,0,0,0,1,0.6,0.6212,0.35,0.2985,114,269,383,383,True
6817,2011-10-16,4,0,10,14,0,0,0,1,0.6,0.6212,0.4,0.2985,114,258,372,372,True
6818,2011-10-16,4,0,10,15,0,0,0,1,0.62,0.6212,0.35,0.3881,114,230,344,344,True
6819,2011-10-16,4,0,10,16,0,0,0,1,0.6,0.6212,0.46,0.3881,114,289,403,403,True
6820,2011-10-16,4,0,10,17,0,0,0,1,0.58,0.5455,0.49,0.4627,114,253,367,367,True
6821,2011-10-16,4,0,10,18,0,0,0,1,0.56,0.5303,0.49,0.4478,102,226,328,328,True
6822,2011-10-16,4,0,10,19,0,0,0,1,0.54,0.5152,0.52,0.3881,52,181,233,233,True
6823,2011-10-16,4,0,10,20,0,0,0,1,0.54,0.5152,0.52,0.4627,49,129,178,178,True
6824,2011-10-16,4,0,10,21,0,0,0,1,0.54,0.5152,0.52,0.3881,14,88,102,102,True
6825,2011-10-16,4,0,10,22,0,0,0,1,0.56,0.5303,0.49,0.4179,42,88,130,130,True
6826,2011-10-16,4,0,10,23,0,0,0,1,0.56,0.5303,0.52,0.4179,14,48,62,62,True
6827,2011-10-17,4,0,10,0,0,1,1,1,0.54,0.5152,0.56,0.3284,12,25,37,37,True
6828,2011-10-17,4,0,10,1,0,1,1,1,0.56,0.5303,0.54,0.3881,2,15,17,17,True
6829,2011-10-17,4,0,10,2,0,1,1,1,0.56,0.5303,0.54,0.3881,4,3,7,7,True
6830,2011-10-17,4,0,10,3,0,1,1,1,0.56,0.5303,0.49,0.194,0,2,2,2,True
6831,2011-10-17,4,0,10,4,0,1,1,1,0.52,0.5,0.59,0.1642,2,3,5,5,True
6832,2011-10-17,4,0,10,5,0,1,1,1,0.5,0.4848,0.63,0.2985,1,28,29,29,True
6833,2011-10-17,4,0,10,6,0,1,1,1,0.5,0.4848,0.55,0.2537,7,107,114,114,True
6834,2011-10-17,4,0,10,7,0,1,1,2,0.5,0.4848,0.55,0.1642,10,299,309,309,True
6835,2011-10-17,4,0,10,8,0,1,1,2,0.5,0.4848,0.51,0.2537,33,381,414,414,True
6836,2011-10-17,4,0,10,9,0,1,1,2,0.5,0.4848,0.45,0.2836,26,180,206,206,True
6837,2011-10-17,4,0,10,10,0,1,1,1,0.52,0.5,0.45,0.1642,43,92,135,135,True
6838,2011-10-17,4,0,10,11,0,1,1,1,0.56,0.5303,0.43,0.0,35,131,166,166,True
6839,2011-10-17,4,0,10,12,0,1,1,1,0.56,0.5303,0.4,0.0896,39,166,205,205,True
6840,2011-10-17,4,0,10,13,0,1,1,1,0.56,0.5303,0.46,0.0896,49,156,205,205,True
6841,2011-10-17,4,0,10,14,0,1,1,1,0.58,0.5455,0.49,0.194,44,122,166,166,True
6842,2011-10-17,4,0,10,15,0,1,1,1,0.56,0.5303,0.6,0.2537,66,142,208,208,True
6843,2011-10-17,4,0,10,16,0,1,1,1,0.58,0.5455,0.56,0.2537,64,238,302,302,True
6844,2011-10-17,4,0,10,17,0,1,1,1,0.56,0.5303,0.64,0.1343,80,499,579,579,True
6845,2011-10-17,4,0,10,18,0,1,1,1,0.56,0.5303,0.6,0.0,49,469,518,518,True
6846,2011-10-17,4,0,10,19,0,1,1,1,0.54,0.5152,0.68,0.1045,45,288,333,333,True
6847,2011-10-17,4,0,10,20,0,1,1,1,0.52,0.5,0.77,0.1045,40,189,229,229,True
6848,2011-10-17,4,0,10,21,0,1,1,1,0.5,0.4848,0.77,0.1045,36,141,177,177,True
6849,2011-10-17,4,0,10,22,0,1,1,1,0.5,0.4848,0.77,0.0,16,88,104,104,True
6850,2011-10-17,4,0,10,23,0,1,1,2,0.48,0.4697,0.88,0.0,10,52,62,62,True
6851,2011-10-18,4,0,10,0,0,2,1,1,0.48,0.4697,0.82,0.0,8,23,31,31,True
6852,2011-10-18,4,0,10,1,0,2,1,2,0.46,0.4545,0.88,0.0,4,7,11,11,True
6853,2011-10-18,4,0,10,2,0,2,1,1,0.44,0.4394,0.94,0.0896,1,4,5,5,True
6854,2011-10-18,4,0,10,3,0,2,1,1,0.44,0.4394,0.94,0.0896,0,1,1,1,True
6855,2011-10-18,4,0,10,4,0,2,1,2,0.44,0.4394,0.94,0.1045,0,4,4,4,True
6856,2011-10-18,4,0,10,5,0,2,1,2,0.46,0.4545,0.88,0.0,2,19,21,21,True
6857,2011-10-18,4,0,10,6,0,2,1,1,0.46,0.4545,0.82,0.0896,4,105,109,109,True
6858,2011-10-18,4,0,10,7,0,2,1,1,0.46,0.4545,0.88,0.0896,15,326,341,341,True
6859,2011-10-18,4,0,10,8,0,2,1,1,0.5,0.4848,0.77,0.0896,25,474,499,499,True
6860,2011-10-18,4,0,10,9,0,2,1,2,0.52,0.5,0.77,0.0896,29,198,227,227,True
6861,2011-10-18,4,0,10,10,0,2,1,2,0.56,0.5303,0.68,0.0,27,75,102,102,True
6862,2011-10-18,4,0,10,11,0,2,1,2,0.6,0.6212,0.49,0.1045,35,112,147,147,True
6863,2011-10-18,4,0,10,12,0,2,1,2,0.62,0.6212,0.43,0.0896,42,159,201,201,True
6864,2011-10-18,4,0,10,13,0,2,1,2,0.64,0.6212,0.38,0.194,48,171,219,219,True
6865,2011-10-18,4,0,10,14,0,2,1,2,0.62,0.6212,0.41,0.1642,32,137,169,169,True
6866,2011-10-18,4,0,10,15,0,2,1,1,0.62,0.6212,0.5,0.194,66,139,205,205,True
6867,2011-10-18,4,0,10,16,0,2,1,1,0.62,0.6212,0.57,0.2537,58,246,304,304,True
6868,2011-10-18,4,0,10,17,0,2,1,1,0.6,0.6061,0.6,0.1343,72,499,571,571,True
6869,2011-10-18,4,0,10,18,0,2,1,1,0.56,0.5303,0.68,0.1045,58,499,557,557,True
6870,2011-10-18,4,0,10,19,0,2,1,1,0.56,0.5303,0.6,0.1045,31,286,317,317,True
6871,2011-10-18,4,0,10,20,0,2,1,1,0.54,0.5152,0.64,0.1642,23,204,227,227,True
6872,2011-10-18,4,0,10,21,0,2,1,2,0.54,0.5152,0.68,0.1343,28,178,206,206,True
6873,2011-10-18,4,0,10,22,0,2,1,2,0.52,0.5,0.77,0.1642,22,115,137,137,True
6874,2011-10-18,4,0,10,23,0,2,1,2,0.52,0.5,0.77,0.194,7,63,70,70,True
6875,2011-10-19,4,0,10,0,0,3,1,2,0.52,0.5,0.77,0.194,11,23,34,34,True
6876,2011-10-19,4,0,10,1,0,3,1,2,0.52,0.5,0.77,0.194,7,9,16,16,True
6877,2011-10-19,4,0,10,2,0,3,1,2,0.52,0.5,0.77,0.194,1,6,7,7,True
6878,2011-10-19,4,0,10,4,0,3,1,3,0.5,0.4848,0.94,0.194,0,3,3,3,True
6879,2011-10-19,4,0,10,5,0,3,1,3,0.5,0.4848,1.0,0.1045,0,3,3,3,True
6880,2011-10-19,4,0,10,6,0,3,1,3,0.52,0.5,0.83,0.2537,3,28,31,31,True
6881,2011-10-19,4,0,10,7,0,3,1,3,0.52,0.5,0.77,0.2537,1,67,68,68,True
6882,2011-10-19,4,0,10,8,0,3,1,3,0.54,0.5152,0.7,0.4775,10,200,210,210,True
6883,2011-10-19,4,0,10,9,0,3,1,3,0.52,0.5,0.88,0.4775,17,185,202,202,True
6884,2011-10-19,4,0,10,10,0,3,1,3,0.52,0.5,0.88,0.4775,14,109,123,123,True
6885,2011-10-19,4,0,10,11,0,3,1,3,0.52,0.5,0.94,0.2537,33,116,149,149,True
6886,2011-10-19,4,0,10,12,0,3,1,3,0.52,0.5,0.94,0.3284,13,117,130,130,True
6887,2011-10-19,4,0,10,13,0,3,1,2,0.54,0.5152,0.94,0.2836,20,86,106,106,True
6888,2011-10-19,4,0,10,14,0,3,1,3,0.54,0.5152,0.94,0.1642,17,80,97,97,True
6889,2011-10-19,4,0,10,15,0,3,1,3,0.54,0.5152,1.0,0.1343,21,99,120,120,True
6890,2011-10-19,4,0,10,16,0,3,1,3,0.56,0.5303,0.94,0.1642,21,180,201,201,True
6891,2011-10-19,4,0,10,17,0,3,1,3,0.56,0.5303,0.94,0.1642,11,170,181,181,True
6892,2011-10-19,4,0,10,18,0,3,1,3,0.56,0.5303,1.0,0.1642,8,132,140,140,True
6893,2011-10-19,4,0,10,19,0,3,1,2,0.6,0.5455,0.88,0.1343,8,189,197,197,True
6894,2011-10-19,4,0,10,20,0,3,1,3,0.6,0.5152,0.94,0.0896,5,140,145,145,True
6895,2011-10-19,4,0,10,21,0,3,1,2,0.58,0.5455,0.94,0.1343,6,79,85,85,True
6896,2011-10-19,4,0,10,22,0,3,1,2,0.58,0.5455,0.94,0.3582,13,94,107,107,True
6897,2011-10-19,4,0,10,23,0,3,1,2,0.58,0.5455,0.94,0.3582,14,55,69,69,True
6898,2011-10-20,4,0,10,0,0,4,1,1,0.56,0.5303,0.94,0.2985,4,22,26,26,True
6899,2011-10-20,4,0,10,1,0,4,1,1,0.56,0.5303,0.88,0.3582,4,11,15,15,True
6900,2011-10-20,4,0,10,2,0,4,1,1,0.56,0.5303,0.88,0.4478,0,4,4,4,True
6901,2011-10-20,4,0,10,3,0,4,1,1,0.5,0.4848,0.82,0.4627,0,1,1,1,True
6902,2011-10-20,4,0,10,4,0,4,1,1,0.5,0.4848,0.82,0.4627,2,6,8,8,True
6903,2011-10-20,4,0,10,5,0,4,1,1,0.48,0.4697,0.82,0.3582,2,24,26,26,True
6904,2011-10-20,4,0,10,6,0,4,1,1,0.44,0.4394,0.82,0.4179,5,87,92,92,True
6905,2011-10-20,4,0,10,7,0,4,1,1,0.42,0.4242,0.77,0.4478,15,303,318,318,True
6906,2011-10-20,4,0,10,8,0,4,1,1,0.44,0.4394,0.67,0.4775,17,409,426,426,True
6907,2011-10-20,4,0,10,9,0,4,1,1,0.44,0.4394,0.67,0.4775,26,197,223,223,True
6908,2011-10-20,4,0,10,10,0,4,1,1,0.46,0.4545,0.59,0.4478,25,105,130,130,True
6909,2011-10-20,4,0,10,11,0,4,1,1,0.48,0.4697,0.55,0.4775,30,99,129,129,True
6910,2011-10-20,4,0,10,12,0,4,1,1,0.48,0.4697,0.48,0.4775,28,171,199,199,True
6911,2011-10-20,4,0,10,13,0,4,1,1,0.5,0.4848,0.45,0.4775,28,136,164,164,True
6912,2011-10-20,4,0,10,14,0,4,1,2,0.48,0.4697,0.48,0.4775,38,117,155,155,True
6913,2011-10-20,4,0,10,15,0,4,1,2,0.48,0.4697,0.51,0.4478,22,138,160,160,True
6914,2011-10-20,4,0,10,16,0,4,1,2,0.48,0.4697,0.51,0.4478,31,203,234,234,True
6915,2011-10-20,4,0,10,17,0,4,1,2,0.48,0.4697,0.48,0.3881,56,438,494,494,True
6916,2011-10-20,4,0,10,18,0,4,1,2,0.46,0.4545,0.51,0.2985,39,430,469,469,True
6917,2011-10-20,4,0,10,19,0,4,1,1,0.46,0.4545,0.51,0.3582,20,278,298,298,True
6918,2011-10-20,4,0,10,20,0,4,1,2,0.46,0.4545,0.51,0.3284,34,207,241,241,True
6919,2011-10-20,4,0,10,21,0,4,1,1,0.44,0.4394,0.51,0.2985,16,149,165,165,True
6920,2011-10-20,4,0,10,22,0,4,1,1,0.44,0.4394,0.51,0.3284,22,106,128,128,True
6921,2011-10-20,4,0,10,23,0,4,1,1,0.42,0.4242,0.58,0.2537,7,83,90,90,True
6922,2011-10-21,4,0,10,0,0,5,1,1,0.4,0.4091,0.62,0.2537,8,42,50,50,True
6923,2011-10-21,4,0,10,1,0,5,1,1,0.4,0.4091,0.62,0.2239,7,19,26,26,True
6924,2011-10-21,4,0,10,2,0,5,1,1,0.38,0.3939,0.66,0.1642,6,12,18,18,True
6925,2011-10-21,4,0,10,3,0,5,1,1,0.36,0.3485,0.71,0.1343,0,7,7,7,True
6926,2011-10-21,4,0,10,4,0,5,1,1,0.36,0.3485,0.71,0.1642,0,6,6,6,True
6927,2011-10-21,4,0,10,5,0,5,1,1,0.34,0.3333,0.76,0.194,0,31,31,31,True
6928,2011-10-21,4,0,10,6,0,5,1,1,0.36,0.3485,0.71,0.1642,7,78,85,85,True
6929,2011-10-21,4,0,10,7,0,5,1,1,0.36,0.3485,0.71,0.1642,5,228,233,233,True
6930,2011-10-21,4,0,10,8,0,5,1,1,0.4,0.4091,0.62,0.194,16,386,402,402,True
6931,2011-10-21,4,0,10,9,0,5,1,2,0.42,0.4242,0.58,0.1343,33,189,222,222,True
6932,2011-10-21,4,0,10,10,0,5,1,1,0.46,0.4545,0.51,0.1642,32,106,138,138,True
6933,2011-10-21,4,0,10,11,0,5,1,1,0.5,0.4848,0.45,0.2239,39,135,174,174,True
6934,2011-10-21,4,0,10,12,0,5,1,1,0.5,0.4848,0.45,0.2985,47,193,240,240,True
6935,2011-10-21,4,0,10,13,0,5,1,1,0.48,0.4697,0.48,0.3284,43,163,206,206,True
6936,2011-10-21,4,0,10,14,0,5,1,1,0.52,0.5,0.42,0.2985,67,131,198,198,True
6937,2011-10-21,4,0,10,15,0,5,1,1,0.5,0.4848,0.45,0.2836,57,178,235,235,True
6938,2011-10-21,4,0,10,16,0,5,1,1,0.5,0.4848,0.45,0.2537,60,242,302,302,True
6939,2011-10-21,4,0,10,17,0,5,1,2,0.46,0.4545,0.51,0.2537,79,445,524,524,True
6940,2011-10-21,4,0,10,18,0,5,1,2,0.44,0.4394,0.54,0.2537,43,354,397,397,True
6941,2011-10-21,4,0,10,19,0,5,1,2,0.44,0.4394,0.54,0.3881,25,228,253,253,True
6942,2011-10-21,4,0,10,20,0,5,1,2,0.44,0.4394,0.54,0.2239,29,155,184,184,True
6943,2011-10-21,4,0,10,21,0,5,1,1,0.42,0.4242,0.58,0.1642,31,112,143,143,True
6944,2011-10-21,4,0,10,22,0,5,1,1,0.42,0.4242,0.54,0.1642,24,89,113,113,True
6945,2011-10-21,4,0,10,23,0,5,1,1,0.4,0.4091,0.62,0.2239,18,99,117,117,True
6946,2011-10-22,4,0,10,0,0,6,0,1,0.4,0.4091,0.62,0.194,16,80,96,96,True
6947,2011-10-22,4,0,10,1,0,6,0,1,0.4,0.4091,0.62,0.194,20,50,70,70,True
6948,2011-10-22,4,0,10,2,0,6,0,1,0.4,0.4091,0.62,0.2537,6,25,31,31,True
6949,2011-10-22,4,0,10,3,0,6,0,1,0.4,0.4091,0.62,0.1343,1,19,20,20,True
6950,2011-10-22,4,0,10,4,0,6,0,1,0.38,0.3939,0.66,0.0896,4,4,8,8,True
6951,2011-10-22,4,0,10,5,0,6,0,1,0.38,0.3939,0.66,0.0,1,7,8,8,True
6952,2011-10-22,4,0,10,6,0,6,0,1,0.36,0.3788,0.71,0.0,1,17,18,18,True
6953,2011-10-22,4,0,10,7,0,6,0,1,0.36,0.3636,0.76,0.1045,8,49,57,57,True
6954,2011-10-22,4,0,10,8,0,6,0,1,0.4,0.4091,0.71,0.0,26,88,114,114,True
6955,2011-10-22,4,0,10,9,0,6,0,1,0.42,0.4242,0.67,0.0896,47,122,169,169,True
6956,2011-10-22,4,0,10,10,0,6,0,2,0.44,0.4394,0.62,0.1045,87,149,236,236,True
6957,2011-10-22,4,0,10,11,0,6,0,2,0.44,0.4394,0.62,0.1045,110,172,282,282,True
6958,2011-10-22,4,0,10,12,0,6,0,1,0.46,0.4545,0.55,0.0896,114,211,325,325,True
6959,2011-10-22,4,0,10,13,0,6,0,1,0.5,0.4848,0.45,0.0,114,186,300,300,True
6960,2011-10-22,4,0,10,14,0,6,0,2,0.48,0.4697,0.48,0.2239,114,177,291,291,True
6961,2011-10-22,4,0,10,15,0,6,0,1,0.48,0.4697,0.51,0.2239,114,223,337,337,True
6962,2011-10-22,4,0,10,16,0,6,0,1,0.5,0.4848,0.45,0.194,114,190,304,304,True
6963,2011-10-22,4,0,10,17,0,6,0,1,0.46,0.4545,0.55,0.1343,114,217,331,331,True
6964,2011-10-22,4,0,10,18,0,6,0,1,0.44,0.4394,0.54,0.0896,111,224,335,335,True
6965,2011-10-22,4,0,10,19,0,6,0,1,0.44,0.4394,0.67,0.0,47,173,220,220,True
6966,2011-10-22,4,0,10,20,0,6,0,1,0.42,0.4242,0.67,0.0,48,111,159,159,True
6967,2011-10-22,4,0,10,21,0,6,0,1,0.4,0.4091,0.76,0.0,37,120,157,157,True
6968,2011-10-22,4,0,10,22,0,6,0,1,0.4,0.4091,0.76,0.0,30,114,144,144,True
6969,2011-10-22,4,0,10,23,0,6,0,1,0.38,0.3939,0.82,0.0,27,81,108,108,True
6970,2011-10-23,4,0,10,0,0,0,0,1,0.36,0.3788,0.87,0.0,24,64,88,88,True
6971,2011-10-23,4,0,10,1,0,0,0,1,0.36,0.3788,0.87,0.0,11,60,71,71,True
6972,2011-10-23,4,0,10,2,0,0,0,1,0.34,0.3485,0.87,0.0896,10,40,50,50,True
6973,2011-10-23,4,0,10,3,0,0,0,1,0.34,0.3636,0.87,0.0,15,31,46,46,True
6974,2011-10-23,4,0,10,4,0,0,0,1,0.34,0.3636,0.87,0.0,5,1,6,6,True
6975,2011-10-23,4,0,10,5,0,0,0,1,0.32,0.3485,0.87,0.0,1,2,3,3,True
6976,2011-10-23,4,0,10,6,0,0,0,1,0.32,0.3333,0.87,0.1045,0,12,12,12,True
6977,2011-10-23,4,0,10,7,0,0,0,1,0.34,0.3485,0.87,0.0896,3,18,21,21,True
6978,2011-10-23,4,0,10,8,0,0,0,1,0.36,0.3485,0.87,0.1343,32,56,88,88,True
6979,2011-10-23,4,0,10,9,0,0,0,1,0.4,0.4091,0.76,0.0,48,95,143,143,True
6980,2011-10-23,4,0,10,10,0,0,0,1,0.42,0.4242,0.71,0.0896,104,185,289,289,True
6981,2011-10-23,4,0,10,11,0,0,0,1,0.46,0.4545,0.72,0.1642,114,202,316,316,True
6982,2011-10-23,4,0,10,12,0,0,0,1,0.5,0.4848,0.59,0.2537,114,249,363,363,True
6983,2011-10-23,4,0,10,13,0,0,0,1,0.52,0.5,0.55,0.194,114,255,369,369,True
6984,2011-10-23,4,0,10,14,0,0,0,1,0.52,0.5,0.55,0.2239,114,216,330,330,True
6985,2011-10-23,4,0,10,15,0,0,0,1,0.52,0.5,0.52,0.1642,114,216,330,330,True
6986,2011-10-23,4,0,10,16,0,0,0,1,0.52,0.5,0.55,0.194,114,217,331,331,True
6987,2011-10-23,4,0,10,17,0,0,0,1,0.5,0.4848,0.63,0.1343,114,220,334,334,True
6988,2011-10-23,4,0,10,18,0,0,0,1,0.5,0.4848,0.63,0.1045,88,196,284,284,True
6989,2011-10-23,4,0,10,19,0,0,0,1,0.46,0.4545,0.77,0.0,53,140,193,193,True
6990,2011-10-23,4,0,10,20,0,0,0,1,0.44,0.4394,0.72,0.0896,32,112,144,144,True
6991,2011-10-23,4,0,10,21,0,0,0,1,0.44,0.4394,0.72,0.0896,24,75,99,99,True
6992,2011-10-23,4,0,10,22,0,0,0,1,0.42,0.4242,0.77,0.1045,25,69,94,94,True
6993,2011-10-23,4,0,10,23,0,0,0,1,0.42,0.4242,0.77,0.1642,18,31,49,49,True
6994,2011-10-24,4,0,10,0,0,1,1,1,0.42,0.4242,0.77,0.0,6,26,32,32,True
6995,2011-10-24,4,0,10,1,0,1,1,1,0.4,0.4091,0.82,0.1343,7,8,15,15,True
6996,2011-10-24,4,0,10,2,0,1,1,1,0.4,0.4091,0.87,0.1045,1,6,7,7,True
6997,2011-10-24,4,0,10,3,0,1,1,1,0.4,0.4091,0.82,0.0896,1,3,4,4,True
6998,2011-10-24,4,0,10,4,0,1,1,1,0.4,0.4091,0.82,0.0,1,5,6,6,True
6999,2011-10-24,4,0,10,5,0,1,1,1,0.38,0.3939,0.87,0.0,2,19,21,21,True
7000,2011-10-24,4,0,10,6,0,1,1,1,0.4,0.4091,0.87,0.1045,3,83,86,86,True
7001,2011-10-24,4,0,10,7,0,1,1,2,0.38,0.3939,0.94,0.1045,11,274,285,285,True
7002,2011-10-24,4,0,10,8,0,1,1,2,0.42,0.4242,0.88,0.1642,20,378,398,398,True
7003,2011-10-24,4,0,10,9,0,1,1,2,0.44,0.4394,0.82,0.1642,29,166,195,195,True
7004,2011-10-24,4,0,10,10,0,1,1,2,0.46,0.4545,0.82,0.2537,47,82,129,129,True
7005,2011-10-24,4,0,10,11,0,1,1,2,0.5,0.4848,0.72,0.1642,59,109,168,168,True
7006,2011-10-24,4,0,10,12,0,1,1,2,0.52,0.5,0.68,0.1045,64,156,220,220,True
7007,2011-10-24,4,0,10,13,0,1,1,2,0.54,0.5152,0.64,0.2239,60,138,198,198,True
7008,2011-10-24,4,0,10,14,0,1,1,2,0.54,0.5152,0.64,0.194,63,143,206,206,True
7009,2011-10-24,4,0,10,15,0,1,1,1,0.56,0.5303,0.6,0.1642,52,125,177,177,True
7010,2011-10-24,4,0,10,16,0,1,1,1,0.54,0.5152,0.64,0.194,68,242,310,310,True
7011,2011-10-24,4,0,10,17,0,1,1,1,0.52,0.5,0.68,0.1343,87,499,586,586,True
7012,2011-10-24,4,0,10,18,0,1,1,1,0.54,0.5152,0.6,0.0896,58,428,486,486,True
7013,2011-10-24,4,0,10,19,0,1,1,3,0.48,0.4697,0.82,0.0,25,212,237,237,True
7014,2011-10-24,4,0,10,20,0,1,1,1,0.48,0.4697,0.82,0.1045,11,118,129,129,True
7015,2011-10-24,4,0,10,21,0,1,1,1,0.46,0.4545,0.87,0.1045,12,114,126,126,True
7016,2011-10-24,4,0,10,22,0,1,1,1,0.48,0.4697,0.75,0.1642,3,76,79,79,True
7017,2011-10-24,4,0,10,23,0,1,1,1,0.46,0.4545,0.77,0.0896,9,50,59,59,True
7018,2011-10-25,4,0,10,0,0,2,1,1,0.44,0.4394,0.77,0.1343,4,26,30,30,True
7019,2011-10-25,4,0,10,1,0,2,1,1,0.44,0.4394,0.77,0.1343,5,6,11,11,True
7020,2011-10-25,4,0,10,2,0,2,1,1,0.42,0.4242,0.82,0.1343,2,3,5,5,True
7021,2011-10-25,4,0,10,3,0,2,1,1,0.4,0.4091,0.87,0.0,1,3,4,4,True
7022,2011-10-25,4,0,10,4,0,2,1,1,0.38,0.3939,0.87,0.1343,0,5,5,5,True
7023,2011-10-25,4,0,10,5,0,2,1,1,0.38,0.3939,0.87,0.1343,0,24,24,24,True
7024,2011-10-25,4,0,10,6,0,2,1,1,0.38,0.3939,0.82,0.1045,3,95,98,98,True
7025,2011-10-25,4,0,10,7,0,2,1,1,0.4,0.4091,0.76,0.194,15,299,314,314,True
7026,2011-10-25,4,0,10,8,0,2,1,1,0.44,0.4394,0.72,0.0,25,383,408,408,True
7027,2011-10-25,4,0,10,9,0,2,1,1,0.48,0.4697,0.55,0.2239,29,194,223,223,True
7028,2011-10-25,4,0,10,10,0,2,1,1,0.5,0.4848,0.51,0.2537,26,102,128,128,True
7029,2011-10-25,4,0,10,11,0,2,1,1,0.52,0.5,0.48,0.2836,46,120,166,166,True
7030,2011-10-25,4,0,10,12,0,2,1,1,0.54,0.5152,0.39,0.3582,35,165,200,200,True
7031,2011-10-25,4,0,10,13,0,2,1,1,0.56,0.5303,0.37,0.3881,37,161,198,198,True
7032,2011-10-25,4,0,10,14,0,2,1,1,0.56,0.5303,0.4,0.2537,66,134,200,200,True
7033,2011-10-25,4,0,10,15,0,2,1,1,0.56,0.5303,0.37,0.1045,63,171,234,234,True
7034,2011-10-25,4,0,10,16,0,2,1,1,0.56,0.5303,0.37,0.194,52,233,285,285,True
7035,2011-10-25,4,0,10,17,0,2,1,1,0.56,0.5303,0.37,0.1045,68,499,567,567,True
7036,2011-10-25,4,0,10,18,0,2,1,1,0.52,0.5,0.42,0.1045,65,453,518,518,True
7037,2011-10-25,4,0,10,19,0,2,1,1,0.48,0.4697,0.67,0.194,44,294,338,338,True
7038,2011-10-25,4,0,10,20,0,2,1,1,0.46,0.4545,0.67,0.1045,40,208,248,248,True
7039,2011-10-25,4,0,10,21,0,2,1,1,0.44,0.4394,0.72,0.1343,32,169,201,201,True
7040,2011-10-25,4,0,10,22,0,2,1,1,0.46,0.4545,0.67,0.194,22,148,170,170,True
7041,2011-10-25,4,0,10,23,0,2,1,1,0.44,0.4394,0.72,0.1343,15,79,94,94,True
7042,2011-10-26,4,0,10,0,0,3,1,1,0.44,0.4394,0.72,0.194,4,28,32,32,True
7043,2011-10-26,4,0,10,1,0,3,1,1,0.44,0.4394,0.67,0.2537,3,9,12,12,True
7044,2011-10-26,4,0,10,2,0,3,1,1,0.44,0.4394,0.67,0.1642,2,1,3,3,True
7045,2011-10-26,4,0,10,3,0,3,1,1,0.44,0.4394,0.67,0.2239,0,3,3,3,True
7046,2011-10-26,4,0,10,4,0,3,1,1,0.42,0.4242,0.71,0.2537,0,5,5,5,True
7047,2011-10-26,4,0,10,5,0,3,1,1,0.42,0.4242,0.71,0.2239,0,21,21,21,True
7048,2011-10-26,4,0,10,6,0,3,1,1,0.42,0.4242,0.71,0.2239,0,92,92,92,True
7049,2011-10-26,4,0,10,7,0,3,1,1,0.42,0.4242,0.71,0.1642,15,284,299,299,True
7050,2011-10-26,4,0,10,8,0,3,1,2,0.44,0.4394,0.67,0.194,26,438,464,464,True
7051,2011-10-26,4,0,10,9,0,3,1,2,0.48,0.4697,0.63,0.2239,14,226,240,240,True
7052,2011-10-26,4,0,10,10,0,3,1,2,0.52,0.5,0.62,0.2537,26,105,131,131,True
7053,2011-10-26,4,0,10,11,0,3,1,1,0.52,0.5,0.59,0.3284,23,132,155,155,True
7054,2011-10-26,4,0,10,12,0,3,1,3,0.58,0.5455,0.53,0.2239,39,155,194,194,True
7055,2011-10-26,4,0,10,13,0,3,1,3,0.56,0.5303,0.6,0.1045,20,62,82,82,True
7056,2011-10-26,4,0,10,14,0,3,1,2,0.52,0.5,0.77,0.0,14,52,66,66,True
7057,2011-10-26,4,0,10,15,0,3,1,2,0.52,0.5,0.77,0.0,11,59,70,70,True
7058,2011-10-26,4,0,10,16,0,3,1,2,0.52,0.5,0.77,0.0896,17,196,213,213,True
7059,2011-10-26,4,0,10,17,0,3,1,2,0.52,0.5,0.77,0.1045,40,414,454,454,True
7060,2011-10-26,4,0,10,18,0,3,1,1,0.52,0.5,0.77,0.1642,55,398,453,453,True
7061,2011-10-26,4,0,10,19,0,3,1,1,0.5,0.4848,0.82,0.0,25,306,331,331,True
7062,2011-10-26,4,0,10,20,0,3,1,1,0.5,0.4848,0.88,0.0,27,180,207,207,True
7063,2011-10-26,4,0,10,21,0,3,1,2,0.52,0.5,0.77,0.0,17,140,157,157,True
7064,2011-10-26,4,0,10,22,0,3,1,2,0.48,0.4697,0.88,0.0896,23,112,135,135,True
7065,2011-10-26,4,0,10,23,0,3,1,2,0.48,0.4697,0.88,0.0896,3,72,75,75,True
7066,2011-10-27,4,0,10,0,0,4,1,1,0.46,0.4545,0.94,0.0,3,23,26,26,True
7067,2011-10-27,4,0,10,1,0,4,1,1,0.46,0.4545,0.94,0.0,2,9,11,11,True
7068,2011-10-27,4,0,10,2,0,4,1,3,0.46,0.4545,0.94,0.0,3,5,8,8,True
7069,2011-10-27,4,0,10,3,0,4,1,3,0.46,0.4545,0.94,0.0,1,3,4,4,True
7070,2011-10-27,4,0,10,4,0,4,1,3,0.48,0.4697,0.88,0.0,1,3,4,4,True
7071,2011-10-27,4,0,10,5,0,4,1,3,0.48,0.4697,0.88,0.0896,1,14,15,15,True
7072,2011-10-27,4,0,10,6,0,4,1,3,0.5,0.4848,0.82,0.0,4,42,46,46,True
7073,2011-10-27,4,0,10,7,0,4,1,2,0.46,0.4545,0.94,0.0896,9,128,137,137,True
7074,2011-10-27,4,0,10,8,0,4,1,3,0.48,0.4697,0.88,0.194,12,304,316,316,True
7075,2011-10-27,4,0,10,9,0,4,1,2,0.5,0.4848,0.82,0.1642,16,155,171,171,True
7076,2011-10-27,4,0,10,10,0,4,1,3,0.5,0.4848,0.88,0.194,10,52,62,62,True
7077,2011-10-27,4,0,10,11,0,4,1,3,0.5,0.4848,0.88,0.1343,8,44,52,52,True
7078,2011-10-27,4,0,10,12,0,4,1,3,0.5,0.4848,0.88,0.1343,8,45,53,53,True
7079,2011-10-27,4,0,10,13,0,4,1,2,0.5,0.4848,0.88,0.1642,10,64,74,74,True
7080,2011-10-27,4,0,10,14,0,4,1,2,0.52,0.5,0.83,0.0,16,76,92,92,True
7081,2011-10-27,4,0,10,15,0,4,1,2,0.52,0.5,0.83,0.1045,12,95,107,107,True
7082,2011-10-27,4,0,10,16,0,4,1,2,0.56,0.5303,0.73,0.1642,14,193,207,207,True
7083,2011-10-27,4,0,10,17,0,4,1,2,0.5,0.4848,0.72,0.4627,31,291,322,322,True
7084,2011-10-27,4,0,10,18,0,4,1,2,0.48,0.4697,0.67,0.4627,14,226,240,240,True
7085,2011-10-27,4,0,10,19,0,4,1,2,0.44,0.4394,0.67,0.4627,19,200,219,219,True
7086,2011-10-27,4,0,10,20,0,4,1,1,0.42,0.4242,0.67,0.4775,11,171,182,182,True
7087,2011-10-27,4,0,10,21,0,4,1,1,0.4,0.4091,0.62,0.4775,13,119,132,132,True
7088,2011-10-27,4,0,10,22,0,4,1,1,0.36,0.3182,0.66,0.4775,14,97,111,111,True
7089,2011-10-27,4,0,10,23,0,4,1,1,0.34,0.303,0.61,0.4179,8,60,68,68,True
7090,2011-10-28,4,0,10,0,0,5,1,1,0.34,0.3182,0.66,0.2537,4,40,44,44,True
7091,2011-10-28,4,0,10,1,0,5,1,1,0.32,0.303,0.66,0.2537,7,9,16,16,True
7092,2011-10-28,4,0,10,2,0,5,1,1,0.32,0.303,0.66,0.2836,1,3,4,4,True
7093,2011-10-28,4,0,10,3,0,5,1,1,0.3,0.2879,0.7,0.2836,4,4,8,8,True
7094,2011-10-28,4,0,10,4,0,5,1,1,0.3,0.2879,0.65,0.2836,5,5,10,10,True
7095,2011-10-28,4,0,10,5,0,5,1,2,0.3,0.2879,0.61,0.2537,0,25,25,25,True
7096,2011-10-28,4,0,10,6,0,5,1,1,0.28,0.2727,0.65,0.2537,1,74,75,75,True
7097,2011-10-28,4,0,10,7,0,5,1,1,0.28,0.2727,0.65,0.2537,6,199,205,205,True
7098,2011-10-28,4,0,10,8,0,5,1,1,0.3,0.2879,0.61,0.2836,13,361,374,374,True
7099,2011-10-28,4,0,10,9,0,5,1,1,0.32,0.303,0.57,0.2239,19,210,229,229,True
7100,2011-10-28,4,0,10,10,0,5,1,1,0.34,0.3182,0.57,0.2239,28,102,130,130,True
7101,2011-10-28,4,0,10,11,0,5,1,1,0.36,0.3485,0.5,0.2239,40,128,168,168,True
7102,2011-10-28,4,0,10,12,0,5,1,2,0.38,0.3939,0.4,0.1642,46,167,213,213,True
7103,2011-10-28,4,0,10,13,0,5,1,2,0.38,0.3939,0.42,0.2239,43,185,228,228,True
7104,2011-10-28,4,0,10,14,0,5,1,2,0.36,0.3485,0.46,0.194,33,152,185,185,True
7105,2011-10-28,4,0,10,15,0,5,1,2,0.36,0.3333,0.43,0.2537,44,171,215,215,True
7106,2011-10-28,4,0,10,16,0,5,1,2,0.36,0.3485,0.46,0.1642,46,262,308,308,True
7107,2011-10-28,4,0,10,17,0,5,1,2,0.36,0.3485,0.5,0.1343,35,411,446,446,True
7108,2011-10-28,4,0,10,18,0,5,1,2,0.36,0.3485,0.53,0.1642,36,332,368,368,True
7109,2011-10-28,4,0,10,19,0,5,1,2,0.36,0.3485,0.5,0.1343,16,188,204,204,True
7110,2011-10-28,4,0,10,20,0,5,1,3,0.34,0.3182,0.61,0.2239,12,131,143,143,True
7111,2011-10-28,4,0,10,21,0,5,1,3,0.32,0.3182,0.7,0.1642,5,69,74,74,True
7112,2011-10-28,4,0,10,22,0,5,1,3,0.3,0.2879,0.75,0.2836,4,32,36,36,True
7113,2011-10-28,4,0,10,23,0,5,1,3,0.3,0.2727,0.81,0.3284,8,31,39,39,True
7114,2011-10-29,4,0,10,0,0,6,0,3,0.28,0.2576,0.87,0.2985,0,19,19,19,True
7115,2011-10-29,4,0,10,1,0,6,0,3,0.3,0.2727,0.87,0.2985,0,18,18,18,True
7116,2011-10-29,4,0,10,2,0,6,0,3,0.3,0.2727,0.87,0.2985,1,16,17,17,True
7117,2011-10-29,4,0,10,3,0,6,0,3,0.3,0.2727,0.81,0.4179,0,8,8,8,True
7118,2011-10-29,4,0,10,4,0,6,0,3,0.3,0.2727,0.81,0.4179,0,1,1,1,True
7119,2011-10-29,4,0,10,5,0,6,0,3,0.26,0.2273,0.93,0.3582,0,1,1,1,True
7120,2011-10-29,4,0,10,6,0,6,0,3,0.26,0.2273,0.87,0.3582,4,1,5,5,True
7121,2011-10-29,4,0,10,7,0,6,0,3,0.26,0.2273,0.87,0.3582,1,6,7,7,True
7122,2011-10-29,4,0,10,8,0,6,0,3,0.28,0.2576,0.87,0.3582,4,16,20,20,True
7123,2011-10-29,4,0,10,9,0,6,0,3,0.28,0.2576,0.87,0.3582,1,19,20,20,True
7124,2011-10-29,4,0,10,10,0,6,0,3,0.26,0.2273,0.93,0.3284,0,12,12,12,True
7125,2011-10-29,4,0,10,11,0,6,0,3,0.26,0.2273,0.93,0.3881,1,26,27,27,True
7126,2011-10-29,4,0,10,12,0,6,0,3,0.24,0.197,0.87,0.4775,6,44,50,50,True
7127,2011-10-29,4,0,10,13,0,6,0,3,0.24,0.197,0.87,0.4775,0,30,30,30,True
7128,2011-10-29,4,0,10,14,0,6,0,3,0.24,0.197,0.87,0.4478,0,29,29,29,True
7129,2011-10-29,4,0,10,15,0,6,0,3,0.22,0.2121,0.93,0.2537,3,38,41,41,True
7130,2011-10-29,4,0,10,16,0,6,0,3,0.22,0.197,0.93,0.3284,3,19,22,22,True
7131,2011-10-29,4,0,10,17,0,6,0,3,0.22,0.197,0.93,0.3284,3,28,31,31,True
7132,2011-10-29,4,0,10,18,0,6,0,3,0.22,0.197,0.93,0.3284,6,37,43,43,True
7133,2011-10-29,4,0,10,19,0,6,0,1,0.24,0.2121,0.87,0.3582,3,36,39,39,True
7134,2011-10-29,4,0,10,20,0,6,0,1,0.24,0.2121,0.87,0.3582,7,40,47,47,True
7135,2011-10-29,4,0,10,21,0,6,0,1,0.24,0.2121,0.87,0.3582,1,49,50,50,True
7136,2011-10-29,4,0,10,22,0,6,0,1,0.22,0.2121,0.87,0.2239,10,44,54,54,True
7137,2011-10-29,4,0,10,23,0,6,0,1,0.22,0.2273,0.87,0.194,3,33,36,36,True
7138,2011-10-30,4,0,10,0,0,0,0,1,0.22,0.2121,0.87,0.2239,7,47,54,54,True
7139,2011-10-30,4,0,10,1,0,0,0,1,0.22,0.2121,0.87,0.2537,9,34,43,43,True
7140,2011-10-30,4,0,10,2,0,0,0,1,0.22,0.2121,0.87,0.2836,7,43,50,50,True
7141,2011-10-30,4,0,10,3,0,0,0,1,0.24,0.2121,0.75,0.3582,7,26,33,33,True
7142,2011-10-30,4,0,10,4,0,0,0,1,0.22,0.197,0.8,0.3284,1,10,11,11,True
7143,2011-10-30,4,0,10,5,0,0,0,1,0.24,0.2121,0.75,0.2985,0,4,4,4,True
7144,2011-10-30,4,0,10,6,0,0,0,1,0.24,0.2273,0.75,0.2537,2,8,10,10,True
7145,2011-10-30,4,0,10,7,0,0,0,1,0.24,0.2879,0.75,0.0,7,15,22,22,True
7146,2011-10-30,4,0,10,8,0,0,0,1,0.26,0.2576,0.7,0.2239,20,60,80,80,True
7147,2011-10-30,4,0,10,9,0,0,0,1,0.3,0.2879,0.65,0.2537,55,92,147,147,True
7148,2011-10-30,4,0,10,10,0,0,0,1,0.32,0.3333,0.61,0.0896,53,125,178,178,True
7149,2011-10-30,4,0,10,11,0,0,0,1,0.36,0.3485,0.53,0.2239,58,182,240,240,True
7150,2011-10-30,4,0,10,12,0,0,0,1,0.38,0.3939,0.5,0.194,85,229,314,314,True
7151,2011-10-30,4,0,10,13,0,0,0,1,0.4,0.4091,0.43,0.2239,113,232,345,345,True
7152,2011-10-30,4,0,10,14,0,0,0,1,0.42,0.4242,0.38,0.194,91,209,300,300,True
7153,2011-10-30,4,0,10,15,0,0,0,1,0.42,0.4242,0.35,0.1642,88,202,290,290,True
7154,2011-10-30,4,0,10,16,0,0,0,1,0.42,0.4242,0.32,0.1343,107,213,320,320,True
7155,2011-10-30,4,0,10,17,0,0,0,1,0.4,0.4091,0.35,0.1045,54,191,245,245,True
7156,2011-10-30,4,0,10,18,0,0,0,1,0.36,0.3485,0.4,0.1343,51,162,213,213,True
7157,2011-10-30,4,0,10,19,0,0,0,1,0.56,0.5303,0.49,0.2985,28,125,153,153,True
7158,2011-10-30,4,0,10,20,0,0,0,1,0.34,0.3636,0.57,0.0,18,74,92,92,True
7159,2011-10-30,4,0,10,21,0,0,0,1,0.32,0.3485,0.66,0.0,4,75,79,79,True
7160,2011-10-30,4,0,10,22,0,0,0,1,0.3,0.3333,0.75,0.0,13,58,71,71,True
7161,2011-10-30,4,0,10,23,0,0,0,1,0.26,0.303,0.87,0.0,7,30,37,37,True
7162,2011-10-31,4,0,10,0,0,1,1,1,0.26,0.303,0.87,0.0,3,20,23,23,True
7163,2011-10-31,4,0,10,1,0,1,1,1,0.26,0.303,0.81,0.0,5,8,13,13,True
7164,2011-10-31,4,0,10,2,0,1,1,1,0.24,0.2879,0.87,0.0,0,3,3,3,True
7165,2011-10-31,4,0,10,3,0,1,1,1,0.24,0.2576,0.87,0.1045,0,3,3,3,True
7166,2011-10-31,4,0,10,4,0,1,1,1,0.24,0.2879,0.87,0.0,1,5,6,6,True
7167,2011-10-31,4,0,10,5,0,1,1,1,0.22,0.2727,0.93,0.0,0,18,18,18,True
7168,2011-10-31,4,0,10,6,0,1,1,1,0.24,0.2879,0.87,0.0,4,82,86,86,True
7169,2011-10-31,4,0,10,7,0,1,1,1,0.24,0.2879,0.93,0.0,11,216,227,227,True
7170,2011-10-31,4,0,10,8,0,1,1,2,0.28,0.3182,0.87,0.0,17,355,372,372,True
7171,2011-10-31,4,0,10,9,0,1,1,2,0.32,0.3182,0.76,0.1642,14,197,211,211,True
7172,2011-10-31,4,0,10,10,0,1,1,2,0.36,0.3485,0.57,0.1642,18,87,105,105,True
7173,2011-10-31,4,0,10,11,0,1,1,1,0.4,0.4091,0.5,0.1343,31,97,128,128,True
7174,2011-10-31,4,0,10,12,0,1,1,1,0.42,0.4242,0.44,0.2239,30,140,170,170,True
7175,2011-10-31,4,0,10,13,0,1,1,2,0.44,0.4394,0.44,0.2239,24,128,152,152,True
7176,2011-10-31,4,0,10,14,0,1,1,2,0.44,0.4394,0.47,0.2239,22,119,141,141,True
7177,2011-10-31,4,0,10,15,0,1,1,1,0.44,0.4394,0.47,0.1642,27,141,168,168,True
7178,2011-10-31,4,0,10,16,0,1,1,1,0.42,0.4242,0.54,0.1642,30,242,272,272,True
7179,2011-10-31,4,0,10,17,0,1,1,1,0.42,0.4242,0.54,0.1343,44,442,486,486,True
7180,2011-10-31,4,0,10,18,0,1,1,1,0.4,0.4091,0.66,0.0896,30,392,422,422,True
7181,2011-10-31,4,0,10,19,0,1,1,1,0.4,0.4091,0.66,0.0896,12,226,238,238,True
7182,2011-10-31,4,0,10,20,0,1,1,1,0.4,0.4091,0.66,0.0896,18,154,172,172,True
7183,2011-10-31,4,0,10,21,0,1,1,2,0.36,0.3485,0.76,0.194,7,109,116,116,True
7184,2011-10-31,4,0,10,22,0,1,1,2,0.36,0.3485,0.76,0.194,8,77,85,85,True
7185,2011-10-31,4,0,10,23,0,1,1,2,0.36,0.3485,0.76,0.194,6,46,52,52,True
7186,2011-11-01,4,0,11,0,0,2,1,2,0.36,0.3485,0.87,0.1642,3,18,21,21,True
7187,2011-11-01,4,0,11,1,0,2,1,1,0.36,0.3485,0.81,0.1343,3,8,11,11,True
7188,2011-11-01,4,0,11,2,0,2,1,2,0.36,0.3485,0.81,0.1642,1,3,4,4,True
7189,2011-11-01,4,0,11,3,0,2,1,2,0.36,0.3485,0.81,0.1343,1,5,6,6,True
7190,2011-11-01,4,0,11,4,0,2,1,1,0.34,0.3182,0.81,0.2239,1,7,8,8,True
7191,2011-11-01,4,0,11,5,0,2,1,1,0.32,0.3182,0.81,0.194,0,18,18,18,True
7192,2011-11-01,4,0,11,6,0,2,1,1,0.32,0.3182,0.81,0.194,3,90,93,93,True
7193,2011-11-01,4,0,11,7,0,2,1,1,0.34,0.3333,0.76,0.194,8,246,254,254,True
7194,2011-11-01,4,0,11,8,0,2,1,1,0.36,0.3333,0.71,0.2537,17,402,419,419,True
7195,2011-11-01,4,0,11,9,0,2,1,1,0.4,0.4091,0.66,0.1642,16,206,222,222,True
7196,2011-11-01,4,0,11,10,0,2,1,1,0.44,0.4394,0.62,0.1343,21,114,135,135,True
7197,2011-11-01,4,0,11,11,0,2,1,1,0.46,0.4545,0.63,0.1045,16,101,117,117,True
7198,2011-11-01,4,0,11,12,0,2,1,1,0.5,0.4848,0.48,0.0896,23,153,176,176,True
7199,2011-11-01,4,0,11,13,0,2,1,1,0.48,0.4697,0.55,0.194,20,147,167,167,True
7200,2011-11-01,4,0,11,14,0,2,1,1,0.5,0.4848,0.48,0.2537,32,118,150,150,True
7201,2011-11-01,4,0,11,15,0,2,1,1,0.5,0.4848,0.45,0.1343,38,148,186,186,True
7202,2011-11-01,4,0,11,16,0,2,1,1,0.48,0.4697,0.44,0.1642,46,252,298,298,True
7203,2011-11-01,4,0,11,17,0,2,1,1,0.44,0.4394,0.54,0.1642,36,470,506,506,True
7204,2011-11-01,4,0,11,18,0,2,1,1,0.42,0.4242,0.58,0.1045,39,421,460,460,True
7205,2011-11-01,4,0,11,19,0,2,1,1,0.42,0.4242,0.58,0.0896,39,274,313,313,True
7206,2011-11-01,4,0,11,20,0,2,1,1,0.4,0.4091,0.71,0.0,18,191,209,209,True
7207,2011-11-01,4,0,11,21,0,2,1,1,0.36,0.3788,0.81,0.0,13,114,127,127,True
7208,2011-11-01,4,0,11,22,0,2,1,1,0.36,0.3788,0.81,0.0,5,91,96,96,True
7209,2011-11-01,4,0,11,23,0,2,1,1,0.34,0.3636,0.87,0.0,11,61,72,72,True
7210,2011-11-02,4,0,11,0,0,3,1,1,0.32,0.3485,0.87,0.0,0,19,19,19,True
7211,2011-11-02,4,0,11,1,0,3,1,1,0.3,0.3333,0.87,0.0,2,8,10,10,True
7212,2011-11-02,4,0,11,2,0,3,1,1,0.3,0.3333,0.87,0.0,0,2,2,2,True
7213,2011-11-02,4,0,11,3,0,3,1,1,0.3,0.3333,0.75,0.0,0,2,2,2,True
7214,2011-11-02,4,0,11,4,0,3,1,1,0.3,0.3333,0.87,0.0,0,4,4,4,True
7215,2011-11-02,4,0,11,5,0,3,1,1,0.3,0.3333,0.81,0.0,0,27,27,27,True
7216,2011-11-02,4,0,11,6,0,3,1,1,0.3,0.3333,0.81,0.0,1,91,92,92,True
7217,2011-11-02,4,0,11,7,0,3,1,1,0.3,0.3333,0.81,0.0,11,240,251,251,True
7218,2011-11-02,4,0,11,8,0,3,1,1,0.32,0.3485,0.87,0.0,20,452,472,472,True
7219,2011-11-02,4,0,11,9,0,3,1,1,0.34,0.3636,0.87,0.0,15,213,228,228,True
7220,2011-11-02,4,0,11,10,0,3,1,1,0.4,0.4091,0.71,0.0896,25,108,133,133,True
7221,2011-11-02,4,0,11,11,0,3,1,1,0.42,0.4242,0.71,0.1343,27,117,144,144,True
7222,2011-11-02,4,0,11,12,0,3,1,1,0.46,0.4545,0.55,0.1642,32,157,189,189,True
7223,2011-11-02,4,0,11,13,0,3,1,1,0.48,0.4697,0.48,0.1642,22,139,161,161,True
7224,2011-11-02,4,0,11,14,0,3,1,1,0.5,0.4848,0.45,0.1642,40,132,172,172,True
7225,2011-11-02,4,0,11,15,0,3,1,1,0.48,0.4697,0.51,0.1642,26,161,187,187,True
7226,2011-11-02,4,0,11,16,0,3,1,1,0.48,0.4697,0.51,0.1045,35,231,266,266,True
7227,2011-11-02,4,0,11,17,0,3,1,1,0.44,0.4394,0.62,0.194,30,499,529,529,True
7228,2011-11-02,4,0,11,18,0,3,1,1,0.42,0.4242,0.71,0.1642,31,448,479,479,True
7229,2011-11-02,4,0,11,19,0,3,1,1,0.4,0.4091,0.76,0.1343,25,257,282,282,True
7230,2011-11-02,4,0,11,20,0,3,1,1,0.4,0.4091,0.66,0.1343,5,177,182,182,True
7231,2011-11-02,4,0,11,21,0,3,1,1,0.38,0.3939,0.71,0.1343,13,155,168,168,True
7232,2011-11-02,4,0,11,22,0,3,1,1,0.36,0.3485,0.71,0.1343,7,99,106,106,True
7233,2011-11-02,4,0,11,23,0,3,1,1,0.36,0.3636,0.76,0.0896,3,54,57,57,True
7234,2011-11-03,4,0,11,0,0,4,1,1,0.36,0.3636,0.76,0.0896,3,28,31,31,True
7235,2011-11-03,4,0,11,1,0,4,1,1,0.34,0.3333,0.81,0.1343,3,12,15,15,True
7236,2011-11-03,4,0,11,2,0,4,1,1,0.34,0.3333,0.76,0.1343,2,5,7,7,True
7237,2011-11-03,4,0,11,3,0,4,1,1,0.34,0.3333,0.81,0.1343,1,4,5,5,True
7238,2011-11-03,4,0,11,4,0,4,1,1,0.32,0.3333,0.81,0.0896,1,3,4,4,True
7239,2011-11-03,4,0,11,5,0,4,1,1,0.32,0.3333,0.81,0.1343,1,27,28,28,True
7240,2011-11-03,4,0,11,6,0,4,1,1,0.34,0.3333,0.76,0.194,3,96,99,99,True
7241,2011-11-03,4,0,11,7,0,4,1,2,0.32,0.3333,0.81,0.0896,12,280,292,292,True
7242,2011-11-03,4,0,11,8,0,4,1,2,0.34,0.3485,0.81,0.0896,8,394,402,402,True
7243,2011-11-03,4,0,11,9,0,4,1,2,0.36,0.3485,0.81,0.194,9,155,164,164,True
7244,2011-11-03,4,0,11,10,0,4,1,2,0.4,0.4091,0.76,0.194,12,98,110,110,True
7245,2011-11-03,4,0,11,11,0,4,1,1,0.44,0.4394,0.67,0.194,12,108,120,120,True
7246,2011-11-03,4,0,11,12,0,4,1,1,0.5,0.4848,0.51,0.194,17,162,179,179,True
7247,2011-11-03,4,0,11,13,0,4,1,2,0.52,0.5,0.48,0.2537,19,150,169,169,True
7248,2011-11-03,4,0,11,14,0,4,1,1,0.52,0.5,0.52,0.1642,32,120,152,152,True
7249,2011-11-03,4,0,11,15,0,4,1,1,0.52,0.5,0.52,0.1642,24,138,162,162,True
7250,2011-11-03,4,0,11,16,0,4,1,1,0.52,0.5,0.48,0.194,33,234,267,267,True
7251,2011-11-03,4,0,11,17,0,4,1,1,0.48,0.4697,0.55,0.0896,33,465,498,498,True
7252,2011-11-03,4,0,11,18,0,4,1,1,0.46,0.4545,0.63,0.1343,24,409,433,433,True
7253,2011-11-03,4,0,11,19,0,4,1,1,0.44,0.4394,0.67,0.0896,18,234,252,252,True
7254,2011-11-03,4,0,11,20,0,4,1,1,0.42,0.4242,0.71,0.1045,11,198,209,209,True
7255,2011-11-03,4,0,11,21,0,4,1,1,0.4,0.4091,0.76,0.1343,4,140,144,144,True
7256,2011-11-03,4,0,11,22,0,4,1,1,0.4,0.4091,0.82,0.0,21,116,137,137,True
7257,2011-11-03,4,0,11,23,0,4,1,1,0.4,0.4091,0.82,0.0896,15,80,95,95,True
7258,2011-11-04,4,0,11,0,0,5,1,2,0.4,0.4091,0.82,0.0,11,32,43,43,True
7259,2011-11-04,4,0,11,1,0,5,1,2,0.4,0.4091,0.82,0.0,1,16,17,17,True
7260,2011-11-04,4,0,11,2,0,5,1,2,0.4,0.4091,0.76,0.0,2,8,10,10,True
7261,2011-11-04,4,0,11,3,0,5,1,2,0.38,0.3939,0.87,0.1642,1,7,8,8,True
7262,2011-11-04,4,0,11,4,0,5,1,2,0.38,0.3939,0.87,0.0896,1,6,7,7,True
7263,2011-11-04,4,0,11,5,0,5,1,2,0.38,0.3939,0.87,0.0,0,23,23,23,True
7264,2011-11-04,4,0,11,6,0,5,1,2,0.38,0.3939,0.87,0.0896,2,64,66,66,True
7265,2011-11-04,4,0,11,7,0,5,1,2,0.4,0.4091,0.86,0.2239,10,235,245,245,True
7266,2011-11-04,4,0,11,8,0,5,1,2,0.4,0.4091,0.87,0.3582,8,387,395,395,True
7267,2011-11-04,4,0,11,9,0,5,1,2,0.42,0.4242,0.71,0.4627,15,239,254,254,True
7268,2011-11-04,4,0,11,10,0,5,1,2,0.42,0.4242,0.71,0.3284,19,115,134,134,True
7269,2011-11-04,4,0,11,11,0,5,1,2,0.44,0.4394,0.67,0.4478,34,128,162,162,True
7270,2011-11-04,4,0,11,12,0,5,1,2,0.48,0.4697,0.55,0.4775,44,153,197,197,True
7271,2011-11-04,4,0,11,13,0,5,1,1,0.44,0.4394,0.51,0.4179,33,161,194,194,True
7272,2011-11-04,4,0,11,14,0,5,1,1,0.44,0.4394,0.47,0.2985,54,147,201,201,True
7273,2011-11-04,4,0,11,15,0,5,1,1,0.46,0.4545,0.44,0.3881,45,192,237,237,True
7274,2011-11-04,4,0,11,16,0,5,1,1,0.46,0.4545,0.36,0.3881,53,237,290,290,True
7275,2011-11-04,4,0,11,17,0,5,1,1,0.42,0.4242,0.38,0.3582,42,438,480,480,True
7276,2011-11-04,4,0,11,18,0,5,1,1,0.42,0.4242,0.32,0.4627,35,339,374,374,True
7277,2011-11-04,4,0,11,19,0,5,1,1,0.4,0.4091,0.37,0.3582,14,182,196,196,True
7278,2011-11-04,4,0,11,20,0,5,1,1,0.36,0.3333,0.43,0.2836,15,171,186,186,True
7279,2011-11-04,4,0,11,21,0,5,1,1,0.34,0.3182,0.46,0.2537,8,115,123,123,True
7280,2011-11-04,4,0,11,22,0,5,1,1,0.34,0.303,0.46,0.3284,6,109,115,115,True
7281,2011-11-04,4,0,11,23,0,5,1,1,0.32,0.303,0.49,0.3284,17,72,89,89,True
7282,2011-11-05,4,0,11,0,0,6,0,1,0.32,0.2879,0.45,0.3582,4,48,52,52,True
7283,2011-11-05,4,0,11,1,0,6,0,1,0.32,0.303,0.45,0.2985,5,57,62,62,True
7284,2011-11-05,4,0,11,2,0,6,0,1,0.3,0.2727,0.52,0.3284,7,24,31,31,True
7285,2011-11-05,4,0,11,3,0,6,0,1,0.3,0.2727,0.52,0.2985,0,8,8,8,True
7286,2011-11-05,4,0,11,4,0,6,0,1,0.28,0.2576,0.56,0.3284,3,5,8,8,True
7287,2011-11-05,4,0,11,5,0,6,0,1,0.26,0.2273,0.6,0.3284,0,2,2,2,True
7288,2011-11-05,4,0,11,6,0,6,0,1,0.26,0.2424,0.6,0.2537,3,20,23,23,True
7289,2011-11-05,4,0,11,7,0,6,0,1,0.26,0.2424,0.6,0.2836,3,31,34,34,True
7290,2011-11-05,4,0,11,8,0,6,0,1,0.28,0.2576,0.56,0.3284,4,80,84,84,True
7291,2011-11-05,4,0,11,9,0,6,0,1,0.3,0.2727,0.56,0.2985,30,111,141,141,True
7292,2011-11-05,4,0,11,10,0,6,0,1,0.32,0.303,0.53,0.2537,56,171,227,227,True
7293,2011-11-05,4,0,11,11,0,6,0,1,0.36,0.3636,0.46,0.1045,69,169,238,238,True
7294,2011-11-05,4,0,11,12,0,6,0,1,0.36,0.3485,0.46,0.1642,114,235,349,349,True
7295,2011-11-05,4,0,11,13,0,6,0,1,0.4,0.4091,0.37,0.1045,114,207,321,321,True
7296,2011-11-05,4,0,11,14,0,6,0,1,0.42,0.4242,0.35,0.1343,114,227,341,341,True
7297,2011-11-05,4,0,11,15,0,6,0,1,0.4,0.4091,0.37,0.194,114,202,316,316,True
7298,2011-11-05,4,0,11,16,0,6,0,1,0.4,0.4091,0.4,0.2239,114,207,321,321,True
7299,2011-11-05,4,0,11,17,0,6,0,1,0.38,0.3939,0.4,0.1642,100,234,334,334,True
7300,2011-11-05,4,0,11,18,0,6,0,1,0.36,0.3636,0.5,0.0896,52,185,237,237,True
7301,2011-11-05,4,0,11,19,0,6,0,1,0.34,0.3636,0.53,0.0,45,159,204,204,True
7302,2011-11-05,4,0,11,20,0,6,0,1,0.32,0.3485,0.66,0.0,29,136,165,165,True
7303,2011-11-05,4,0,11,21,0,6,0,1,0.32,0.3485,0.66,0.0,19,99,118,118,True
7304,2011-11-05,4,0,11,22,0,6,0,1,0.3,0.3333,0.65,0.0,10,72,82,82,True
7305,2011-11-05,4,0,11,23,0,6,0,1,0.28,0.3182,0.7,0.0,4,81,85,85,True
7306,2011-11-06,4,0,11,0,0,0,0,1,0.28,0.3182,0.75,0.0,10,65,75,75,True
7307,2011-11-06,4,0,11,1,0,0,0,1,0.26,0.303,0.81,0.0,11,104,115,115,True
7308,2011-11-06,4,0,11,2,0,0,0,1,0.26,0.303,0.81,0.0,6,23,29,29,True
7309,2011-11-06,4,0,11,3,0,0,0,1,0.24,0.2879,0.87,0.0,5,4,9,9,True
7310,2011-11-06,4,0,11,4,0,0,0,1,0.24,0.2879,0.87,0.0,0,6,6,6,True
7311,2011-11-06,4,0,11,5,0,0,0,1,0.24,0.2424,0.87,0.1343,0,5,5,5,True
7312,2011-11-06,4,0,11,6,0,0,0,1,0.26,0.2879,0.81,0.0896,5,11,16,16,True
7313,2011-11-06,4,0,11,7,0,0,0,1,0.26,0.2727,0.87,0.1045,4,24,28,28,True
7314,2011-11-06,4,0,11,8,0,0,0,2,0.28,0.303,0.87,0.0896,19,71,90,90,True
7315,2011-11-06,4,0,11,9,0,0,0,2,0.3,0.3182,0.75,0.0896,36,134,170,170,True
7316,2011-11-06,4,0,11,10,0,0,0,1,0.36,0.3636,0.66,0.0896,76,186,262,262,True
7317,2011-11-06,4,0,11,11,0,0,0,1,0.42,0.4242,0.58,0.0896,104,216,320,320,True
7318,2011-11-06,4,0,11,12,0,0,0,1,0.44,0.4394,0.54,0.0,114,226,340,340,True
7319,2011-11-06,4,0,11,13,0,0,0,1,0.46,0.4545,0.51,0.1642,105,209,314,314,True
7320,2011-11-06,4,0,11,14,0,0,0,1,0.46,0.4545,0.55,0.194,101,219,320,320,True
7321,2011-11-06,4,0,11,15,0,0,0,1,0.48,0.4697,0.51,0.194,96,210,306,306,True
7322,2011-11-06,4,0,11,16,0,0,0,1,0.46,0.4545,0.55,0.2239,84,263,347,347,True
7323,2011-11-06,4,0,11,17,0,0,0,1,0.44,0.4394,0.62,0.1642,71,185,256,256,True
7324,2011-11-06,4,0,11,18,0,0,0,1,0.42,0.4242,0.71,0.1045,39,146,185,185,True
7325,2011-11-06,4,0,11,19,0,0,0,1,0.38,0.3939,0.76,0.194,21,130,151,151,True
7326,2011-11-06,4,0,11,20,0,0,0,1,0.36,0.3636,0.81,0.1045,16,100,116,116,True
7327,2011-11-06,4,0,11,21,0,0,0,1,0.36,0.3636,0.81,0.0896,11,77,88,88,True
7328,2011-11-06,4,0,11,22,0,0,0,1,0.36,0.3788,0.87,0.0,5,40,45,45,True
7329,2011-11-06,4,0,11,23,0,0,0,1,0.34,0.3485,0.87,0.0896,7,43,50,50,True
7330,2011-11-07,4,0,11,0,0,1,1,1,0.34,0.3636,0.87,0.0,1,14,15,15,True
7331,2011-11-07,4,0,11,1,0,1,1,1,0.34,0.3636,0.87,0.0,2,6,8,8,True
7332,2011-11-07,4,0,11,2,0,1,1,1,0.32,0.3485,0.93,0.0,0,2,2,2,True
7333,2011-11-07,4,0,11,3,0,1,1,1,0.32,0.3485,0.93,0.0,0,3,3,3,True
7334,2011-11-07,4,0,11,4,0,1,1,1,0.32,0.3485,0.93,0.0,2,4,6,6,True
7335,2011-11-07,4,0,11,5,0,1,1,1,0.3,0.3333,0.93,0.0,1,25,26,26,True
7336,2011-11-07,4,0,11,6,0,1,1,2,0.28,0.3182,0.93,0.0,2,97,99,99,True
7337,2011-11-07,4,0,11,7,0,1,1,2,0.28,0.3182,0.93,0.0,6,305,311,311,True
7338,2011-11-07,4,0,11,8,0,1,1,2,0.3,0.3182,1.0,0.0896,13,397,410,410,True
7339,2011-11-07,4,0,11,9,0,1,1,2,0.34,0.3333,1.0,0.1343,18,156,174,174,True
7340,2011-11-07,4,0,11,10,0,1,1,1,0.36,0.3485,0.93,0.1343,28,95,123,123,True
7341,2011-11-07,4,0,11,11,0,1,1,1,0.42,0.4242,0.77,0.1045,28,100,128,128,True
7342,2011-11-07,4,0,11,12,0,1,1,1,0.46,0.4545,0.67,0.0,21,158,179,179,True
7343,2011-11-07,4,0,11,13,0,1,1,1,0.54,0.5152,0.49,0.0896,32,157,189,189,True
7344,2011-11-07,4,0,11,14,0,1,1,1,0.56,0.5303,0.37,0.1642,30,115,145,145,True
7345,2011-11-07,4,0,11,15,0,1,1,1,0.56,0.5303,0.37,0.1045,38,132,170,170,True
7346,2011-11-07,4,0,11,16,0,1,1,1,0.52,0.5,0.45,0.0,40,255,295,295,True
7347,2011-11-07,4,0,11,17,0,1,1,1,0.5,0.4848,0.45,0.1642,39,489,528,528,True
7348,2011-11-07,4,0,11,18,0,1,1,1,0.46,0.4545,0.59,0.1045,18,407,425,425,True
7349,2011-11-07,4,0,11,19,0,1,1,1,0.46,0.4545,0.59,0.0,20,280,300,300,True
7350,2011-11-07,4,0,11,20,0,1,1,1,0.4,0.4091,0.71,0.0,17,187,204,204,True
7351,2011-11-07,4,0,11,21,0,1,1,1,0.38,0.3939,0.82,0.1045,10,129,139,139,True
7352,2011-11-07,4,0,11,22,0,1,1,1,0.36,0.3636,0.81,0.0896,6,102,108,108,True
7353,2011-11-07,4,0,11,23,0,1,1,1,0.36,0.3636,0.87,0.0896,1,47,48,48,True
7354,2011-11-08,4,0,11,0,0,2,1,1,0.34,0.3485,0.87,0.0896,0,18,18,18,True
7355,2011-11-08,4,0,11,1,0,2,1,1,0.32,0.3333,0.93,0.1045,3,8,11,11,True
7356,2011-11-08,4,0,11,2,0,2,1,1,0.32,0.3485,0.87,0.0,0,1,1,1,True
7357,2011-11-08,4,0,11,3,0,2,1,1,0.32,0.3485,0.87,0.0,0,3,3,3,True
7358,2011-11-08,4,0,11,4,0,2,1,1,0.3,0.3333,0.87,0.0,0,4,4,4,True
7359,2011-11-08,4,0,11,5,0,2,1,1,0.3,0.3182,0.87,0.0896,1,17,18,18,True
7360,2011-11-08,4,0,11,6,0,2,1,1,0.3,0.3333,0.87,0.0,3,96,99,99,True
7361,2011-11-08,4,0,11,7,0,2,1,1,0.3,0.3182,0.87,0.1045,7,316,323,323,True
7362,2011-11-08,4,0,11,8,0,2,1,1,0.32,0.3333,0.93,0.1045,11,455,466,466,True
7363,2011-11-08,4,0,11,9,0,2,1,1,0.36,0.3788,0.87,0.0,14,177,191,191,True
7364,2011-11-08,4,0,11,10,0,2,1,1,0.42,0.4242,0.71,0.0896,25,104,129,129,True
7365,2011-11-08,4,0,11,11,0,2,1,1,0.46,0.4545,0.63,0.1343,21,126,147,147,True
7366,2011-11-08,4,0,11,12,0,2,1,1,0.52,0.5,0.52,0.1343,28,175,203,203,True
7367,2011-11-08,4,0,11,13,0,2,1,1,0.54,0.5152,0.49,0.1642,31,165,196,196,True
7368,2011-11-08,4,0,11,14,0,2,1,1,0.56,0.5303,0.46,0.1045,32,129,161,161,True
7369,2011-11-08,4,0,11,15,0,2,1,1,0.58,0.5455,0.46,0.1045,33,155,188,188,True
7370,2011-11-08,4,0,11,16,0,2,1,1,0.56,0.5303,0.46,0.1343,39,250,289,289,True
7371,2011-11-08,4,0,11,17,0,2,1,1,0.52,0.5,0.43,0.1642,40,459,499,499,True
7372,2011-11-08,4,0,11,18,0,2,1,1,0.48,0.4697,0.55,0.1343,30,432,462,462,True
7373,2011-11-08,4,0,11,19,0,2,1,1,0.46,0.4545,0.59,0.0,14,264,278,278,True
7374,2011-11-08,4,0,11,20,0,2,1,1,0.4,0.4091,0.76,0.0,12,169,181,181,True
7375,2011-11-08,4,0,11,21,0,2,1,1,0.4,0.4091,0.76,0.0,16,166,182,182,True
7376,2011-11-08,4,0,11,22,0,2,1,1,0.36,0.3788,0.87,0.0,13,95,108,108,True
7377,2011-11-08,4,0,11,23,0,2,1,1,0.36,0.3788,0.81,0.0,3,45,48,48,True
7378,2011-11-09,4,0,11,0,0,3,1,1,0.36,0.3788,0.87,0.0,0,13,13,13,True
7379,2011-11-09,4,0,11,1,0,3,1,1,0.34,0.3636,0.87,0.0,0,10,10,10,True
7380,2011-11-09,4,0,11,2,0,3,1,1,0.32,0.3485,0.93,0.0,0,5,5,5,True
7381,2011-11-09,4,0,11,3,0,3,1,1,0.32,0.3485,0.93,0.0,0,4,4,4,True
7382,2011-11-09,4,0,11,4,0,3,1,1,0.32,0.3485,0.87,0.0,0,4,4,4,True
7383,2011-11-09,4,0,11,5,0,3,1,1,0.3,0.3333,0.87,0.0,0,28,28,28,True
7384,2011-11-09,4,0,11,6,0,3,1,1,0.3,0.3333,0.87,0.0,0,98,98,98,True
7385,2011-11-09,4,0,11,7,0,3,1,1,0.3,0.3333,0.87,0.0,0,300,300,300,True
7386,2011-11-09,4,0,11,8,0,3,1,1,0.32,0.3485,0.93,0.0,19,437,456,456,True
7387,2011-11-09,4,0,11,9,0,3,1,1,0.34,0.3636,0.93,0.0,22,197,219,219,True
7388,2011-11-09,4,0,11,10,0,3,1,1,0.4,0.4091,0.76,0.1045,16,89,105,105,True
7389,2011-11-09,4,0,11,11,0,3,1,1,0.46,0.4545,0.67,0.1642,21,131,152,152,True
7390,2011-11-09,4,0,11,12,0,3,1,1,0.5,0.4848,0.51,0.1642,24,156,180,180,True
7391,2011-11-09,4,0,11,13,0,3,1,1,0.5,0.4848,0.51,0.1642,31,136,167,167,True
7392,2011-11-09,4,0,11,14,0,3,1,1,0.52,0.5,0.48,0.1642,26,153,179,179,True
7393,2011-11-09,4,0,11,15,0,3,1,1,0.52,0.5,0.45,0.2239,21,130,151,151,True
7394,2011-11-09,4,0,11,16,0,3,1,1,0.52,0.5,0.48,0.194,24,257,281,281,True
7395,2011-11-09,4,0,11,17,0,3,1,1,0.46,0.4545,0.63,0.1045,27,458,485,485,True
7396,2011-11-09,4,0,11,18,0,3,1,1,0.44,0.4394,0.67,0.1045,21,387,408,408,True
7397,2011-11-09,4,0,11,19,0,3,1,1,0.44,0.4394,0.72,0.1045,12,292,304,304,True
7398,2011-11-09,4,0,11,20,0,3,1,1,0.44,0.4394,0.77,0.0,18,201,219,219,True
7399,2011-11-09,4,0,11,21,0,3,1,1,0.4,0.4091,0.87,0.0,9,152,161,161,True
7400,2011-11-09,4,0,11,22,0,3,1,1,0.4,0.4091,0.87,0.0,9,105,114,114,True
7401,2011-11-09,4,0,11,23,0,3,1,1,0.38,0.3939,0.87,0.0,5,61,66,66,True
7402,2011-11-10,4,0,11,0,0,4,1,1,0.4,0.4091,0.87,0.0,0,24,24,24,True
7403,2011-11-10,4,0,11,1,0,4,1,2,0.4,0.4091,0.87,0.0,1,10,11,11,True
7404,2011-11-10,4,0,11,2,0,4,1,2,0.38,0.3939,0.94,0.0,0,5,5,5,True
7405,2011-11-10,4,0,11,3,0,4,1,1,0.38,0.3939,0.94,0.0896,0,11,11,11,True
7406,2011-11-10,4,0,11,4,0,4,1,1,0.38,0.3939,0.94,0.0896,1,2,3,3,True
7407,2011-11-10,4,0,11,5,0,4,1,2,0.36,0.3485,1.0,0.1343,1,22,23,23,True
7408,2011-11-10,4,0,11,6,0,4,1,2,0.36,0.3485,1.0,0.1343,4,110,114,114,True
7409,2011-11-10,4,0,11,7,0,4,1,2,0.38,0.3939,0.94,0.1642,6,266,272,272,True
7410,2011-11-10,4,0,11,8,0,4,1,2,0.4,0.4091,0.94,0.0896,18,418,436,436,True
7411,2011-11-10,4,0,11,9,0,4,1,2,0.42,0.4242,0.94,0.1045,23,188,211,211,True
7412,2011-11-10,4,0,11,10,0,4,1,2,0.44,0.4394,0.88,0.2239,17,100,117,117,True
7413,2011-11-10,4,0,11,11,0,4,1,2,0.46,0.4545,0.67,0.3881,9,99,108,108,True
7414,2011-11-10,4,0,11,12,0,4,1,2,0.42,0.4242,0.67,0.3582,18,149,167,167,True
7415,2011-11-10,4,0,11,13,0,4,1,3,0.36,0.3333,0.81,0.3582,9,87,96,96,True
7416,2011-11-10,4,0,11,14,0,4,1,3,0.36,0.3333,0.87,0.2836,6,58,64,64,True
7417,2011-11-10,4,0,11,15,0,4,1,3,0.36,0.3333,0.81,0.2985,5,57,62,62,True
7418,2011-11-10,4,0,11,16,0,4,1,3,0.36,0.3485,0.81,0.2239,6,67,73,73,True
7419,2011-11-10,4,0,11,17,0,4,1,3,0.36,0.3485,0.81,0.2239,9,168,177,177,True
7420,2011-11-10,4,0,11,18,0,4,1,2,0.36,0.3485,0.81,0.1642,10,263,273,273,True
7421,2011-11-10,4,0,11,19,0,4,1,2,0.36,0.3485,0.71,0.2239,19,192,211,211,True
7422,2011-11-10,4,0,11,20,0,4,1,2,0.36,0.3333,0.62,0.2836,8,160,168,168,True
7423,2011-11-10,4,0,11,21,0,4,1,1,0.36,0.3333,0.57,0.2537,6,130,136,136,True
7424,2011-11-10,4,0,11,22,0,4,1,1,0.36,0.3333,0.53,0.2836,5,84,89,89,True
7425,2011-11-10,4,0,11,23,0,4,1,2,0.34,0.3333,0.57,0.1642,9,73,82,82,True
7426,2011-11-11,4,0,11,0,1,5,0,1,0.34,0.3182,0.53,0.2537,10,56,66,66,True
7427,2011-11-11,4,0,11,1,1,5,0,1,0.32,0.303,0.57,0.3284,3,16,19,19,True
7428,2011-11-11,4,0,11,2,1,5,0,1,0.32,0.2879,0.57,0.2836,1,10,11,11,True
7429,2011-11-11,4,0,11,3,1,5,0,1,0.3,0.2879,0.61,0.194,0,6,6,6,True
7430,2011-11-11,4,0,11,4,1,5,0,1,0.3,0.2879,0.61,0.194,0,8,8,8,True
7431,2011-11-11,4,0,11,5,1,5,0,1,0.3,0.2879,0.49,0.2537,0,13,13,13,True
7432,2011-11-11,4,0,11,6,1,5,0,1,0.28,0.2576,0.45,0.3284,0,46,46,46,True
7433,2011-11-11,4,0,11,7,1,5,0,1,0.28,0.2727,0.45,0.2537,5,116,121,121,True
7434,2011-11-11,4,0,11,8,1,5,0,1,0.3,0.2727,0.42,0.3582,9,249,258,258,True
7435,2011-11-11,4,0,11,9,1,5,0,1,0.32,0.2879,0.45,0.4478,15,186,201,201,True
7436,2011-11-11,4,0,11,10,1,5,0,1,0.32,0.2727,0.42,0.4775,38,162,200,200,True
7437,2011-11-11,4,0,11,11,1,5,0,1,0.34,0.2879,0.42,0.4775,20,150,170,170,True
7438,2011-11-11,4,0,11,12,1,5,0,1,0.34,0.2879,0.42,0.4627,41,198,239,239,True
7439,2011-11-11,4,0,11,13,1,5,0,1,0.38,0.3939,0.37,0.4775,57,179,236,236,True
7440,2011-11-11,4,0,11,14,1,5,0,1,0.38,0.3939,0.37,0.4627,64,183,247,247,True
7441,2011-11-11,4,0,11,15,1,5,0,1,0.36,0.3333,0.37,0.4179,29,187,216,216,True
7442,2011-11-11,4,0,11,16,1,5,0,1,0.36,0.3333,0.34,0.3284,49,189,238,238,True
7443,2011-11-11,4,0,11,17,1,5,0,1,0.34,0.303,0.39,0.3284,24,286,310,310,True
7444,2011-11-11,4,0,11,18,1,5,0,1,0.34,0.3182,0.39,0.2537,23,185,208,208,True
7445,2011-11-11,4,0,11,19,1,5,0,1,0.32,0.3182,0.39,0.1642,17,182,199,199,True
7446,2011-11-11,4,0,11,20,1,5,0,1,0.32,0.3182,0.39,0.194,12,97,109,109,True
7447,2011-11-11,4,0,11,21,1,5,0,1,0.3,0.303,0.45,0.1642,4,79,83,83,True
7448,2011-11-11,4,0,11,22,1,5,0,1,0.32,0.3182,0.39,0.194,13,78,91,91,True
7449,2011-11-11,4,0,11,23,1,5,0,1,0.3,0.3182,0.45,0.0896,6,67,73,73,True
7450,2011-11-12,4,0,11,0,0,6,0,1,0.24,0.2424,0.6,0.1343,12,52,64,64,True
7451,2011-11-12,4,0,11,1,0,6,0,1,0.24,0.2424,0.6,0.1343,9,45,54,54,True
7452,2011-11-12,4,0,11,2,0,6,0,1,0.24,0.2576,0.65,0.0896,7,39,46,46,True
7453,2011-11-12,4,0,11,3,0,6,0,1,0.24,0.2424,0.7,0.1343,4,13,17,17,True
7454,2011-11-12,4,0,11,4,0,6,0,1,0.2,0.2121,0.8,0.1343,0,7,7,7,True
7455,2011-11-12,4,0,11,5,0,6,0,1,0.22,0.2576,0.75,0.0896,1,3,4,4,True
7456,2011-11-12,4,0,11,6,0,6,0,1,0.22,0.2273,0.75,0.1642,0,7,7,7,True
7457,2011-11-12,4,0,11,7,0,6,0,1,0.22,0.2273,0.75,0.194,3,24,27,27,True
7458,2011-11-12,4,0,11,8,0,6,0,1,0.26,0.2576,0.7,0.194,14,87,101,101,True
7459,2011-11-12,4,0,11,9,0,6,0,1,0.3,0.303,0.61,0.1642,18,142,160,160,True
7460,2011-11-12,4,0,11,10,0,6,0,1,0.34,0.3182,0.61,0.2836,62,170,232,232,True
7461,2011-11-12,4,0,11,11,0,6,0,1,0.38,0.3939,0.54,0.2836,102,213,315,315,True
7462,2011-11-12,4,0,11,12,0,6,0,1,0.44,0.4394,0.44,0.2836,114,224,338,338,True
7463,2011-11-12,4,0,11,13,0,6,0,1,0.48,0.4697,0.36,0.2836,114,225,339,339,True
7464,2011-11-12,4,0,11,14,0,6,0,1,0.5,0.4848,0.36,0.2985,114,244,358,358,True
7465,2011-11-12,4,0,11,15,0,6,0,1,0.52,0.5,0.29,0.2836,114,221,335,335,True
7466,2011-11-12,4,0,11,16,0,6,0,1,0.52,0.5,0.32,0.2537,114,224,338,338,True
7467,2011-11-12,4,0,11,17,0,6,0,1,0.5,0.4848,0.34,0.2537,92,193,285,285,True
7468,2011-11-12,4,0,11,18,0,6,0,1,0.42,0.4242,0.58,0.194,53,150,203,203,True
7469,2011-11-12,4,0,11,19,0,6,0,1,0.42,0.4242,0.5,0.2537,32,139,171,171,True
7470,2011-11-12,4,0,11,20,0,6,0,1,0.42,0.4242,0.5,0.2836,31,101,132,132,True
7471,2011-11-12,4,0,11,21,0,6,0,1,0.42,0.4242,0.47,0.2836,19,103,122,122,True
7472,2011-11-12,4,0,11,22,0,6,0,1,0.42,0.4242,0.47,0.2537,30,88,118,118,True
7473,2011-11-12,4,0,11,23,0,6,0,1,0.4,0.4091,0.58,0.1642,23,78,101,101,True
7474,2011-11-13,4,0,11,0,0,0,0,2,0.4,0.4091,0.58,0.194,12,61,73,73,True
7475,2011-11-13,4,0,11,1,0,0,0,2,0.36,0.3485,0.66,0.194,13,58,71,71,True
7476,2011-11-13,4,0,11,2,0,0,0,1,0.36,0.3636,0.57,0.1045,9,48,57,57,True
7477,2011-11-13,4,0,11,3,0,0,0,2,0.36,0.3485,0.62,0.1343,8,20,28,28,True
7478,2011-11-13,4,0,11,4,0,0,0,2,0.36,0.3485,0.62,0.1343,1,5,6,6,True
7479,2011-11-13,4,0,11,5,0,0,0,1,0.34,0.3333,0.61,0.1642,2,3,5,5,True
7480,2011-11-13,4,0,11,6,0,0,0,1,0.34,0.3333,0.66,0.1343,5,18,23,23,True
7481,2011-11-13,4,0,11,7,0,0,0,1,0.34,0.3182,0.66,0.2239,13,30,43,43,True
7482,2011-11-13,4,0,11,8,0,0,0,1,0.34,0.3485,0.66,0.0896,24,55,79,79,True
7483,2011-11-13,4,0,11,9,0,0,0,1,0.4,0.4091,0.54,0.2836,38,97,135,135,True
7484,2011-11-13,4,0,11,10,0,0,0,1,0.44,0.4394,0.44,0.3284,63,178,241,241,True
7485,2011-11-13,4,0,11,11,0,0,0,1,0.46,0.4545,0.4,0.4179,108,187,295,295,True
7486,2011-11-13,4,0,11,12,0,0,0,2,0.52,0.5,0.29,0.4179,112,242,354,354,True
7487,2011-11-13,4,0,11,13,0,0,0,2,0.52,0.5,0.29,0.4179,105,234,339,339,True
7488,2011-11-13,4,0,11,14,0,0,0,2,0.54,0.5152,0.28,0.4775,108,263,371,371,True
7489,2011-11-13,4,0,11,15,0,0,0,2,0.5,0.4848,0.42,0.3284,89,221,310,310,True
7490,2011-11-13,4,0,11,16,0,0,0,2,0.54,0.5152,0.28,0.3881,93,226,319,319,True
7491,2011-11-13,4,0,11,17,0,0,0,1,0.52,0.5,0.27,0.3284,44,187,231,231,True
7492,2011-11-13,4,0,11,18,0,0,0,1,0.52,0.5,0.27,0.3284,35,155,190,190,True
7493,2011-11-13,4,0,11,19,0,0,0,1,0.5,0.4848,0.29,0.3582,36,121,157,157,True
7494,2011-11-13,4,0,11,20,0,0,0,1,0.5,0.4848,0.31,0.3582,24,115,139,139,True
7495,2011-11-13,4,0,11,21,0,0,0,1,0.48,0.4697,0.36,0.2537,19,76,95,95,True
7496,2011-11-13,4,0,11,22,0,0,0,1,0.48,0.4697,0.41,0.3881,25,64,89,89,True
7497,2011-11-13,4,0,11,23,0,0,0,1,0.46,0.4545,0.51,0.2985,18,49,67,67,True
7498,2011-11-14,4,0,11,0,0,1,1,1,0.46,0.4545,0.59,0.2836,8,22,30,30,True
7499,2011-11-14,4,0,11,1,0,1,1,1,0.46,0.4545,0.63,0.2985,5,6,11,11,True
7500,2011-11-14,4,0,11,2,0,1,1,1,0.46,0.4545,0.63,0.3582,7,10,17,17,True
7501,2011-11-14,4,0,11,3,0,1,1,1,0.44,0.4394,0.67,0.2836,4,3,7,7,True
7502,2011-11-14,4,0,11,4,0,1,1,1,0.44,0.4394,0.67,0.2239,0,5,5,5,True
7503,2011-11-14,4,0,11,5,0,1,1,2,0.44,0.4394,0.67,0.2537,0,19,19,19,True
7504,2011-11-14,4,0,11,6,0,1,1,2,0.44,0.4394,0.72,0.2239,10,104,114,114,True
7505,2011-11-14,4,0,11,7,0,1,1,1,0.44,0.4394,0.72,0.2537,11,311,322,322,True
7506,2011-11-14,4,0,11,8,0,1,1,2,0.46,0.4545,0.67,0.194,27,425,452,452,True
7507,2011-11-14,4,0,11,9,0,1,1,2,0.48,0.4697,0.67,0.3284,29,204,233,233,True
7508,2011-11-14,4,0,11,10,0,1,1,2,0.5,0.4848,0.63,0.2836,26,85,111,111,True
7509,2011-11-14,4,0,11,11,0,1,1,2,0.54,0.5152,0.6,0.2836,22,106,128,128,True
7510,2011-11-14,4,0,11,12,0,1,1,1,0.56,0.5303,0.56,0.2985,36,166,202,202,True
7511,2011-11-14,4,0,11,13,0,1,1,1,0.6,0.6212,0.49,0.3881,50,153,203,203,True
7512,2011-11-14,4,0,11,14,0,1,1,1,0.62,0.6212,0.46,0.4478,47,138,185,185,True
7513,2011-11-14,4,0,11,15,0,1,1,1,0.64,0.6212,0.44,0.3284,53,142,195,195,True
7514,2011-11-14,4,0,11,16,0,1,1,1,0.62,0.6212,0.46,0.4179,51,264,315,315,True
7515,2011-11-14,4,0,11,17,0,1,1,1,0.62,0.6212,0.46,0.2537,55,464,519,519,True
7516,2011-11-14,4,0,11,18,0,1,1,1,0.56,0.5303,0.56,0.2836,29,460,489,489,True
7517,2011-11-14,4,0,11,19,0,1,1,1,0.6,0.6212,0.53,0.2985,28,274,302,302,True
7518,2011-11-14,4,0,11,20,0,1,1,1,0.6,0.6212,0.53,0.3582,30,210,240,240,True
7519,2011-11-14,4,0,11,21,0,1,1,1,0.6,0.6212,0.53,0.3582,37,176,213,213,True
7520,2011-11-14,4,0,11,22,0,1,1,1,0.58,0.5455,0.56,0.3582,17,96,113,113,True
7521,2011-11-14,4,0,11,23,0,1,1,1,0.56,0.5303,0.64,0.2985,13,48,61,61,True
7522,2011-11-15,4,0,11,0,0,2,1,1,0.56,0.5303,0.64,0.3582,7,15,22,22,True
7523,2011-11-15,4,0,11,1,0,2,1,1,0.56,0.5303,0.6,0.2985,5,5,10,10,True
7524,2011-11-15,4,0,11,2,0,2,1,1,0.56,0.5303,0.64,0.2537,7,8,15,15,True
7525,2011-11-15,4,0,11,3,0,2,1,2,0.54,0.5152,0.68,0.3284,0,4,4,4,True
7526,2011-11-15,4,0,11,4,0,2,1,1,0.56,0.5303,0.64,0.2985,1,6,7,7,True
7527,2011-11-15,4,0,11,5,0,2,1,1,0.54,0.5152,0.68,0.2836,2,26,28,28,True
7528,2011-11-15,4,0,11,6,0,2,1,2,0.56,0.5303,0.64,0.0896,4,104,108,108,True
7529,2011-11-15,4,0,11,7,0,2,1,2,0.54,0.5152,0.68,0.1642,21,298,319,319,True
7530,2011-11-15,4,0,11,8,0,2,1,2,0.54,0.5152,0.68,0.1045,27,453,480,480,True
7531,2011-11-15,4,0,11,9,0,2,1,2,0.56,0.5303,0.64,0.0896,26,174,200,200,True
7532,2011-11-15,4,0,11,10,0,2,1,2,0.56,0.5303,0.64,0.2836,23,115,138,138,True
7533,2011-11-15,4,0,11,11,0,2,1,2,0.56,0.5303,0.64,0.194,18,116,134,134,True
7534,2011-11-15,4,0,11,12,0,2,1,2,0.54,0.5152,0.68,0.0,28,148,176,176,True
7535,2011-11-15,4,0,11,13,0,2,1,3,0.54,0.5152,0.6,0.2239,21,132,153,153,True
7536,2011-11-15,4,0,11,14,0,2,1,2,0.54,0.5152,0.6,0.2836,27,120,147,147,True
7537,2011-11-15,4,0,11,15,0,2,1,2,0.54,0.5152,0.6,0.1343,36,155,191,191,True
7538,2011-11-15,4,0,11,16,0,2,1,2,0.52,0.5,0.68,0.1343,31,240,271,271,True
7539,2011-11-15,4,0,11,17,0,2,1,2,0.5,0.4848,0.72,0.194,29,422,451,451,True
7540,2011-11-15,4,0,11,18,0,2,1,2,0.5,0.4848,0.72,0.2836,27,414,441,441,True
7541,2011-11-15,4,0,11,19,0,2,1,2,0.5,0.4848,0.72,0.3582,27,259,286,286,True
7542,2011-11-15,4,0,11,20,0,2,1,2,0.48,0.4697,0.82,0.1343,26,212,238,238,True
7543,2011-11-15,4,0,11,21,0,2,1,2,0.5,0.4848,0.77,0.0896,23,145,168,168,True
7544,2011-11-15,4,0,11,22,0,2,1,2,0.46,0.4545,0.88,0.1045,19,109,128,128,True
7545,2011-11-15,4,0,11,23,0,2,1,2,0.46,0.4545,0.94,0.1045,14,66,80,80,True
7546,2011-11-16,4,0,11,0,0,3,1,2,0.46,0.4545,0.94,0.0,5,26,31,31,True
7547,2011-11-16,4,0,11,1,0,3,1,3,0.46,0.4545,0.94,0.0896,0,5,5,5,True
7548,2011-11-16,4,0,11,2,0,3,1,2,0.46,0.4545,0.94,0.1045,4,6,10,10,True
7549,2011-11-16,4,0,11,3,0,3,1,2,0.46,0.4545,0.94,0.1045,2,3,5,5,True
7550,2011-11-16,4,0,11,4,0,3,1,2,0.44,0.4394,1.0,0.2239,1,3,4,4,True
7551,2011-11-16,4,0,11,5,0,3,1,3,0.46,0.4545,0.94,0.1045,0,13,13,13,True
7552,2011-11-16,4,0,11,6,0,3,1,2,0.46,0.4545,0.94,0.0896,4,52,56,56,True
7553,2011-11-16,4,0,11,7,0,3,1,3,0.46,0.4545,0.94,0.0,7,130,137,137,True
7554,2011-11-16,4,0,11,8,0,3,1,3,0.46,0.4545,0.94,0.0,9,223,232,232,True
7555,2011-11-16,4,0,11,9,0,3,1,3,0.46,0.4545,0.94,0.0,5,77,82,82,True
7556,2011-11-16,4,0,11,10,0,3,1,3,0.46,0.4545,0.94,0.0,4,32,36,36,True
7557,2011-11-16,4,0,11,11,0,3,1,3,0.46,0.4545,0.94,0.0896,7,53,60,60,True
7558,2011-11-16,4,0,11,12,0,3,1,3,0.46,0.4545,1.0,0.0,5,49,54,54,True
7559,2011-11-16,4,0,11,13,0,3,1,3,0.46,0.4545,0.94,0.1343,6,52,58,58,True
7560,2011-11-16,4,0,11,14,0,3,1,2,0.46,0.4545,1.0,0.1343,12,49,61,61,True
7561,2011-11-16,4,0,11,15,0,3,1,3,0.48,0.4697,0.94,0.1045,16,50,66,66,True
7562,2011-11-16,4,0,11,16,0,3,1,3,0.48,0.4697,0.94,0.1045,13,110,123,123,True
7563,2011-11-16,4,0,11,17,0,3,1,2,0.48,0.4697,0.88,0.194,17,216,233,233,True
7564,2011-11-16,4,0,11,18,0,3,1,3,0.46,0.4545,0.88,0.3881,13,176,189,189,True
7565,2011-11-16,4,0,11,19,0,3,1,3,0.46,0.4545,0.88,0.3881,3,108,111,111,True
7566,2011-11-16,4,0,11,20,0,3,1,3,0.44,0.4394,0.88,0.3881,5,94,99,99,True
7567,2011-11-16,4,0,11,21,0,3,1,3,0.44,0.4394,0.88,0.2836,3,72,75,75,True
7568,2011-11-16,4,0,11,22,0,3,1,3,0.42,0.4242,0.88,0.2239,1,45,46,46,True
7569,2011-11-16,4,0,11,23,0,3,1,3,0.42,0.4242,0.88,0.1343,3,28,31,31,True
7570,2011-11-17,4,0,11,0,0,4,1,2,0.42,0.4242,0.88,0.2537,2,22,24,24,True
7571,2011-11-17,4,0,11,1,0,4,1,2,0.42,0.4242,0.82,0.1642,0,5,5,5,True
7572,2011-11-17,4,0,11,2,0,4,1,2,0.42,0.4242,0.82,0.2239,0,5,5,5,True
7573,2011-11-17,4,0,11,3,0,4,1,2,0.42,0.4242,0.77,0.3284,0,3,3,3,True
7574,2011-11-17,4,0,11,4,0,4,1,2,0.4,0.4091,0.62,0.4179,1,3,4,4,True
7575,2011-11-17,4,0,11,5,0,4,1,3,0.34,0.303,0.71,0.3284,1,21,22,22,True
7576,2011-11-17,4,0,11,6,0,4,1,3,0.36,0.3485,0.57,0.2239,3,72,75,75,True
7577,2011-11-17,4,0,11,7,0,4,1,3,0.34,0.3182,0.61,0.2836,4,164,168,168,True
7578,2011-11-17,4,0,11,8,0,4,1,3,0.34,0.303,0.61,0.2985,12,343,355,355,True
7579,2011-11-17,4,0,11,9,0,4,1,2,0.34,0.303,0.61,0.3284,14,184,198,198,True
7580,2011-11-17,4,0,11,10,0,4,1,2,0.34,0.303,0.61,0.3284,7,74,81,81,True
7581,2011-11-17,4,0,11,11,0,4,1,3,0.32,0.303,0.66,0.3284,4,93,97,97,True
7582,2011-11-17,4,0,11,12,0,4,1,2,0.34,0.303,0.53,0.2985,6,115,121,121,True
7583,2011-11-17,4,0,11,13,0,4,1,2,0.34,0.303,0.49,0.4478,15,109,124,124,True
7584,2011-11-17,4,0,11,14,0,4,1,2,0.34,0.303,0.49,0.3881,5,105,110,110,True
7585,2011-11-17,4,0,11,15,0,4,1,2,0.34,0.303,0.49,0.4478,10,106,116,116,True
7586,2011-11-17,4,0,11,16,0,4,1,1,0.32,0.2879,0.39,0.4179,8,187,195,195,True
7587,2011-11-17,4,0,11,17,0,4,1,1,0.32,0.2879,0.42,0.3881,20,379,399,399,True
7588,2011-11-17,4,0,11,18,0,4,1,1,0.32,0.3182,0.39,0.194,9,298,307,307,True
7589,2011-11-17,4,0,11,19,0,4,1,1,0.3,0.2879,0.45,0.2239,7,210,217,217,True
7590,2011-11-17,4,0,11,20,0,4,1,1,0.3,0.2879,0.42,0.2836,7,162,169,169,True
7591,2011-11-17,4,0,11,21,0,4,1,1,0.3,0.2879,0.42,0.2537,3,113,116,116,True
7592,2011-11-17,4,0,11,22,0,4,1,1,0.26,0.2424,0.52,0.2537,1,83,84,84,True
7593,2011-11-17,4,0,11,23,0,4,1,1,0.26,0.2576,0.52,0.2239,0,58,58,58,True
7594,2011-11-18,4,0,11,0,0,5,1,1,0.26,0.2576,0.48,0.1642,2,28,30,30,True
7595,2011-11-18,4,0,11,1,0,5,1,1,0.26,0.2273,0.44,0.3284,0,10,10,10,True
7596,2011-11-18,4,0,11,2,0,5,1,1,0.24,0.2273,0.44,0.2239,2,8,10,10,True
7597,2011-11-18,4,0,11,3,0,5,1,1,0.24,0.2121,0.41,0.2836,0,2,2,2,True
7598,2011-11-18,4,0,11,4,0,5,1,1,0.22,0.2273,0.44,0.1642,0,5,5,5,True
7599,2011-11-18,4,0,11,5,0,5,1,1,0.22,0.2273,0.44,0.1343,0,22,22,22,True
7600,2011-11-18,4,0,11,6,0,5,1,1,0.22,0.2576,0.44,0.0896,1,70,71,71,True
7601,2011-11-18,4,0,11,7,0,5,1,1,0.22,0.2273,0.44,0.1642,5,211,216,216,True
7602,2011-11-18,4,0,11,8,0,5,1,1,0.22,0.2273,0.44,0.194,6,369,375,375,True
7603,2011-11-18,4,0,11,9,0,5,1,1,0.26,0.2576,0.41,0.194,6,207,213,213,True
7604,2011-11-18,4,0,11,10,0,5,1,1,0.26,0.2424,0.41,0.2836,10,105,115,115,True
7605,2011-11-18,4,0,11,11,0,5,1,1,0.3,0.303,0.36,0.1343,18,122,140,140,True
7606,2011-11-18,4,0,11,12,0,5,1,1,0.32,0.3333,0.33,0.0,22,143,165,165,True
7607,2011-11-18,4,0,11,13,0,5,1,1,0.34,0.3182,0.31,0.2239,31,146,177,177,True
7608,2011-11-18,4,0,11,14,0,5,1,1,0.34,0.3333,0.31,0.1343,31,123,154,154,True
7609,2011-11-18,4,0,11,15,0,5,1,1,0.34,0.3333,0.29,0.1343,27,151,178,178,True
7610,2011-11-18,4,0,11,16,0,5,1,1,0.34,0.3333,0.29,0.1343,19,190,209,209,True
7611,2011-11-18,4,0,11,17,0,5,1,1,0.32,0.3333,0.31,0.1343,17,361,378,378,True
7612,2011-11-18,4,0,11,18,0,5,1,1,0.3,0.303,0.36,0.1642,16,312,328,328,True
7613,2011-11-18,4,0,11,19,0,5,1,1,0.28,0.2727,0.41,0.1642,7,183,190,190,True
7614,2011-11-18,4,0,11,20,0,5,1,1,0.28,0.2727,0.48,0.194,8,129,137,137,True
7615,2011-11-18,4,0,11,21,0,5,1,1,0.28,0.2727,0.48,0.1642,3,108,111,111,True
7616,2011-11-18,4,0,11,22,0,5,1,1,0.26,0.2727,0.52,0.1045,9,88,97,97,True
7617,2011-11-18,4,0,11,23,0,5,1,1,0.26,0.2727,0.6,0.1343,5,54,59,59,True
7618,2011-11-19,4,0,11,0,0,6,0,1,0.26,0.2576,0.56,0.194,4,49,53,53,True
7619,2011-11-19,4,0,11,1,0,6,0,1,0.26,0.2273,0.52,0.2985,1,34,35,35,True
7620,2011-11-19,4,0,11,2,0,6,0,1,0.24,0.2424,0.56,0.1642,12,34,46,46,True
7621,2011-11-19,4,0,11,3,0,6,0,1,0.26,0.2424,0.48,0.2537,4,11,15,15,True
7622,2011-11-19,4,0,11,4,0,6,0,1,0.26,0.2273,0.48,0.3284,4,4,8,8,True
7623,2011-11-19,4,0,11,5,0,6,0,1,0.24,0.2273,0.56,0.2537,0,2,2,2,True
7624,2011-11-19,4,0,11,6,0,6,0,1,0.24,0.2121,0.6,0.3284,2,10,12,12,True
7625,2011-11-19,4,0,11,7,0,6,0,1,0.24,0.2273,0.6,0.2537,3,38,41,41,True
7626,2011-11-19,4,0,11,8,0,6,0,1,0.26,0.2424,0.56,0.2537,12,80,92,92,True
7627,2011-11-19,4,0,11,9,0,6,0,1,0.28,0.2576,0.52,0.2985,12,130,142,142,True
7628,2011-11-19,4,0,11,10,0,6,0,1,0.32,0.303,0.45,0.2537,35,165,200,200,True
7629,2011-11-19,4,0,11,11,0,6,0,1,0.36,0.3788,0.4,0.0,50,183,233,233,True
7630,2011-11-19,4,0,11,12,0,6,0,1,0.4,0.4091,0.35,0.2836,93,218,311,311,True
7631,2011-11-19,4,0,11,13,0,6,0,1,0.42,0.4242,0.3,0.2836,114,245,359,359,True
7632,2011-11-19,4,0,11,14,0,6,0,1,0.42,0.4242,0.32,0.2985,114,228,342,342,True
7633,2011-11-19,4,0,11,15,0,6,0,1,0.42,0.4242,0.41,0.194,114,262,376,376,True
7634,2011-11-19,4,0,11,16,0,6,0,1,0.42,0.4242,0.38,0.2985,99,188,287,287,True
7635,2011-11-19,4,0,11,17,0,6,0,1,0.4,0.4091,0.4,0.194,61,171,232,232,True
7636,2011-11-19,4,0,11,18,0,6,0,1,0.38,0.3939,0.46,0.1343,36,172,208,208,True
7637,2011-11-19,4,0,11,19,0,6,0,2,0.34,0.3333,0.71,0.1343,33,149,182,182,True
7638,2011-11-19,4,0,11,20,0,6,0,2,0.36,0.3636,0.57,0.1045,48,115,163,163,True
7639,2011-11-19,4,0,11,21,0,6,0,2,0.36,0.3485,0.62,0.194,29,79,108,108,True
7640,2011-11-19,4,0,11,22,0,6,0,2,0.38,0.3939,0.62,0.1642,26,80,106,106,True
7641,2011-11-19,4,0,11,23,0,6,0,1,0.38,0.3939,0.62,0.2239,20,73,93,93,True
7642,2011-11-20,4,0,11,0,0,0,0,1,0.38,0.3939,0.66,0.1642,14,79,93,93,True
7643,2011-11-20,4,0,11,1,0,0,0,1,0.4,0.4091,0.62,0.2537,11,73,84,84,True
7644,2011-11-20,4,0,11,2,0,0,0,1,0.4,0.4091,0.62,0.2836,12,44,56,56,True
7645,2011-11-20,4,0,11,3,0,0,0,2,0.4,0.4091,0.66,0.2836,6,31,37,37,True
7646,2011-11-20,4,0,11,4,0,0,0,2,0.4,0.4091,0.71,0.2836,2,10,12,12,True
7647,2011-11-20,4,0,11,5,0,0,0,2,0.42,0.4242,0.67,0.2836,0,4,4,4,True
7648,2011-11-20,4,0,11,6,0,0,0,2,0.42,0.4242,0.67,0.2537,3,6,9,9,True
7649,2011-11-20,4,0,11,7,0,0,0,1,0.42,0.4242,0.67,0.2239,4,19,23,23,True
7650,2011-11-20,4,0,11,8,0,0,0,2,0.42,0.4242,0.71,0.2836,13,52,65,65,True
7651,2011-11-20,4,0,11,9,0,0,0,1,0.44,0.4394,0.72,0.1642,29,109,138,138,True
7652,2011-11-20,4,0,11,10,0,0,0,2,0.44,0.4394,0.72,0.1045,46,183,229,229,True
7653,2011-11-20,4,0,11,11,0,0,0,2,0.5,0.4848,0.63,0.1045,74,212,286,286,True
7654,2011-11-20,4,0,11,12,0,0,0,2,0.5,0.4848,0.63,0.1343,70,234,304,304,True
7655,2011-11-20,4,0,11,13,0,0,0,2,0.54,0.5152,0.6,0.194,84,285,369,369,True
7656,2011-11-20,4,0,11,14,0,0,0,1,0.52,0.5,0.63,0.2537,113,250,363,363,True
7657,2011-11-20,4,0,11,15,0,0,0,2,0.52,0.5,0.68,0.194,109,242,351,351,True
7658,2011-11-20,4,0,11,16,0,0,0,2,0.52,0.5,0.63,0.1343,81,225,306,306,True
7659,2011-11-20,4,0,11,17,0,0,0,2,0.52,0.5,0.63,0.194,35,168,203,203,True
7660,2011-11-20,4,0,11,18,0,0,0,2,0.54,0.5152,0.64,0.194,22,123,145,145,True
7661,2011-11-20,4,0,11,19,0,0,0,2,0.5,0.4848,0.72,0.1045,17,140,157,157,True
7662,2011-11-20,4,0,11,20,0,0,0,2,0.52,0.5,0.68,0.1045,23,90,113,113,True
7663,2011-11-20,4,0,11,21,0,0,0,2,0.48,0.4697,0.77,0.0896,11,94,105,105,True
7664,2011-11-20,4,0,11,22,0,0,0,3,0.46,0.4545,0.88,0.0896,5,35,40,40,True
7665,2011-11-20,4,0,11,23,0,0,0,3,0.46,0.4545,0.88,0.0896,3,25,28,28,True
7666,2011-11-21,4,0,11,0,0,1,1,2,0.46,0.4545,0.94,0.0,4,13,17,17,True
7667,2011-11-21,4,0,11,1,0,1,1,3,0.46,0.4545,0.94,0.194,4,8,12,12,True
7668,2011-11-21,4,0,11,2,0,1,1,3,0.44,0.4394,1.0,0.194,1,2,3,3,True
7669,2011-11-21,4,0,11,3,0,1,1,3,0.44,0.4394,1.0,0.1343,0,4,4,4,True
7670,2011-11-21,4,0,11,4,0,1,1,3,0.44,0.4394,1.0,0.1343,0,5,5,5,True
7671,2011-11-21,4,0,11,5,0,1,1,2,0.44,0.4394,1.0,0.0,0,20,20,20,True
7672,2011-11-21,4,0,11,6,0,1,1,2,0.42,0.4242,1.0,0.0,0,76,76,76,True
7673,2011-11-21,4,0,11,7,0,1,1,2,0.46,0.4545,0.94,0.1642,17,229,246,246,True
7674,2011-11-21,4,0,11,8,0,1,1,2,0.46,0.4545,0.94,0.0,13,378,391,391,True
7675,2011-11-21,4,0,11,9,0,1,1,2,0.48,0.4697,0.94,0.1045,15,222,237,237,True
7676,2011-11-21,4,0,11,10,0,1,1,2,0.52,0.5,0.83,0.0,25,110,135,135,True
7677,2011-11-21,4,0,11,11,0,1,1,2,0.52,0.5,0.83,0.1045,16,112,128,128,True
7678,2011-11-21,4,0,11,12,0,1,1,2,0.5,0.4848,0.77,0.1343,24,138,162,162,True
7679,2011-11-21,4,0,11,13,0,1,1,2,0.5,0.4848,0.77,0.1343,13,121,134,134,True
7680,2011-11-21,4,0,11,14,0,1,1,2,0.48,0.4697,0.82,0.194,14,121,135,135,True
7681,2011-11-21,4,0,11,15,0,1,1,3,0.44,0.4394,0.94,0.2239,15,93,108,108,True
7682,2011-11-21,4,0,11,16,0,1,1,3,0.44,0.4394,0.94,0.2239,13,95,108,108,True
7683,2011-11-21,4,0,11,17,0,1,1,3,0.42,0.4242,0.94,0.2985,10,200,210,210,True
7684,2011-11-21,4,0,11,18,0,1,1,3,0.42,0.4242,0.88,0.194,8,184,192,192,True
7685,2011-11-21,4,0,11,19,0,1,1,3,0.4,0.4091,0.94,0.194,2,135,137,137,True
7686,2011-11-21,4,0,11,20,0,1,1,3,0.4,0.4091,0.87,0.2239,5,75,80,80,True
7687,2011-11-21,4,0,11,21,0,1,1,3,0.4,0.4091,0.87,0.1642,11,103,114,114,True
7688,2011-11-21,4,0,11,22,0,1,1,3,0.4,0.4091,0.87,0.1343,6,72,78,78,True
7689,2011-11-21,4,0,11,23,0,1,1,3,0.4,0.4091,0.87,0.1642,4,29,33,33,True
7690,2011-11-22,4,0,11,0,0,2,1,3,0.38,0.3939,0.94,0.1045,0,14,14,14,True
7691,2011-11-22,4,0,11,1,0,2,1,3,0.4,0.4091,0.94,0.1343,1,5,6,6,True
7692,2011-11-22,4,0,11,2,0,2,1,3,0.38,0.3939,1.0,0.1045,2,4,6,6,True
7693,2011-11-22,4,0,11,3,0,2,1,3,0.38,0.3939,1.0,0.1045,1,2,3,3,True
7694,2011-11-22,4,0,11,4,0,2,1,3,0.38,0.3939,0.94,0.1642,0,7,7,7,True
7695,2011-11-22,4,0,11,5,0,2,1,3,0.38,0.3939,0.94,0.1642,1,17,18,18,True
7696,2011-11-22,4,0,11,6,0,2,1,2,0.38,0.3939,0.94,0.1045,1,63,64,64,True
7697,2011-11-22,4,0,11,7,0,2,1,3,0.38,0.3939,0.94,0.2239,2,119,121,121,True
7698,2011-11-22,4,0,11,8,0,2,1,3,0.38,0.3939,0.94,0.2239,5,185,190,190,True
7699,2011-11-22,4,0,11,9,0,2,1,3,0.4,0.4091,0.94,0.0,2,147,149,149,True
7700,2011-11-22,4,0,11,10,0,2,1,3,0.4,0.4091,0.94,0.0,6,46,52,52,True
7701,2011-11-22,4,0,11,11,0,2,1,3,0.4,0.4091,0.94,0.1343,4,28,32,32,True
7702,2011-11-22,4,0,11,12,0,2,1,3,0.4,0.4091,1.0,0.0896,3,18,21,21,True
7703,2011-11-22,4,0,11,13,0,2,1,3,0.42,0.4242,1.0,0.0896,4,22,26,26,True
7704,2011-11-22,4,0,11,14,0,2,1,3,0.42,0.4242,1.0,0.0896,4,31,35,35,True
7705,2011-11-22,4,0,11,15,0,2,1,3,0.44,0.4394,0.94,0.0,2,32,34,34,True
7706,2011-11-22,4,0,11,16,0,2,1,3,0.44,0.4394,0.94,0.0,3,59,62,62,True
7707,2011-11-22,4,0,11,17,0,2,1,3,0.44,0.4394,1.0,0.0896,4,161,165,165,True
7708,2011-11-22,4,0,11,18,0,2,1,3,0.44,0.4394,1.0,0.0,0,148,148,148,True
7709,2011-11-22,4,0,11,19,0,2,1,3,0.46,0.4545,0.94,0.1045,5,106,111,111,True
7710,2011-11-22,4,0,11,20,0,2,1,2,0.46,0.4545,1.0,0.2239,6,121,127,127,True
7711,2011-11-22,4,0,11,21,0,2,1,2,0.46,0.4545,1.0,0.2537,4,86,90,90,True
7712,2011-11-22,4,0,11,22,0,2,1,2,0.5,0.4848,0.94,0.194,6,81,87,87,True
7713,2011-11-22,4,0,11,23,0,2,1,2,0.48,0.4697,0.94,0.2537,3,36,39,39,True
7714,2011-11-23,4,0,11,0,0,3,1,2,0.48,0.4697,0.94,0.2537,2,14,16,16,True
7715,2011-11-23,4,0,11,1,0,3,1,2,0.48,0.4697,0.94,0.2985,0,8,8,8,True
7716,2011-11-23,4,0,11,2,0,3,1,3,0.5,0.4848,0.94,0.3582,1,5,6,6,True
7717,2011-11-23,4,0,11,3,0,3,1,3,0.5,0.4848,0.94,0.3582,1,2,3,3,True
7718,2011-11-23,4,0,11,4,0,3,1,3,0.52,0.5,0.88,0.3582,0,5,5,5,True
7719,2011-11-23,4,0,11,5,0,3,1,2,0.46,0.4545,0.94,0.194,1,16,17,17,True
7720,2011-11-23,4,0,11,6,0,3,1,2,0.44,0.4394,1.0,0.0,1,68,69,69,True
7721,2011-11-23,4,0,11,7,0,3,1,2,0.46,0.4545,1.0,0.0896,2,154,156,156,True
7722,2011-11-23,4,0,11,8,0,3,1,2,0.48,0.4697,0.94,0.1045,7,316,323,323,True
7723,2011-11-23,4,0,11,9,0,3,1,2,0.52,0.5,0.94,0.194,3,164,167,167,True
7724,2011-11-23,4,0,11,10,0,3,1,2,0.52,0.5,0.94,0.194,6,70,76,76,True
7725,2011-11-23,4,0,11,11,0,3,1,2,0.5,0.4848,0.72,0.4179,9,107,116,116,True
7726,2011-11-23,4,0,11,12,0,3,1,1,0.48,0.4697,0.55,0.4179,9,151,160,160,True
7727,2011-11-23,4,0,11,13,0,3,1,2,0.44,0.4394,0.54,0.4775,12,162,174,174,True
7728,2011-11-23,4,0,11,14,0,3,1,1,0.42,0.4242,0.54,0.4627,13,200,213,213,True
7729,2011-11-23,4,0,11,15,0,3,1,2,0.42,0.4242,0.54,0.4478,13,194,207,207,True
7730,2011-11-23,4,0,11,16,0,3,1,2,0.4,0.4091,0.62,0.4627,4,169,173,173,True
7731,2011-11-23,4,0,11,17,0,3,1,3,0.38,0.3939,0.71,0.3881,7,156,163,163,True
7732,2011-11-23,4,0,11,18,0,3,1,2,0.4,0.4091,0.58,0.4775,7,138,145,145,True
7733,2011-11-23,4,0,11,19,0,3,1,1,0.38,0.3939,0.58,0.3881,6,116,122,122,True
7734,2011-11-23,4,0,11,20,0,3,1,1,0.36,0.3333,0.62,0.3881,1,67,68,68,True
7735,2011-11-23,4,0,11,21,0,3,1,1,0.36,0.3182,0.57,0.4627,0,66,66,66,True
7736,2011-11-23,4,0,11,22,0,3,1,1,0.34,0.303,0.61,0.4478,3,59,62,62,True
7737,2011-11-23,4,0,11,23,0,3,1,1,0.34,0.303,0.61,0.3582,4,47,51,51,True
7738,2011-11-24,4,0,11,0,1,4,0,1,0.32,0.303,0.57,0.2239,1,22,23,23,True
7739,2011-11-24,4,0,11,1,1,4,0,1,0.32,0.2879,0.57,0.4179,1,23,24,24,True
7740,2011-11-24,4,0,11,2,1,4,0,1,0.3,0.2879,0.61,0.2836,3,19,22,22,True
7741,2011-11-24,4,0,11,3,1,4,0,1,0.28,0.2879,0.65,0.1343,1,4,5,5,True
7742,2011-11-24,4,0,11,4,1,4,0,1,0.3,0.3182,0.61,0.0896,1,1,2,2,True
7743,2011-11-24,4,0,11,5,1,4,0,1,0.3,0.3182,0.61,0.1045,1,10,11,11,True
7744,2011-11-24,4,0,11,6,1,4,0,1,0.3,0.3182,0.61,0.0896,1,5,6,6,True
7745,2011-11-24,4,0,11,7,1,4,0,1,0.26,0.2727,0.75,0.1045,9,31,40,40,True
7746,2011-11-24,4,0,11,8,1,4,0,1,0.3,0.3182,0.65,0.0896,4,42,46,46,True
7747,2011-11-24,4,0,11,9,1,4,0,1,0.34,0.3485,0.61,0.0,13,68,81,81,True
7748,2011-11-24,4,0,11,10,1,4,0,1,0.36,0.3788,0.57,0.0,34,64,98,98,True
7749,2011-11-24,4,0,11,11,1,4,0,1,0.42,0.4242,0.41,0.2985,52,90,142,142,True
7750,2011-11-24,4,0,11,12,1,4,0,1,0.46,0.4545,0.36,0.2239,62,88,150,150,True
7751,2011-11-24,4,0,11,13,1,4,0,1,0.48,0.4697,0.33,0.2239,84,91,175,175,True
7752,2011-11-24,4,0,11,14,1,4,0,1,0.5,0.4848,0.31,0.2985,74,94,168,168,True
7753,2011-11-24,4,0,11,15,1,4,0,1,0.5,0.4848,0.31,0.2537,78,71,149,149,True
7754,2011-11-24,4,0,11,16,1,4,0,1,0.5,0.4848,0.34,0.2836,48,66,114,114,True
7755,2011-11-24,4,0,11,17,1,4,0,1,0.48,0.4697,0.33,0.1045,34,40,74,74,True
7756,2011-11-24,4,0,11,18,1,4,0,1,0.42,0.4242,0.5,0.0896,13,24,37,37,True
7757,2011-11-24,4,0,11,19,1,4,0,1,0.4,0.4091,0.54,0.1045,15,13,28,28,True
7758,2011-11-24,4,0,11,20,1,4,0,1,0.36,0.3485,0.76,0.1642,14,17,31,31,True
7759,2011-11-24,4,0,11,21,1,4,0,1,0.36,0.3485,0.71,0.1642,7,19,26,26,True
7760,2011-11-24,4,0,11,22,1,4,0,1,0.36,0.3485,0.71,0.1642,8,14,22,22,True
7761,2011-11-24,4,0,11,23,1,4,0,1,0.34,0.3485,0.76,0.1045,2,19,21,21,True
7762,2011-11-25,4,0,11,0,0,5,1,1,0.34,0.3333,0.76,0.1642,7,22,29,29,True
7763,2011-11-25,4,0,11,1,0,5,1,1,0.34,0.3636,0.76,0.0,2,12,14,14,True
7764,2011-11-25,4,0,11,2,0,5,1,1,0.28,0.2879,0.81,0.1045,4,6,10,10,True
7765,2011-11-25,4,0,11,3,0,5,1,1,0.28,0.2879,0.75,0.1045,0,2,2,2,True
7766,2011-11-25,4,0,11,4,0,5,1,1,0.3,0.3182,0.75,0.1045,4,3,7,7,True
7767,2011-11-25,4,0,11,5,0,5,1,1,0.28,0.3182,0.75,0.0,2,3,5,5,True
7768,2011-11-25,4,0,11,6,0,5,1,1,0.26,0.2727,0.81,0.1045,4,9,13,13,True
7769,2011-11-25,4,0,11,7,0,5,1,1,0.26,0.303,0.81,0.0,4,31,35,35,True
7770,2011-11-25,4,0,11,8,0,5,1,1,0.26,0.2727,0.81,0.1343,6,68,74,74,True
7771,2011-11-25,4,0,11,9,0,5,1,1,0.32,0.3485,0.76,0.0,25,70,95,95,True
7772,2011-11-25,4,0,11,10,0,5,1,1,0.36,0.3485,0.71,0.1642,60,82,142,142,True
7773,2011-11-25,4,0,11,11,0,5,1,1,0.4,0.4091,0.66,0.1045,99,127,226,226,True
7774,2011-11-25,4,0,11,12,0,5,1,1,0.46,0.4545,0.51,0.1045,114,146,260,260,True
7775,2011-11-25,4,0,11,13,0,5,1,1,0.5,0.4848,0.45,0.2239,114,140,254,254,True
7776,2011-11-25,4,0,11,14,0,5,1,1,0.52,0.5,0.39,0.2239,114,150,264,264,True
7777,2011-11-25,4,0,11,15,0,5,1,1,0.52,0.5,0.36,0.194,114,145,259,259,True
7778,2011-11-25,4,0,11,16,0,5,1,1,0.5,0.4848,0.39,0.1642,114,139,253,253,True
7779,2011-11-25,4,0,11,17,0,5,1,1,0.5,0.4848,0.34,0.1045,57,127,184,184,True
7780,2011-11-25,4,0,11,18,0,5,1,1,0.46,0.4545,0.44,0.0896,45,108,153,153,True
7781,2011-11-25,4,0,11,19,0,5,1,1,0.42,0.4242,0.67,0.0,38,96,134,134,True
7782,2011-11-25,4,0,11,20,0,5,1,1,0.4,0.4091,0.58,0.0896,19,76,95,95,True
7783,2011-11-25,4,0,11,21,0,5,1,1,0.36,0.3788,0.71,0.0,24,61,85,85,True
7784,2011-11-25,4,0,11,22,0,5,1,1,0.34,0.3485,0.71,0.0896,12,46,58,58,True
7785,2011-11-25,4,0,11,23,0,5,1,1,0.34,0.3485,0.76,0.1045,5,28,33,33,True
7786,2011-11-26,4,0,11,0,0,6,0,1,0.34,0.3485,0.76,0.1045,9,38,47,47,True
7787,2011-11-26,4,0,11,1,0,6,0,1,0.32,0.3333,0.76,0.0896,5,24,29,29,True
7788,2011-11-26,4,0,11,2,0,6,0,1,0.3,0.3182,0.81,0.1045,3,20,23,23,True
7789,2011-11-26,4,0,11,3,0,6,0,1,0.3,0.3333,0.81,0.0,8,9,17,17,True
7790,2011-11-26,4,0,11,4,0,6,0,1,0.3,0.3333,0.81,0.0,0,4,4,4,True
7791,2011-11-26,4,0,11,5,0,6,0,1,0.3,0.3182,0.75,0.1045,0,3,3,3,True
7792,2011-11-26,4,0,11,6,0,6,0,2,0.3,0.3182,0.75,0.0896,2,8,10,10,True
7793,2011-11-26,4,0,11,7,0,6,0,1,0.26,0.2727,0.87,0.1045,4,13,17,17,True
7794,2011-11-26,4,0,11,8,0,6,0,1,0.32,0.3333,0.76,0.0896,10,50,60,60,True
7795,2011-11-26,4,0,11,9,0,6,0,1,0.34,0.3485,0.76,0.0896,16,67,83,83,True
7796,2011-11-26,4,0,11,10,0,6,0,1,0.36,0.3788,0.81,0.0,57,84,141,141,True
7797,2011-11-26,4,0,11,11,0,6,0,1,0.4,0.4091,0.62,0.1045,107,123,230,230,True
7798,2011-11-26,4,0,11,12,0,6,0,1,0.44,0.4394,0.51,0.0,114,172,286,286,True
7799,2011-11-26,4,0,11,13,0,6,0,1,0.48,0.4697,0.44,0.0,114,148,262,262,True
7800,2011-11-26,4,0,11,14,0,6,0,2,0.48,0.4697,0.48,0.1343,114,158,272,272,True
7801,2011-11-26,4,0,11,15,0,6,0,2,0.5,0.4848,0.42,0.1045,114,160,274,274,True
7802,2011-11-26,4,0,11,16,0,6,0,2,0.46,0.4545,0.47,0.1343,114,138,252,252,True
7803,2011-11-26,4,0,11,17,0,6,0,2,0.46,0.4545,0.47,0.1343,62,122,184,184,True
7804,2011-11-26,4,0,11,18,0,6,0,2,0.42,0.4242,0.62,0.1642,67,118,185,185,True
7805,2011-11-26,4,0,11,19,0,6,0,2,0.4,0.4091,0.71,0.0896,46,100,146,146,True
7806,2011-11-26,4,0,11,20,0,6,0,2,0.42,0.4242,0.58,0.0,55,86,141,141,True
7807,2011-11-26,4,0,11,21,0,6,0,2,0.38,0.3939,0.82,0.0,20,72,92,92,True
7808,2011-11-26,4,0,11,22,0,6,0,2,0.38,0.3939,0.76,0.0,14,51,65,65,True
7809,2011-11-26,4,0,11,23,0,6,0,1,0.36,0.3788,0.81,0.0,18,51,69,69,True
7810,2011-11-27,4,0,11,0,0,0,0,1,0.36,0.3788,0.81,0.0,7,39,46,46,True
7811,2011-11-27,4,0,11,1,0,0,0,1,0.36,0.3788,0.81,0.0,9,35,44,44,True
7812,2011-11-27,4,0,11,2,0,0,0,1,0.34,0.3636,0.81,0.0,9,22,31,31,True
7813,2011-11-27,4,0,11,3,0,0,0,1,0.34,0.3636,0.87,0.0,9,8,17,17,True
7814,2011-11-27,4,0,11,4,0,0,0,1,0.34,0.3485,0.87,0.1045,0,4,4,4,True
7815,2011-11-27,4,0,11,5,0,0,0,1,0.36,0.3485,0.87,0.194,0,5,5,5,True
7816,2011-11-27,4,0,11,6,0,0,0,1,0.38,0.3939,0.82,0.1642,0,9,9,9,True
7817,2011-11-27,4,0,11,7,0,0,0,1,0.38,0.3939,0.87,0.2239,12,11,23,23,True
7818,2011-11-27,4,0,11,8,0,0,0,1,0.4,0.4091,0.82,0.2985,6,36,42,42,True
7819,2011-11-27,4,0,11,9,0,0,0,1,0.46,0.4545,0.72,0.2836,21,90,111,111,True
7820,2011-11-27,4,0,11,10,0,0,0,1,0.46,0.4545,0.72,0.2836,58,131,189,189,True
7821,2011-11-27,4,0,11,11,0,0,0,1,0.5,0.4848,0.63,0.3582,83,157,240,240,True
7822,2011-11-27,4,0,11,12,0,0,0,1,0.54,0.5152,0.56,0.2836,63,193,256,256,True
7823,2011-11-27,4,0,11,13,0,0,0,1,0.54,0.5152,0.6,0.194,97,216,313,313,True
7824,2011-11-27,4,0,11,14,0,0,0,1,0.62,0.6212,0.43,0.4627,113,200,313,313,True
7825,2011-11-27,4,0,11,15,0,0,0,1,0.62,0.6212,0.43,0.2836,96,221,317,317,True
7826,2011-11-27,4,0,11,16,0,0,0,1,0.56,0.5303,0.52,0.2537,94,229,323,323,True
7827,2011-11-27,4,0,11,17,0,0,0,1,0.54,0.5152,0.56,0.194,37,167,204,204,True
7828,2011-11-27,4,0,11,18,0,0,0,1,0.5,0.4848,0.63,0.1642,25,130,155,155,True
7829,2011-11-27,4,0,11,19,0,0,0,1,0.48,0.4697,0.67,0.2239,30,109,139,139,True
7830,2011-11-27,4,0,11,20,0,0,0,1,0.5,0.4848,0.63,0.2537,10,94,104,104,True
7831,2011-11-27,4,0,11,21,0,0,0,1,0.48,0.4697,0.67,0.2836,13,75,88,88,True
7832,2011-11-27,4,0,11,22,0,0,0,1,0.48,0.4697,0.72,0.2537,13,53,66,66,True
7833,2011-11-27,4,0,11,23,0,0,0,1,0.48,0.4697,0.72,0.2537,5,27,32,32,True
7834,2011-11-28,4,0,11,0,0,1,1,1,0.46,0.4545,0.77,0.2836,6,10,16,16,True
7835,2011-11-28,4,0,11,1,0,1,1,1,0.46,0.4545,0.77,0.2985,1,12,13,13,True
7836,2011-11-28,4,0,11,3,0,1,1,1,0.44,0.4394,0.88,0.2239,1,4,5,5,True
7837,2011-11-28,4,0,11,4,0,1,1,1,0.44,0.4394,0.82,0.0896,0,4,4,4,True
7838,2011-11-28,4,0,11,5,0,1,1,1,0.4,0.4091,0.87,0.0,0,34,34,34,True
7839,2011-11-28,4,0,11,6,0,1,1,1,0.42,0.4242,0.82,0.0896,6,98,104,104,True
7840,2011-11-28,4,0,11,7,0,1,1,1,0.42,0.4242,0.88,0.0,7,270,277,277,True
7841,2011-11-28,4,0,11,8,0,1,1,2,0.42,0.4242,0.94,0.0,13,394,407,407,True
7842,2011-11-28,4,0,11,9,0,1,1,2,0.44,0.4394,0.88,0.2239,17,191,208,208,True
7843,2011-11-28,4,0,11,10,0,1,1,2,0.48,0.4697,0.77,0.1343,21,86,107,107,True
7844,2011-11-28,4,0,11,11,0,1,1,2,0.52,0.5,0.68,0.1045,11,107,118,118,True
7845,2011-11-28,4,0,11,12,0,1,1,1,0.56,0.5303,0.6,0.1045,13,165,178,178,True
7846,2011-11-28,4,0,11,13,0,1,1,2,0.58,0.5455,0.56,0.0,25,137,162,162,True
7847,2011-11-28,4,0,11,14,0,1,1,1,0.6,0.6212,0.56,0.0,14,129,143,143,True
7848,2011-11-28,4,0,11,15,0,1,1,1,0.58,0.5455,0.6,0.1642,18,132,150,150,True
7849,2011-11-28,4,0,11,16,0,1,1,1,0.56,0.5303,0.6,0.194,24,240,264,264,True
7850,2011-11-28,4,0,11,17,0,1,1,1,0.58,0.5455,0.56,0.194,24,444,468,468,True
7851,2011-11-28,4,0,11,18,0,1,1,1,0.56,0.5303,0.64,0.2239,20,396,416,416,True
7852,2011-11-28,4,0,11,19,0,1,1,1,0.54,0.5152,0.73,0.2239,4,260,264,264,True
7853,2011-11-28,4,0,11,20,0,1,1,2,0.54,0.5152,0.73,0.2537,12,206,218,218,True
7854,2011-11-28,4,0,11,21,0,1,1,2,0.54,0.5152,0.77,0.2239,4,152,156,156,True
7855,2011-11-28,4,0,11,22,0,1,1,2,0.52,0.5,0.83,0.1045,7,102,109,109,True
7856,2011-11-28,4,0,11,23,0,1,1,2,0.52,0.5,0.83,0.1343,5,41,46,46,True
7857,2011-11-29,4,0,11,0,0,2,1,1,0.52,0.5,0.83,0.0,4,18,22,22,True
7858,2011-11-29,4,0,11,1,0,2,1,1,0.52,0.5,0.83,0.0896,1,16,17,17,True
7859,2011-11-29,4,0,11,2,0,2,1,2,0.5,0.4848,0.88,0.0,0,5,5,5,True
7860,2011-11-29,4,0,11,3,0,2,1,2,0.5,0.4848,0.88,0.0,0,2,2,2,True
7861,2011-11-29,4,0,11,4,0,2,1,2,0.52,0.5,0.83,0.3284,1,5,6,6,True
7862,2011-11-29,4,0,11,5,0,2,1,1,0.5,0.4848,0.88,0.2836,1,21,22,22,True
7863,2011-11-29,4,0,11,6,0,2,1,1,0.52,0.5,0.83,0.2836,1,88,89,89,True
7864,2011-11-29,4,0,11,7,0,2,1,1,0.52,0.5,0.77,0.2239,12,330,342,342,True
7865,2011-11-29,4,0,11,8,0,2,1,1,0.54,0.5152,0.77,0.2836,9,440,449,449,True
7866,2011-11-29,4,0,11,9,0,2,1,3,0.56,0.5303,0.73,0.4179,5,197,202,202,True
7867,2011-11-29,4,0,11,10,0,2,1,3,0.56,0.5303,0.73,0.4179,2,34,36,36,True
7868,2011-11-29,4,0,11,11,0,2,1,3,0.5,0.4848,0.88,0.2985,1,10,11,11,True
7869,2011-11-29,4,0,11,12,0,2,1,3,0.42,0.4242,0.82,0.4179,1,17,18,18,True
7870,2011-11-29,4,0,11,13,0,2,1,3,0.42,0.4242,0.77,0.2836,0,22,22,22,True
7871,2011-11-29,4,0,11,14,0,2,1,3,0.4,0.4091,0.94,0.194,1,35,36,36,True
7872,2011-11-29,4,0,11,15,0,2,1,3,0.4,0.4091,0.87,0.3284,5,60,65,65,True
7873,2011-11-29,4,0,11,16,0,2,1,3,0.4,0.4091,0.87,0.2239,5,146,151,151,True
7874,2011-11-29,4,0,11,17,0,2,1,2,0.4,0.4091,0.87,0.2985,8,346,354,354,True
7875,2011-11-29,4,0,11,18,0,2,1,2,0.4,0.4091,0.82,0.2985,11,347,358,358,True
7876,2011-11-29,4,0,11,19,0,2,1,2,0.4,0.4091,0.82,0.3284,6,244,250,250,True
7877,2011-11-29,4,0,11,20,0,2,1,2,0.38,0.3939,0.87,0.2537,8,176,184,184,True
7878,2011-11-29,4,0,11,21,0,2,1,2,0.38,0.3939,0.87,0.2537,9,116,125,125,True
7879,2011-11-29,4,0,11,22,0,2,1,1,0.38,0.3939,0.82,0.2985,5,90,95,95,True
7880,2011-11-29,4,0,11,23,0,2,1,1,0.36,0.3333,0.76,0.3881,0,53,53,53,True
7881,2011-11-30,4,0,11,0,0,3,1,1,0.36,0.3333,0.62,0.4179,1,23,24,24,True
7882,2011-11-30,4,0,11,1,0,3,1,1,0.34,0.303,0.66,0.3284,0,8,8,8,True
7883,2011-11-30,4,0,11,2,0,3,1,1,0.32,0.3182,0.7,0.1642,0,5,5,5,True
7884,2011-11-30,4,0,11,3,0,3,1,1,0.32,0.3182,0.7,0.1642,0,1,1,1,True
7885,2011-11-30,4,0,11,4,0,3,1,1,0.3,0.2879,0.75,0.2239,0,5,5,5,True
7886,2011-11-30,4,0,11,5,0,3,1,1,0.28,0.2727,0.81,0.194,1,21,22,22,True
7887,2011-11-30,4,0,11,6,0,3,1,1,0.26,0.2727,0.87,0.1045,3,100,103,103,True
7888,2011-11-30,4,0,11,7,0,3,1,1,0.26,0.2727,0.81,0.1045,9,276,285,285,True
7889,2011-11-30,4,0,11,8,0,3,1,1,0.28,0.2727,0.81,0.194,13,465,478,478,True
7890,2011-11-30,4,0,11,9,0,3,1,1,0.3,0.2879,0.75,0.2836,7,186,193,193,True
7891,2011-11-30,4,0,11,10,0,3,1,1,0.34,0.3182,0.66,0.2239,15,95,110,110,True
7892,2011-11-30,4,0,11,11,0,3,1,1,0.38,0.3939,0.54,0.2985,10,112,122,122,True
7893,2011-11-30,4,0,11,12,0,3,1,2,0.36,0.3333,0.53,0.2836,12,148,160,160,True
7894,2011-11-30,4,0,11,13,0,3,1,2,0.38,0.3939,0.43,0.3582,16,131,147,147,True
7895,2011-11-30,4,0,11,14,0,3,1,2,0.38,0.3939,0.43,0.3582,13,99,112,112,True
7896,2011-11-30,4,0,11,15,0,3,1,1,0.36,0.3333,0.46,0.3284,11,104,115,115,True
7897,2011-11-30,4,0,11,16,0,3,1,1,0.36,0.3333,0.46,0.2836,27,199,226,226,True
7898,2011-11-30,4,0,11,17,0,3,1,2,0.34,0.303,0.49,0.3284,15,365,380,380,True
7899,2011-11-30,4,0,11,18,0,3,1,1,0.34,0.303,0.49,0.3284,7,369,376,376,True
7900,2011-11-30,4,0,11,19,0,3,1,2,0.32,0.303,0.57,0.2836,6,273,279,279,True
7901,2011-11-30,4,0,11,20,0,3,1,2,0.32,0.303,0.57,0.2836,6,184,190,190,True
7902,2011-11-30,4,0,11,21,0,3,1,1,0.32,0.2879,0.53,0.3881,7,128,135,135,True
7903,2011-11-30,4,0,11,22,0,3,1,1,0.3,0.2727,0.56,0.2985,5,82,87,87,True
7904,2011-11-30,4,0,11,23,0,3,1,1,0.28,0.2576,0.52,0.2836,4,46,50,50,True
7905,2011-12-01,4,0,12,0,0,4,1,1,0.28,0.2576,0.52,0.3284,1,19,20,20,True
7906,2011-12-01,4,0,12,1,0,4,1,1,0.26,0.2424,0.6,0.2836,1,9,10,10,True
7907,2011-12-01,4,0,12,2,0,4,1,1,0.26,0.2273,0.56,0.2985,1,8,9,9,True
7908,2011-12-01,4,0,12,3,0,4,1,1,0.26,0.2424,0.56,0.2537,1,6,7,7,True
7909,2011-12-01,4,0,12,4,0,4,1,1,0.26,0.2424,0.56,0.2836,0,1,1,1,True
7910,2011-12-01,4,0,12,5,0,4,1,1,0.26,0.2424,0.56,0.2537,1,23,24,24,True
7911,2011-12-01,4,0,12,6,0,4,1,1,0.24,0.2121,0.65,0.2836,5,92,97,97,True
7912,2011-12-01,4,0,12,7,0,4,1,1,0.24,0.2121,0.65,0.3582,11,265,276,276,True
7913,2011-12-01,4,0,12,8,0,4,1,1,0.26,0.2273,0.6,0.3284,15,462,477,477,True
7914,2011-12-01,4,0,12,9,0,4,1,1,0.3,0.2727,0.52,0.3284,9,215,224,224,True
7915,2011-12-01,4,0,12,10,0,4,1,1,0.32,0.303,0.53,0.2985,7,86,93,93,True
7916,2011-12-01,4,0,12,11,0,4,1,1,0.34,0.3182,0.49,0.2537,7,95,102,102,True
7917,2011-12-01,4,0,12,12,0,4,1,1,0.36,0.3485,0.46,0.2239,9,139,148,148,True
7918,2011-12-01,4,0,12,13,0,4,1,1,0.4,0.4091,0.4,0.2239,17,137,154,154,True
7919,2011-12-01,4,0,12,14,0,4,1,1,0.4,0.4091,0.4,0.2239,20,130,150,150,True
7920,2011-12-01,4,0,12,15,0,4,1,1,0.4,0.4091,0.4,0.2239,10,144,154,154,True
7921,2011-12-01,4,0,12,16,0,4,1,1,0.4,0.4091,0.4,0.194,9,192,201,201,True
7922,2011-12-01,4,0,12,17,0,4,1,1,0.36,0.3485,0.46,0.1343,9,409,418,418,True
7923,2011-12-01,4,0,12,18,0,4,1,1,0.36,0.3636,0.43,0.1045,12,393,405,405,True
7924,2011-12-01,4,0,12,19,0,4,1,1,0.34,0.3485,0.46,0.1045,9,219,228,228,True
7925,2011-12-01,4,0,12,20,0,4,1,1,0.34,0.3485,0.46,0.1045,12,178,190,190,True
7926,2011-12-01,4,0,12,21,0,4,1,1,0.3,0.3182,0.61,0.1045,8,154,162,162,True
7927,2011-12-01,4,0,12,22,0,4,1,1,0.3,0.3333,0.61,0.0,5,99,104,104,True
7928,2011-12-01,4,0,12,23,0,4,1,1,0.26,0.2879,0.7,0.0896,3,70,73,73,True
7929,2011-12-02,4,0,12,0,0,5,1,1,0.26,0.2879,0.7,0.0896,6,32,38,38,True
7930,2011-12-02,4,0,12,1,0,5,1,1,0.24,0.2879,0.75,0.0,1,14,15,15,True
7931,2011-12-02,4,0,12,2,0,5,1,1,0.24,0.2879,0.75,0.0,0,10,10,10,True
7932,2011-12-02,4,0,12,3,0,5,1,1,0.22,0.2727,0.8,0.0,0,1,1,1,True
7933,2011-12-02,4,0,12,4,0,5,1,1,0.22,0.2727,0.8,0.0,0,3,3,3,True
7934,2011-12-02,4,0,12,5,0,5,1,1,0.22,0.2576,0.8,0.0896,0,23,23,23,True
7935,2011-12-02,4,0,12,6,0,5,1,1,0.22,0.2727,0.8,0.0,3,84,87,87,True
7936,2011-12-02,4,0,12,7,0,5,1,1,0.22,0.2576,0.87,0.0896,6,199,205,205,True
7937,2011-12-02,4,0,12,8,0,5,1,1,0.24,0.2879,0.87,0.0,13,432,445,445,True
7938,2011-12-02,4,0,12,9,0,5,1,1,0.28,0.3182,0.81,0.0,12,234,246,246,True
7939,2011-12-02,4,0,12,10,0,5,1,1,0.3,0.2879,0.75,0.2239,16,89,105,105,True
7940,2011-12-02,4,0,12,11,0,5,1,1,0.34,0.3333,0.66,0.1642,18,142,160,160,True
7941,2011-12-02,4,0,12,12,0,5,1,1,0.36,0.3485,0.57,0.1343,18,186,204,204,True
7942,2011-12-02,4,0,12,13,0,5,1,1,0.4,0.4091,0.47,0.1343,19,188,207,207,True
7943,2011-12-02,4,0,12,14,0,5,1,1,0.42,0.4242,0.44,0.1045,25,145,170,170,True
7944,2011-12-02,4,0,12,15,0,5,1,1,0.42,0.4242,0.41,0.0896,24,175,199,199,True
7945,2011-12-02,4,0,12,16,0,5,1,1,0.42,0.4242,0.41,0.0896,22,254,276,276,True
7946,2011-12-02,4,0,12,17,0,5,1,1,0.42,0.4242,0.38,0.0,20,391,411,411,True
7947,2011-12-02,4,0,12,18,0,5,1,1,0.4,0.4091,0.5,0.0,10,362,372,372,True
7948,2011-12-02,4,0,12,19,0,5,1,1,0.34,0.3182,0.53,0.2537,13,252,265,265,True
7949,2011-12-02,4,0,12,20,0,5,1,1,0.38,0.3939,0.4,0.2836,12,178,190,190,True
7950,2011-12-02,4,0,12,21,0,5,1,1,0.34,0.3333,0.49,0.194,9,102,111,111,True
7951,2011-12-02,4,0,12,22,0,5,1,1,0.32,0.3182,0.53,0.194,7,95,102,102,True
7952,2011-12-02,4,0,12,23,0,5,1,1,0.32,0.303,0.53,0.2836,14,81,95,95,True
7953,2011-12-03,4,0,12,0,0,6,0,1,0.3,0.2879,0.56,0.2537,10,65,75,75,True
7954,2011-12-03,4,0,12,1,0,6,0,1,0.26,0.2576,0.65,0.194,9,62,71,71,True
7955,2011-12-03,4,0,12,2,0,6,0,1,0.26,0.2576,0.65,0.1642,9,41,50,50,True
7956,2011-12-03,4,0,12,3,0,6,0,1,0.24,0.2424,0.7,0.1343,4,5,9,9,True
7957,2011-12-03,4,0,12,4,0,6,0,1,0.22,0.2273,0.75,0.1343,1,7,8,8,True
7958,2011-12-03,4,0,12,5,0,6,0,1,0.24,0.2576,0.7,0.0896,0,6,6,6,True
7959,2011-12-03,4,0,12,6,0,6,0,1,0.24,0.2576,0.65,0.1045,1,10,11,11,True
7960,2011-12-03,4,0,12,7,0,6,0,1,0.22,0.2576,0.75,0.0896,2,24,26,26,True
7961,2011-12-03,4,0,12,8,0,6,0,1,0.24,0.2576,0.75,0.0896,1,62,63,63,True
7962,2011-12-03,4,0,12,9,0,6,0,1,0.26,0.2727,0.7,0.1045,25,99,124,124,True
7963,2011-12-03,4,0,12,10,0,6,0,1,0.32,0.3333,0.61,0.1343,22,173,195,195,True
7964,2011-12-03,4,0,12,11,0,6,0,1,0.32,0.3333,0.57,0.0896,48,227,275,275,True
7965,2011-12-03,4,0,12,12,0,6,0,1,0.36,0.3788,0.5,0.0,78,280,358,358,True
7966,2011-12-03,4,0,12,13,0,6,0,1,0.36,0.3636,0.5,0.0896,70,222,292,292,True
7967,2011-12-03,4,0,12,14,0,6,0,1,0.36,0.3788,0.46,0.0,92,251,343,343,True
7968,2011-12-03,4,0,12,15,0,6,0,1,0.38,0.3939,0.46,0.0,100,237,337,337,True
7969,2011-12-03,4,0,12,16,0,6,0,1,0.38,0.3939,0.46,0.0,75,230,305,305,True
7970,2011-12-03,4,0,12,17,0,6,0,1,0.36,0.3788,0.62,0.0,46,186,232,232,True
7971,2011-12-03,4,0,12,18,0,6,0,1,0.34,0.3333,0.53,0.1343,31,193,224,224,True
7972,2011-12-03,4,0,12,19,0,6,0,1,0.3,0.3182,0.61,0.0896,31,144,175,175,True
7973,2011-12-03,4,0,12,20,0,6,0,1,0.3,0.3182,0.61,0.0896,17,110,127,127,True
7974,2011-12-03,4,0,12,21,0,6,0,2,0.3,0.3182,0.61,0.0896,5,104,109,109,True
7975,2011-12-03,4,0,12,22,0,6,0,2,0.32,0.3333,0.61,0.0896,17,97,114,114,True
7976,2011-12-03,4,0,12,23,0,6,0,1,0.3,0.303,0.7,0.1343,12,73,85,85,True
7977,2011-12-04,4,0,12,0,0,0,0,1,0.3,0.3182,0.7,0.1045,19,64,83,83,True
7978,2011-12-04,4,0,12,1,0,0,0,1,0.3,0.3182,0.75,0.0896,20,54,74,74,True
7979,2011-12-04,4,0,12,2,0,0,0,1,0.26,0.303,0.81,0.0,11,51,62,62,True
7980,2011-12-04,4,0,12,3,0,0,0,1,0.28,0.3182,0.75,0.0,7,34,41,41,True
7981,2011-12-04,4,0,12,4,0,0,0,1,0.26,0.303,0.87,0.0,2,9,11,11,True
7982,2011-12-04,4,0,12,5,0,0,0,1,0.26,0.303,0.81,0.0,2,2,4,4,True
7983,2011-12-04,4,0,12,6,0,0,0,1,0.24,0.2879,0.93,0.0,1,3,4,4,True
7984,2011-12-04,4,0,12,7,0,0,0,1,0.26,0.303,0.87,0.0,3,23,26,26,True
7985,2011-12-04,4,0,12,8,0,0,0,1,0.26,0.303,0.87,0.0,7,48,55,55,True
7986,2011-12-04,4,0,12,9,0,0,0,1,0.3,0.3333,0.81,0.0,12,114,126,126,True
7987,2011-12-04,4,0,12,10,0,0,0,1,0.32,0.3333,0.81,0.1343,36,180,216,216,True
7988,2011-12-04,4,0,12,11,0,0,0,1,0.34,0.3333,0.81,0.1642,48,206,254,254,True
7989,2011-12-04,4,0,12,12,0,0,0,1,0.36,0.3485,0.81,0.1642,82,247,329,329,True
7990,2011-12-04,4,0,12,13,0,0,0,1,0.4,0.4091,0.66,0.2239,88,269,357,357,True
7991,2011-12-04,4,0,12,14,0,0,0,1,0.42,0.4242,0.62,0.1343,77,246,323,323,True
7992,2011-12-04,4,0,12,15,0,0,0,1,0.42,0.4242,0.62,0.194,69,227,296,296,True
7993,2011-12-04,4,0,12,16,0,0,0,1,0.42,0.4242,0.58,0.2239,64,266,330,330,True
7994,2011-12-04,4,0,12,17,0,0,0,1,0.38,0.3939,0.76,0.1343,38,207,245,245,True
7995,2011-12-04,4,0,12,18,0,0,0,1,0.38,0.3939,0.71,0.0,10,161,171,171,True
7996,2011-12-04,4,0,12,19,0,0,0,1,0.38,0.3939,0.76,0.0,15,158,173,173,True
7997,2011-12-04,4,0,12,20,0,0,0,1,0.36,0.3485,0.76,0.1343,8,116,124,124,True
7998,2011-12-04,4,0,12,21,0,0,0,1,0.36,0.3636,0.81,0.1045,7,65,72,72,True
7999,2011-12-04,4,0,12,22,0,0,0,1,0.34,0.3485,0.87,0.1045,5,59,64,64,True
8000,2011-12-04,4,0,12,23,0,0,0,1,0.34,0.3485,0.87,0.1045,3,42,45,45,True
8001,2011-12-05,4,0,12,0,0,1,1,1,0.32,0.3333,0.87,0.0896,3,21,24,24,True
8002,2011-12-05,4,0,12,1,0,1,1,1,0.32,0.3485,0.87,0.0,2,10,12,12,True
8003,2011-12-05,4,0,12,2,0,1,1,1,0.32,0.3485,0.87,0.0,0,8,8,8,True
8004,2011-12-05,4,0,12,3,0,1,1,1,0.32,0.3485,0.87,0.0,0,2,2,2,True
8005,2011-12-05,4,0,12,4,0,1,1,1,0.3,0.3182,0.87,0.1045,0,7,7,7,True
8006,2011-12-05,4,0,12,5,0,1,1,1,0.3,0.3182,0.87,0.1045,1,24,25,25,True
8007,2011-12-05,4,0,12,6,0,1,1,1,0.3,0.3182,0.93,0.0896,1,89,90,90,True
8008,2011-12-05,4,0,12,7,0,1,1,1,0.32,0.3485,0.9,0.0,9,274,283,283,True
8009,2011-12-05,4,0,12,8,0,1,1,1,0.32,0.3485,0.93,0.0,12,392,404,404,True
8010,2011-12-05,4,0,12,9,0,1,1,2,0.36,0.3636,0.87,0.0896,12,178,190,190,True
8011,2011-12-05,4,0,12,10,0,1,1,2,0.36,0.3636,0.87,0.0896,9,78,87,87,True
8012,2011-12-05,4,0,12,11,0,1,1,2,0.36,0.3636,0.87,0.0896,17,106,123,123,True
8013,2011-12-05,4,0,12,12,0,1,1,2,0.4,0.4091,0.76,0.1045,29,125,154,154,True
8014,2011-12-05,4,0,12,13,0,1,1,2,0.42,0.4242,0.71,0.0896,18,153,171,171,True
8015,2011-12-05,4,0,12,14,0,1,1,2,0.46,0.4545,0.67,0.0,7,126,133,133,True
8016,2011-12-05,4,0,12,15,0,1,1,2,0.46,0.4545,0.72,0.0896,16,132,148,148,True
8017,2011-12-05,4,0,12,16,0,1,1,1,0.5,0.4848,0.63,0.0896,10,238,248,248,True
8018,2011-12-05,4,0,12,17,0,1,1,1,0.42,0.4242,0.77,0.0,16,430,446,446,True
8019,2011-12-05,4,0,12,18,0,1,1,1,0.44,0.4394,0.77,0.0,13,386,399,399,True
8020,2011-12-05,4,0,12,19,0,1,1,2,0.46,0.4545,0.77,0.0,13,295,308,308,True
8021,2011-12-05,4,0,12,20,0,1,1,2,0.46,0.4545,0.82,0.1045,15,190,205,205,True
8022,2011-12-05,4,0,12,21,0,1,1,2,0.44,0.4394,0.88,0.0896,10,166,176,176,True
8023,2011-12-05,4,0,12,22,0,1,1,2,0.44,0.4394,0.88,0.1343,12,94,106,106,True
8024,2011-12-05,4,0,12,23,0,1,1,2,0.46,0.4545,0.88,0.1343,8,54,62,62,True
8025,2011-12-06,4,0,12,0,0,2,1,2,0.5,0.4848,0.77,0.2985,3,25,28,28,True
8026,2011-12-06,4,0,12,1,0,2,1,2,0.46,0.4545,0.88,0.2985,2,14,16,16,True
8027,2011-12-06,4,0,12,2,0,2,1,2,0.46,0.4545,0.87,0.194,0,3,3,3,True
8028,2011-12-06,4,0,12,3,0,2,1,2,0.46,0.4545,0.87,0.194,0,3,3,3,True
8029,2011-12-06,4,0,12,4,0,2,1,3,0.46,0.4545,0.88,0.2239,0,7,7,7,True
8030,2011-12-06,4,0,12,5,0,2,1,3,0.46,0.4545,0.88,0.2239,0,20,20,20,True
8031,2011-12-06,4,0,12,6,0,2,1,2,0.44,0.4394,0.94,0.2836,5,81,86,86,True
8032,2011-12-06,4,0,12,7,0,2,1,2,0.46,0.4545,0.94,0.194,7,227,234,234,True
8033,2011-12-06,4,0,12,8,0,2,1,2,0.46,0.4545,0.94,0.194,13,401,414,414,True
8034,2011-12-06,4,0,12,9,0,2,1,2,0.46,0.4545,0.94,0.2239,4,200,204,204,True
8035,2011-12-06,4,0,12,10,0,2,1,3,0.46,0.4545,0.94,0.2836,6,44,50,50,True
8036,2011-12-06,4,0,12,11,0,2,1,3,0.46,0.4545,0.94,0.2537,4,28,32,32,True
8037,2011-12-06,4,0,12,12,0,2,1,3,0.46,0.4545,1.0,0.2239,5,50,55,55,True
8038,2011-12-06,4,0,12,13,0,2,1,3,0.46,0.4545,1.0,0.194,6,65,71,71,True
8039,2011-12-06,4,0,12,14,0,2,1,3,0.48,0.4697,1.0,0.2239,6,69,75,75,True
8040,2011-12-06,4,0,12,15,0,2,1,3,0.5,0.4848,1.0,0.194,2,43,45,45,True
8041,2011-12-06,4,0,12,16,0,2,1,3,0.46,0.4545,1.0,0.2537,4,84,88,88,True
8042,2011-12-06,4,0,12,17,0,2,1,2,0.46,0.4545,1.0,0.2239,13,249,262,262,True
8043,2011-12-06,4,0,12,18,0,2,1,2,0.46,0.4545,1.0,0.2836,17,287,304,304,True
8044,2011-12-06,4,0,12,19,0,2,1,3,0.46,0.4545,1.0,0.2985,10,223,233,233,True
8045,2011-12-06,4,0,12,20,0,2,1,3,0.46,0.4545,1.0,0.2985,3,107,110,110,True
8046,2011-12-06,4,0,12,21,0,2,1,2,0.44,0.4394,1.0,0.194,6,108,114,114,True
8047,2011-12-06,4,0,12,22,0,2,1,3,0.46,0.4545,1.0,0.1642,5,82,87,87,True
8048,2011-12-06,4,0,12,23,0,2,1,3,0.46,0.4545,1.0,0.1642,5,48,53,53,True
8049,2011-12-07,4,0,12,0,0,3,1,1,0.44,0.4394,1.0,0.194,3,30,33,33,True
8050,2011-12-07,4,0,12,1,0,3,1,2,0.46,0.4545,1.0,0.2537,4,9,13,13,True
8051,2011-12-07,4,0,12,2,0,3,1,3,0.46,0.4545,1.0,0.2239,2,4,6,6,True
8052,2011-12-07,4,0,12,3,0,3,1,3,0.46,0.4545,1.0,0.2239,0,3,3,3,True
8053,2011-12-07,4,0,12,4,0,3,1,3,0.46,0.4545,1.0,0.1642,0,1,1,1,True
8054,2011-12-07,4,0,12,5,0,3,1,3,0.46,0.4545,1.0,0.1642,0,3,3,3,True
8055,2011-12-07,4,0,12,6,0,3,1,3,0.48,0.4697,1.0,0.4179,0,18,18,18,True
8056,2011-12-07,4,0,12,7,0,3,1,3,0.44,0.4394,1.0,0.1045,3,43,46,46,True
8057,2011-12-07,4,0,12,8,0,3,1,3,0.44,0.4394,1.0,0.0,6,80,86,86,True
8058,2011-12-07,4,0,12,9,0,3,1,3,0.44,0.4394,1.0,0.2537,0,64,64,64,True
8059,2011-12-07,4,0,12,10,0,3,1,3,0.44,0.4394,1.0,0.0896,1,32,33,33,True
8060,2011-12-07,4,0,12,11,0,3,1,3,0.44,0.4394,1.0,0.0896,3,47,50,50,True
8061,2011-12-07,4,0,12,12,0,3,1,3,0.44,0.4394,1.0,0.1343,4,29,33,33,True
8062,2011-12-07,4,0,12,13,0,3,1,3,0.44,0.4394,1.0,0.194,5,28,33,33,True
8063,2011-12-07,4,0,12,14,0,3,1,3,0.44,0.4394,1.0,0.194,1,24,25,25,True
8064,2011-12-07,4,0,12,15,0,3,1,3,0.42,0.4242,0.94,0.2239,5,25,30,30,True
8065,2011-12-07,4,0,12,16,0,3,1,3,0.42,0.4242,0.94,0.194,3,28,31,31,True
8066,2011-12-07,4,0,12,17,0,3,1,3,0.4,0.4091,1.0,0.3284,4,48,52,52,True
8067,2011-12-07,4,0,12,18,0,3,1,3,0.4,0.4091,0.94,0.2985,3,48,51,51,True
8068,2011-12-07,4,0,12,19,0,3,1,3,0.34,0.2879,0.87,0.4775,2,31,33,33,True
8069,2011-12-07,4,0,12,20,0,3,1,3,0.34,0.2879,0.87,0.4775,1,25,26,26,True
8070,2011-12-07,4,0,12,21,0,3,1,3,0.3,0.2576,0.87,0.4775,0,6,6,6,True
8071,2011-12-07,4,0,12,22,0,3,1,3,0.24,0.197,0.93,0.4478,0,13,13,13,True
8072,2011-12-07,4,0,12,23,0,3,1,1,0.24,0.2121,0.93,0.3881,0,16,16,16,True
8073,2011-12-08,4,0,12,0,0,4,1,2,0.26,0.2273,0.87,0.2985,0,21,21,21,True
8074,2011-12-08,4,0,12,1,0,4,1,1,0.26,0.2273,0.81,0.3582,1,6,7,7,True
8075,2011-12-08,4,0,12,2,0,4,1,1,0.28,0.2727,0.65,0.2239,0,4,4,4,True
8076,2011-12-08,4,0,12,3,0,4,1,1,0.26,0.2273,0.6,0.2985,0,1,1,1,True
8077,2011-12-08,4,0,12,4,0,4,1,2,0.24,0.197,0.6,0.4627,0,2,2,2,True
8078,2011-12-08,4,0,12,5,0,4,1,1,0.22,0.2121,0.64,0.2239,0,12,12,12,True
8079,2011-12-08,4,0,12,6,0,4,1,1,0.22,0.2121,0.55,0.2836,0,71,71,71,True
8080,2011-12-08,4,0,12,7,0,4,1,1,0.22,0.2121,0.6,0.2239,11,233,244,244,True
8081,2011-12-08,4,0,12,8,0,4,1,1,0.22,0.2121,0.55,0.2836,11,418,429,429,True
8082,2011-12-08,4,0,12,9,0,4,1,1,0.24,0.2121,0.52,0.3881,7,218,225,225,True
8083,2011-12-08,4,0,12,10,0,4,1,1,0.26,0.2273,0.52,0.3284,1,109,110,110,True
8084,2011-12-08,4,0,12,11,0,4,1,1,0.28,0.2727,0.52,0.2537,6,100,106,106,True
8085,2011-12-08,4,0,12,12,0,4,1,1,0.28,0.2576,0.52,0.3284,8,148,156,156,True
8086,2011-12-08,4,0,12,13,0,4,1,1,0.3,0.2727,0.49,0.3582,9,115,124,124,True
8087,2011-12-08,4,0,12,14,0,4,1,1,0.32,0.303,0.45,0.2537,16,121,137,137,True
8088,2011-12-08,4,0,12,15,0,4,1,1,0.32,0.3333,0.45,0.1343,19,98,117,117,True
8089,2011-12-08,4,0,12,16,0,4,1,1,0.32,0.3182,0.45,0.194,7,201,208,208,True
8090,2011-12-08,4,0,12,17,0,4,1,1,0.3,0.3182,0.49,0.1045,10,321,331,331,True
8091,2011-12-08,4,0,12,18,0,4,1,1,0.28,0.2727,0.52,0.2239,12,306,318,318,True
8092,2011-12-08,4,0,12,19,0,4,1,1,0.26,0.2727,0.56,0.1045,12,220,232,232,True
8093,2011-12-08,4,0,12,20,0,4,1,1,0.26,0.2727,0.6,0.1045,5,170,175,175,True
8094,2011-12-08,4,0,12,21,0,4,1,1,0.28,0.303,0.61,0.0896,4,135,139,139,True
8095,2011-12-08,4,0,12,22,0,4,1,1,0.26,0.2727,0.65,0.1343,8,84,92,92,True
8096,2011-12-08,4,0,12,23,0,4,1,1,0.24,0.2576,0.7,0.1045,3,58,61,61,True
8097,2011-12-09,4,0,12,0,0,5,1,1,0.24,0.2879,0.65,0.0,8,26,34,34,True
8098,2011-12-09,4,0,12,1,0,5,1,1,0.24,0.2879,0.65,0.0,2,12,14,14,True
8099,2011-12-09,4,0,12,2,0,5,1,1,0.24,0.2879,0.7,0.0,2,10,12,12,True
8100,2011-12-09,4,0,12,3,0,5,1,1,0.22,0.2727,0.8,0.0,1,5,6,6,True
8101,2011-12-09,4,0,12,4,0,5,1,1,0.22,0.2727,0.8,0.0,1,1,2,2,True
8102,2011-12-09,4,0,12,5,0,5,1,1,0.22,0.2727,0.8,0.0,0,20,20,20,True
8103,2011-12-09,4,0,12,6,0,5,1,1,0.22,0.2576,0.8,0.0896,1,62,63,63,True
8104,2011-12-09,4,0,12,7,0,5,1,1,0.22,0.2576,0.75,0.0896,4,195,199,199,True
8105,2011-12-09,4,0,12,8,0,5,1,1,0.24,0.2879,0.81,0.0,7,378,385,385,True
8106,2011-12-09,4,0,12,9,0,5,1,1,0.26,0.2879,0.81,0.0896,8,256,264,264,True
8107,2011-12-09,4,0,12,10,0,5,1,2,0.3,0.303,0.7,0.1642,11,115,126,126,True
8108,2011-12-09,4,0,12,11,0,5,1,1,0.32,0.303,0.7,0.2537,15,121,136,136,True
8109,2011-12-09,4,0,12,12,0,5,1,1,0.36,0.3333,0.57,0.2985,27,146,173,173,True
8110,2011-12-09,4,0,12,13,0,5,1,1,0.38,0.3939,0.5,0.194,27,141,168,168,True
8111,2011-12-09,4,0,12,14,0,5,1,1,0.38,0.3939,0.46,0.2836,24,163,187,187,True
8112,2011-12-09,4,0,12,15,0,5,1,1,0.38,0.3939,0.46,0.2836,29,160,189,189,True
8113,2011-12-09,4,0,12,16,0,5,1,1,0.36,0.3485,0.62,0.1343,24,226,250,250,True
8114,2011-12-09,4,0,12,17,0,5,1,1,0.34,0.3485,0.66,0.1045,10,352,362,362,True
8115,2011-12-09,4,0,12,18,0,5,1,1,0.34,0.3636,0.61,0.0,10,308,318,318,True
8116,2011-12-09,4,0,12,19,0,5,1,1,0.34,0.3636,0.61,0.0,10,189,199,199,True
8117,2011-12-09,4,0,12,20,0,5,1,1,0.3,0.3333,0.81,0.0,10,140,150,150,True
8118,2011-12-09,4,0,12,21,0,5,1,1,0.3,0.3333,0.75,0.0,9,131,140,140,True
8119,2011-12-09,4,0,12,22,0,5,1,1,0.28,0.3182,0.87,0.0,15,114,129,129,True
8120,2011-12-09,4,0,12,23,0,5,1,1,0.28,0.3182,0.81,0.0,6,88,94,94,True
8121,2011-12-10,4,0,12,0,0,6,0,2,0.26,0.2727,0.81,0.1045,11,66,77,77,True
8122,2011-12-10,4,0,12,1,0,6,0,2,0.26,0.2576,0.7,0.1642,11,55,66,66,True
8123,2011-12-10,4,0,12,2,0,6,0,2,0.28,0.303,0.61,0.0896,12,48,60,60,True
8124,2011-12-10,4,0,12,3,0,6,0,2,0.28,0.303,0.61,0.0896,5,20,25,25,True
8125,2011-12-10,4,0,12,4,0,6,0,2,0.26,0.2727,0.65,0.1045,0,3,3,3,True
8126,2011-12-10,4,0,12,5,0,6,0,1,0.26,0.2576,0.6,0.1642,0,6,6,6,True
8127,2011-12-10,4,0,12,6,0,6,0,1,0.24,0.2576,0.65,0.1045,1,10,11,11,True
8128,2011-12-10,4,0,12,7,0,6,0,1,0.24,0.2273,0.65,0.194,0,11,11,11,True
8129,2011-12-10,4,0,12,8,0,6,0,1,0.26,0.2727,0.65,0.1343,5,68,73,73,True
8130,2011-12-10,4,0,12,9,0,6,0,1,0.28,0.2576,0.61,0.2836,15,134,149,149,True
8131,2011-12-10,4,0,12,10,0,6,0,1,0.32,0.303,0.57,0.2537,31,161,192,192,True
8132,2011-12-10,4,0,12,11,0,6,0,1,0.32,0.2879,0.53,0.4179,44,192,236,236,True
8133,2011-12-10,4,0,12,12,0,6,0,1,0.32,0.2879,0.45,0.4179,48,235,283,283,True
8134,2011-12-10,4,0,12,13,0,6,0,1,0.34,0.303,0.34,0.4179,47,239,286,286,True
8135,2011-12-10,4,0,12,14,0,6,0,1,0.34,0.303,0.31,0.3284,51,242,293,293,True
8136,2011-12-10,4,0,12,15,0,6,0,1,0.34,0.303,0.34,0.3582,60,239,299,299,True
8137,2011-12-10,4,0,12,16,0,6,0,1,0.32,0.2879,0.31,0.3881,58,183,241,241,True
8138,2011-12-10,4,0,12,17,0,6,0,1,0.28,0.2576,0.36,0.3284,34,151,185,185,True
8139,2011-12-10,4,0,12,18,0,6,0,1,0.26,0.2576,0.38,0.2239,28,144,172,172,True
8140,2011-12-10,4,0,12,19,0,6,0,1,0.26,0.2424,0.38,0.2836,15,139,154,154,True
8141,2011-12-10,4,0,12,20,0,6,0,1,0.24,0.2273,0.35,0.2239,10,114,124,124,True
8142,2011-12-10,4,0,12,21,0,6,0,1,0.22,0.2121,0.44,0.2239,4,79,83,83,True
8143,2011-12-10,4,0,12,22,0,6,0,1,0.22,0.2273,0.41,0.1343,7,88,95,95,True
8144,2011-12-10,4,0,12,23,0,6,0,1,0.2,0.2121,0.47,0.1642,5,61,66,66,True
8145,2011-12-11,4,0,12,0,0,0,0,1,0.2,0.197,0.51,0.2239,5,69,74,74,True
8146,2011-12-11,4,0,12,1,0,0,0,1,0.16,0.1515,0.59,0.2239,8,54,62,62,True
8147,2011-12-11,4,0,12,2,0,0,0,1,0.18,0.1667,0.55,0.2537,5,47,52,52,True
8148,2011-12-11,4,0,12,3,0,0,0,1,0.16,0.1818,0.59,0.1343,2,17,19,19,True
8149,2011-12-11,4,0,12,4,0,0,0,1,0.16,0.1667,0.59,0.1642,0,5,5,5,True
8150,2011-12-11,4,0,12,5,0,0,0,1,0.18,0.2121,0.59,0.1045,0,6,6,6,True
8151,2011-12-11,4,0,12,6,0,0,0,1,0.16,0.2273,0.59,0.0,0,10,10,10,True
8152,2011-12-11,4,0,12,7,0,0,0,1,0.18,0.2424,0.55,0.0,1,30,31,31,True
8153,2011-12-11,4,0,12,8,0,0,0,1,0.16,0.2273,0.69,0.0,4,68,72,72,True
8154,2011-12-11,4,0,12,9,0,0,0,1,0.2,0.2576,0.59,0.0,19,88,107,107,True
8155,2011-12-11,4,0,12,10,0,0,0,1,0.24,0.2879,0.44,0.0,30,164,194,194,True
8156,2011-12-11,4,0,12,11,0,0,0,1,0.26,0.303,0.35,0.0,31,166,197,197,True
8157,2011-12-11,4,0,12,12,0,0,0,1,0.26,0.303,0.35,0.0,42,246,288,288,True
8158,2011-12-11,4,0,12,13,0,0,0,1,0.3,0.3333,0.31,0.0,44,224,268,268,True
8159,2011-12-11,4,0,12,14,0,0,0,1,0.3,0.3333,0.28,0.0,44,198,242,242,True
8160,2011-12-11,4,0,12,15,0,0,0,1,0.3,0.3333,0.26,0.0,47,219,266,266,True
8161,2011-12-11,4,0,12,16,0,0,0,1,0.3,0.3333,0.26,0.0,32,174,206,206,True
8162,2011-12-11,4,0,12,17,0,0,0,1,0.28,0.3182,0.3,0.0,13,150,163,163,True
8163,2011-12-11,4,0,12,18,0,0,0,1,0.24,0.2273,0.48,0.194,12,151,163,163,True
8164,2011-12-11,4,0,12,19,0,0,0,1,0.22,0.2273,0.55,0.194,7,98,105,105,True
8165,2011-12-11,4,0,12,20,0,0,0,1,0.22,0.2424,0.55,0.1045,10,62,72,72,True
8166,2011-12-11,4,0,12,21,0,0,0,1,0.22,0.2727,0.55,0.0,10,53,63,63,True
8167,2011-12-11,4,0,12,22,0,0,0,1,0.22,0.2727,0.55,0.0,7,36,43,43,True
8168,2011-12-11,4,0,12,23,0,0,0,1,0.2,0.2576,0.69,0.0,4,31,35,35,True
8169,2011-12-12,4,0,12,0,0,1,1,1,0.2,0.2273,0.69,0.0896,4,16,20,20,True
8170,2011-12-12,4,0,12,1,0,1,1,1,0.2,0.2576,0.69,0.0,0,9,9,9,True
8171,2011-12-12,4,0,12,2,0,1,1,1,0.2,0.2576,0.69,0.0,0,4,4,4,True
8172,2011-12-12,4,0,12,3,0,1,1,1,0.18,0.2424,0.74,0.0,0,2,2,2,True
8173,2011-12-12,4,0,12,4,0,1,1,1,0.18,0.2424,0.74,0.0,0,3,3,3,True
8174,2011-12-12,4,0,12,5,0,1,1,1,0.16,0.2273,0.8,0.0,0,21,21,21,True
8175,2011-12-12,4,0,12,6,0,1,1,1,0.16,0.1818,0.8,0.1045,1,63,64,64,True
8176,2011-12-12,4,0,12,7,0,1,1,1,0.14,0.1515,0.86,0.1343,4,231,235,235,True
8177,2011-12-12,4,0,12,8,0,1,1,2,0.16,0.1818,0.8,0.1045,7,378,385,385,True
8178,2011-12-12,4,0,12,9,0,1,1,2,0.18,0.2121,0.74,0.0896,12,208,220,220,True
8179,2011-12-12,4,0,12,10,0,1,1,2,0.22,0.2424,0.69,0.1045,14,91,105,105,True
8180,2011-12-12,4,0,12,11,0,1,1,2,0.26,0.2879,0.6,0.0896,15,100,115,115,True
8181,2011-12-12,4,0,12,12,0,1,1,1,0.28,0.2879,0.52,0.1045,7,138,145,145,True
8182,2011-12-12,4,0,12,13,0,1,1,2,0.3,0.3182,0.52,0.1045,13,153,166,166,True
8183,2011-12-12,4,0,12,14,0,1,1,2,0.32,0.3333,0.53,0.1343,16,95,111,111,True
8184,2011-12-12,4,0,12,15,0,1,1,2,0.32,0.3333,0.57,0.1045,8,124,132,132,True
8185,2011-12-12,4,0,12,16,0,1,1,2,0.32,0.3333,0.57,0.0896,5,209,214,214,True
8186,2011-12-12,4,0,12,17,0,1,1,2,0.3,0.3333,0.56,0.0,7,352,359,359,True
8187,2011-12-12,4,0,12,18,0,1,1,1,0.3,0.3182,0.56,0.0896,8,349,357,357,True
8188,2011-12-12,4,0,12,19,0,1,1,1,0.28,0.303,0.61,0.0896,9,232,241,241,True
8189,2011-12-12,4,0,12,20,0,1,1,1,0.3,0.3182,0.56,0.0896,8,157,165,165,True
8190,2011-12-12,4,0,12,21,0,1,1,1,0.26,0.303,0.81,0.0,2,119,121,121,True
8191,2011-12-12,4,0,12,22,0,1,1,1,0.26,0.303,0.7,0.0,0,71,71,71,True
8192,2011-12-12,4,0,12,23,0,1,1,1,0.24,0.2879,0.75,0.0,3,42,45,45,True
8193,2011-12-13,4,0,12,0,0,2,1,1,0.22,0.2727,0.8,0.0,1,16,17,17,True
8194,2011-12-13,4,0,12,1,0,2,1,1,0.2,0.2576,0.8,0.0,0,4,4,4,True
8195,2011-12-13,4,0,12,2,0,2,1,1,0.2,0.2576,0.8,0.0,1,1,2,2,True
8196,2011-12-13,4,0,12,3,0,2,1,1,0.18,0.2424,0.8,0.0,0,3,3,3,True
8197,2011-12-13,4,0,12,4,0,2,1,1,0.2,0.2576,0.8,0.0,0,4,4,4,True
8198,2011-12-13,4,0,12,5,0,2,1,1,0.18,0.2424,0.86,0.0,0,20,20,20,True
8199,2011-12-13,4,0,12,6,0,2,1,1,0.2,0.2576,0.8,0.0,0,92,92,92,True
8200,2011-12-13,4,0,12,7,0,2,1,1,0.16,0.1667,0.8,0.1642,2,221,223,223,True
8201,2011-12-13,4,0,12,8,0,2,1,1,0.2,0.2273,0.69,0.1045,9,391,400,400,True
8202,2011-12-13,4,0,12,9,0,2,1,1,0.26,0.2576,0.6,0.1642,10,223,233,233,True
8203,2011-12-13,4,0,12,10,0,2,1,1,0.3,0.303,0.52,0.1642,3,99,102,102,True
8204,2011-12-13,4,0,12,11,0,2,1,1,0.34,0.3182,0.46,0.2537,9,115,124,124,True
8205,2011-12-13,4,0,12,12,0,2,1,1,0.36,0.3333,0.43,0.3582,20,147,167,167,True
8206,2011-12-13,4,0,12,13,0,2,1,1,0.4,0.4091,0.37,0.3284,7,120,127,127,True
8207,2011-12-13,4,0,12,14,0,2,1,1,0.4,0.4091,0.37,0.2537,18,116,134,134,True
8208,2011-12-13,4,0,12,15,0,2,1,1,0.4,0.4091,0.35,0.2537,7,144,151,151,True
8209,2011-12-13,4,0,12,16,0,2,1,1,0.38,0.3939,0.37,0.2537,13,194,207,207,True
8210,2011-12-13,4,0,12,17,0,2,1,1,0.36,0.3485,0.4,0.194,17,381,398,398,True
8211,2011-12-13,4,0,12,18,0,2,1,1,0.34,0.3182,0.42,0.2239,12,370,382,382,True
8212,2011-12-13,4,0,12,19,0,2,1,1,0.32,0.3182,0.49,0.1642,5,262,267,267,True
8213,2011-12-13,4,0,12,20,0,2,1,1,0.32,0.3182,0.49,0.1642,7,154,161,161,True
8214,2011-12-13,4,0,12,21,0,2,1,1,0.3,0.303,0.52,0.1642,5,134,139,139,True
8215,2011-12-13,4,0,12,22,0,2,1,1,0.3,0.303,0.52,0.1642,5,102,107,107,True
8216,2011-12-13,4,0,12,23,0,2,1,1,0.26,0.303,0.7,0.0,4,55,59,59,True
8217,2011-12-14,4,0,12,0,0,3,1,1,0.26,0.303,0.75,0.0,0,22,22,22,True
8218,2011-12-14,4,0,12,1,0,3,1,1,0.26,0.303,0.75,0.0,0,8,8,8,True
8219,2011-12-14,4,0,12,2,0,3,1,1,0.26,0.303,0.75,0.0,0,2,2,2,True
8220,2011-12-14,4,0,12,3,0,3,1,1,0.28,0.3182,0.65,0.0,0,3,3,3,True
8221,2011-12-14,4,0,12,4,0,3,1,1,0.26,0.303,0.75,0.0,0,4,4,4,True
8222,2011-12-14,4,0,12,5,0,3,1,2,0.26,0.303,0.81,0.0,0,26,26,26,True
8223,2011-12-14,4,0,12,6,0,3,1,2,0.26,0.303,0.87,0.0,0,87,87,87,True
8224,2011-12-14,4,0,12,7,0,3,1,1,0.28,0.3182,0.75,0.0,4,243,247,247,True
8225,2011-12-14,4,0,12,8,0,3,1,2,0.26,0.303,0.87,0.0,9,458,467,467,True
8226,2011-12-14,4,0,12,9,0,3,1,2,0.3,0.3333,0.61,0.0,9,230,239,239,True
8227,2011-12-14,4,0,12,10,0,3,1,2,0.32,0.3485,0.57,0.0,9,133,142,142,True
8228,2011-12-14,4,0,12,11,0,3,1,2,0.34,0.3636,0.55,0.0,12,103,115,115,True
8229,2011-12-14,4,0,12,12,0,3,1,2,0.36,0.3636,0.57,0.0896,6,138,144,144,True
8230,2011-12-14,4,0,12,13,0,3,1,2,0.36,0.3636,0.57,0.1045,14,119,133,133,True
8231,2011-12-14,4,0,12,14,0,3,1,2,0.38,0.3939,0.54,0.0896,17,134,151,151,True
8232,2011-12-14,4,0,12,15,0,3,1,2,0.38,0.3939,0.54,0.1045,24,143,167,167,True
8233,2011-12-14,4,0,12,16,0,3,1,2,0.38,0.3939,0.54,0.1045,12,233,245,245,True
8234,2011-12-14,4,0,12,17,0,3,1,2,0.36,0.3636,0.57,0.1045,19,377,396,396,True
8235,2011-12-14,4,0,12,18,0,3,1,2,0.36,0.3485,0.62,0.1642,11,379,390,390,True
8236,2011-12-14,4,0,12,19,0,3,1,2,0.36,0.3636,0.62,0.1045,9,259,268,268,True
8237,2011-12-14,4,0,12,20,0,3,1,2,0.34,0.3485,0.66,0.1045,6,169,175,175,True
8238,2011-12-14,4,0,12,21,0,3,1,2,0.34,0.3333,0.66,0.1642,9,145,154,154,True
8239,2011-12-14,4,0,12,22,0,3,1,1,0.34,0.3333,0.66,0.1642,5,99,104,104,True
8240,2011-12-14,4,0,12,23,0,3,1,1,0.32,0.3182,0.7,0.1642,3,48,51,51,True
8241,2011-12-15,4,0,12,0,0,4,1,1,0.32,0.3182,0.7,0.1642,5,45,50,50,True
8242,2011-12-15,4,0,12,1,0,4,1,2,0.32,0.3182,0.7,0.1642,5,15,20,20,True
8243,2011-12-15,4,0,12,2,0,4,1,2,0.32,0.3333,0.7,0.1343,2,5,7,7,True
8244,2011-12-15,4,0,12,3,0,4,1,2,0.32,0.3333,0.7,0.1343,1,2,3,3,True
8245,2011-12-15,4,0,12,4,0,4,1,2,0.32,0.303,0.7,0.2239,0,6,6,6,True
8246,2011-12-15,4,0,12,5,0,4,1,2,0.32,0.303,0.7,0.2836,0,24,24,24,True
8247,2011-12-15,4,0,12,6,0,4,1,1,0.32,0.3182,0.66,0.194,2,90,92,92,True
8248,2011-12-15,4,0,12,7,0,4,1,1,0.32,0.3182,0.7,0.194,6,252,258,258,True
8249,2011-12-15,4,0,12,8,0,4,1,2,0.34,0.3182,0.66,0.2239,8,449,457,457,True
8250,2011-12-15,4,0,12,9,0,4,1,2,0.36,0.3333,0.62,0.2836,6,274,280,280,True
8251,2011-12-15,4,0,12,10,0,4,1,2,0.4,0.4091,0.58,0.2985,4,105,109,109,True
8252,2011-12-15,4,0,12,11,0,4,1,2,0.4,0.4091,0.62,0.4179,9,126,135,135,True
8253,2011-12-15,4,0,12,12,0,4,1,2,0.46,0.4545,0.59,0.4775,17,140,157,157,True
8254,2011-12-15,4,0,12,13,0,4,1,2,0.5,0.4848,0.55,0.3582,14,150,164,164,True
8255,2011-12-15,4,0,12,14,0,4,1,2,0.52,0.5,0.52,0.3284,8,124,132,132,True
8256,2011-12-15,4,0,12,15,0,4,1,3,0.52,0.5,0.55,0.2239,6,76,82,82,True
8257,2011-12-15,4,0,12,16,0,4,1,3,0.46,0.4545,0.72,0.1642,7,124,131,131,True
8258,2011-12-15,4,0,12,17,0,4,1,2,0.52,0.5,0.59,0.2836,14,310,324,324,True
8259,2011-12-15,4,0,12,18,0,4,1,2,0.52,0.5,0.59,0.2985,14,363,377,377,True
8260,2011-12-15,4,0,12,19,0,4,1,2,0.52,0.5,0.59,0.2836,13,274,287,287,True
8261,2011-12-15,4,0,12,20,0,4,1,1,0.52,0.5,0.59,0.3284,12,209,221,221,True
8262,2011-12-15,4,0,12,21,0,4,1,1,0.5,0.4848,0.63,0.2985,10,145,155,155,True
8263,2011-12-15,4,0,12,22,0,4,1,1,0.52,0.5,0.63,0.3284,8,116,124,124,True
8264,2011-12-15,4,0,12,23,0,4,1,1,0.52,0.5,0.63,0.3284,10,104,114,114,True
8265,2011-12-16,4,0,12,0,0,5,1,1,0.5,0.4848,0.72,0.3284,12,60,72,72,True
8266,2011-12-16,4,0,12,1,0,5,1,1,0.5,0.4848,0.72,0.2239,3,28,31,31,True
8267,2011-12-16,4,0,12,2,0,5,1,1,0.48,0.4697,0.77,0.1045,0,23,23,23,True
8268,2011-12-16,4,0,12,3,0,5,1,1,0.46,0.4545,0.82,0.1343,2,3,5,5,True
8269,2011-12-16,4,0,12,4,0,5,1,2,0.5,0.4848,0.59,0.194,1,4,5,5,True
8270,2011-12-16,4,0,12,5,0,5,1,1,0.48,0.4697,0.44,0.3881,0,26,26,26,True
8271,2011-12-16,4,0,12,6,0,5,1,2,0.44,0.4394,0.33,0.2985,2,80,82,82,True
8272,2011-12-16,4,0,12,7,0,5,1,2,0.38,0.3939,0.46,0.2985,5,226,231,231,True
8273,2011-12-16,4,0,12,8,0,5,1,1,0.36,0.3333,0.46,0.4179,10,449,459,459,True
8274,2011-12-16,4,0,12,9,0,5,1,1,0.36,0.3333,0.46,0.3881,8,235,243,243,True
8275,2011-12-16,4,0,12,10,0,5,1,1,0.34,0.303,0.46,0.2985,10,122,132,132,True
8276,2011-12-16,4,0,12,11,0,5,1,2,0.34,0.303,0.42,0.2985,9,135,144,144,True
8277,2011-12-16,4,0,12,12,0,5,1,2,0.34,0.303,0.42,0.3582,10,163,173,173,True
8278,2011-12-16,4,0,12,13,0,5,1,2,0.34,0.303,0.39,0.3582,12,125,137,137,True
8279,2011-12-16,4,0,12,14,0,5,1,2,0.34,0.3182,0.42,0.2239,13,115,128,128,True
8280,2011-12-16,4,0,12,15,0,5,1,2,0.32,0.303,0.45,0.2985,12,141,153,153,True
8281,2011-12-16,4,0,12,16,0,5,1,2,0.32,0.303,0.45,0.2239,12,212,224,224,True
8282,2011-12-16,4,0,12,17,0,5,1,2,0.32,0.303,0.45,0.2836,13,352,365,365,True
8283,2011-12-16,4,0,12,18,0,5,1,2,0.32,0.303,0.45,0.2537,10,285,295,295,True
8284,2011-12-16,4,0,12,19,0,5,1,2,0.32,0.303,0.45,0.2239,11,203,214,214,True
8285,2011-12-16,4,0,12,20,0,5,1,2,0.32,0.3182,0.45,0.194,6,146,152,152,True
8286,2011-12-16,4,0,12,21,0,5,1,2,0.32,0.3182,0.45,0.1642,7,95,102,102,True
8287,2011-12-16,4,0,12,22,0,5,1,2,0.3,0.303,0.49,0.1642,6,100,106,106,True
8288,2011-12-16,4,0,12,23,0,5,1,2,0.3,0.303,0.49,0.1343,4,71,75,75,True
8289,2011-12-17,4,0,12,0,0,6,0,1,0.3,0.2879,0.49,0.2836,3,59,62,62,True
8290,2011-12-17,4,0,12,1,0,6,0,2,0.3,0.2879,0.52,0.2537,4,39,43,43,True
8291,2011-12-17,4,0,12,2,0,6,0,2,0.28,0.2727,0.56,0.2239,11,47,58,58,True
8292,2011-12-17,4,0,12,3,0,6,0,1,0.26,0.2576,0.6,0.194,4,22,26,26,True
8293,2011-12-17,4,0,12,4,0,6,0,1,0.24,0.2424,0.65,0.1642,0,9,9,9,True
8294,2011-12-17,4,0,12,5,0,6,0,2,0.26,0.2576,0.6,0.194,2,7,9,9,True
8295,2011-12-17,4,0,12,6,0,6,0,2,0.26,0.2424,0.56,0.2836,0,17,17,17,True
8296,2011-12-17,4,0,12,7,0,6,0,2,0.26,0.2576,0.56,0.2239,0,20,20,20,True
8297,2011-12-17,4,0,12,8,0,6,0,2,0.26,0.2576,0.56,0.2239,4,55,59,59,True
8298,2011-12-17,4,0,12,9,0,6,0,2,0.26,0.2424,0.56,0.2537,5,95,100,100,True
8299,2011-12-17,4,0,12,10,0,6,0,2,0.26,0.2424,0.52,0.2836,10,171,181,181,True
8300,2011-12-17,4,0,12,11,0,6,0,2,0.28,0.2576,0.45,0.3284,21,188,209,209,True
8301,2011-12-17,4,0,12,12,0,6,0,2,0.28,0.2576,0.45,0.2836,28,216,244,244,True
8302,2011-12-17,4,0,12,13,0,6,0,2,0.28,0.2727,0.48,0.2537,32,204,236,236,True
8303,2011-12-17,4,0,12,14,0,6,0,1,0.28,0.2576,0.45,0.3582,30,207,237,237,True
8304,2011-12-17,4,0,12,15,0,6,0,1,0.28,0.2576,0.45,0.2836,33,195,228,228,True
8305,2011-12-17,4,0,12,16,0,6,0,1,0.28,0.2727,0.45,0.2239,30,192,222,222,True
8306,2011-12-17,4,0,12,17,0,6,0,1,0.26,0.2576,0.48,0.2239,12,153,165,165,True
8307,2011-12-17,4,0,12,18,0,6,0,1,0.26,0.2273,0.48,0.3881,7,150,157,157,True
8308,2011-12-17,4,0,12,19,0,6,0,3,0.24,0.2121,0.65,0.3284,11,95,106,106,True
8309,2011-12-17,4,0,12,20,0,6,0,1,0.22,0.2121,0.69,0.2537,7,99,106,106,True
8310,2011-12-17,4,0,12,21,0,6,0,1,0.2,0.2121,0.75,0.1642,8,88,96,96,True
8311,2011-12-17,4,0,12,22,0,6,0,1,0.2,0.2121,0.75,0.1642,7,73,80,80,True
8312,2011-12-17,4,0,12,23,0,6,0,1,0.2,0.2273,0.75,0.0,6,63,69,69,True
8313,2011-12-18,4,0,12,0,0,0,0,1,0.2,0.2121,0.75,0.1343,7,64,71,71,True
8314,2011-12-18,4,0,12,1,0,0,0,1,0.2,0.2273,0.69,0.1045,3,43,46,46,True
8315,2011-12-18,4,0,12,2,0,0,0,1,0.22,0.2424,0.55,0.1045,2,39,41,41,True
8316,2011-12-18,4,0,12,3,0,0,0,1,0.22,0.2121,0.55,0.2239,2,16,18,18,True
8317,2011-12-18,4,0,12,4,0,0,0,1,0.22,0.2121,0.55,0.2239,0,1,1,1,True
8318,2011-12-18,4,0,12,5,0,0,0,1,0.2,0.2273,0.59,0.1045,1,4,5,5,True
8319,2011-12-18,4,0,12,6,0,0,0,1,0.2,0.2121,0.59,0.1343,0,3,3,3,True
8320,2011-12-18,4,0,12,7,0,0,0,1,0.2,0.2121,0.59,0.1642,1,11,12,12,True
8321,2011-12-18,4,0,12,8,0,0,0,1,0.2,0.2576,0.69,0.0,1,31,32,32,True
8322,2011-12-18,4,0,12,9,0,0,0,1,0.22,0.2273,0.64,0.1642,6,75,81,81,True
8323,2011-12-18,4,0,12,10,0,0,0,1,0.24,0.2273,0.6,0.2537,7,122,129,129,True
8324,2011-12-18,4,0,12,11,0,0,0,2,0.24,0.2273,0.6,0.2239,20,168,188,188,True
8325,2011-12-18,4,0,12,12,0,0,0,1,0.26,0.2576,0.6,0.2239,26,202,228,228,True
8326,2011-12-18,4,0,12,13,0,0,0,1,0.3,0.2727,0.49,0.2985,18,210,228,228,True
8327,2011-12-18,4,0,12,14,0,0,0,1,0.3,0.2879,0.49,0.2836,19,200,219,219,True
8328,2011-12-18,4,0,12,15,0,0,0,1,0.32,0.303,0.45,0.2836,23,184,207,207,True
8329,2011-12-18,4,0,12,16,0,0,0,1,0.28,0.2727,0.48,0.2537,27,207,234,234,True
8330,2011-12-18,4,0,12,17,0,0,0,1,0.28,0.2727,0.46,0.1642,10,126,136,136,True
8331,2011-12-18,4,0,12,18,0,0,0,1,0.28,0.2727,0.45,0.194,15,123,138,138,True
8332,2011-12-18,4,0,12,19,0,0,0,1,0.26,0.2727,0.52,0.1343,5,130,135,135,True
8333,2011-12-18,4,0,12,20,0,0,0,1,0.24,0.2576,0.6,0.1045,10,94,104,104,True
8334,2011-12-18,4,0,12,21,0,0,0,1,0.22,0.2727,0.64,0.0,9,80,89,89,True
8335,2011-12-18,4,0,12,22,0,0,0,1,0.22,0.2273,0.75,0.194,2,47,49,49,True
8336,2011-12-18,4,0,12,23,0,0,0,1,0.2,0.2273,0.75,0.1045,6,31,37,37,True
8337,2011-12-19,4,0,12,0,0,1,1,1,0.2,0.2273,0.75,0.0896,3,14,17,17,True
8338,2011-12-19,4,0,12,1,0,1,1,1,0.18,0.2121,0.8,0.0896,3,8,11,11,True
8339,2011-12-19,4,0,12,2,0,1,1,1,0.18,0.2121,0.8,0.0896,0,3,3,3,True
8340,2011-12-19,4,0,12,3,0,1,1,1,0.16,0.197,0.86,0.0896,0,3,3,3,True
8341,2011-12-19,4,0,12,4,0,1,1,1,0.16,0.1818,0.86,0.1343,0,4,4,4,True
8342,2011-12-19,4,0,12,5,0,1,1,1,0.14,0.1667,0.93,0.1045,0,21,21,21,True
8343,2011-12-19,4,0,12,6,0,1,1,1,0.16,0.1818,0.86,0.1045,0,68,68,68,True
8344,2011-12-19,4,0,12,7,0,1,1,1,0.18,0.2121,0.74,0.1045,4,187,191,191,True
8345,2011-12-19,4,0,12,8,0,1,1,1,0.2,0.197,0.75,0.194,8,389,397,397,True
8346,2011-12-19,4,0,12,9,0,1,1,1,0.22,0.2121,0.69,0.2239,17,166,183,183,True
8347,2011-12-19,4,0,12,10,0,1,1,1,0.24,0.2273,0.67,0.194,12,96,108,108,True
8348,2011-12-19,4,0,12,11,0,1,1,1,0.26,0.2424,0.65,0.2537,22,105,127,127,True
8349,2011-12-19,4,0,12,12,0,1,1,1,0.3,0.2727,0.61,0.3284,13,128,141,141,True
8350,2011-12-19,4,0,12,13,0,1,1,1,0.34,0.303,0.49,0.3284,15,127,142,142,True
8351,2011-12-19,4,0,12,14,0,1,1,1,0.36,0.3485,0.46,0.2239,30,107,137,137,True
8352,2011-12-19,4,0,12,15,0,1,1,1,0.38,0.3939,0.46,0.1642,24,135,159,159,True
8353,2011-12-19,4,0,12,16,0,1,1,1,0.4,0.4091,0.4,0.2537,19,189,208,208,True
8354,2011-12-19,4,0,12,17,0,1,1,1,0.38,0.3939,0.46,0.194,16,362,378,378,True
8355,2011-12-19,4,0,12,18,0,1,1,1,0.36,0.3485,0.5,0.194,11,343,354,354,True
8356,2011-12-19,4,0,12,19,0,1,1,2,0.36,0.3485,0.53,0.1642,17,234,251,251,True
8357,2011-12-19,4,0,12,20,0,1,1,1,0.4,0.4091,0.4,0.1642,9,197,206,206,True
8358,2011-12-19,4,0,12,21,0,1,1,2,0.36,0.3485,0.53,0.1343,15,112,127,127,True
8359,2011-12-19,4,0,12,22,0,1,1,2,0.36,0.3485,0.57,0.1642,12,95,107,107,True
8360,2011-12-19,4,0,12,23,0,1,1,1,0.36,0.3485,0.53,0.1642,10,50,60,60,True
8361,2011-12-20,4,0,12,0,0,2,1,1,0.36,0.3636,0.57,0.1045,0,21,21,21,True
8362,2011-12-20,4,0,12,1,0,2,1,1,0.36,0.3788,0.53,0.0,0,6,6,6,True
8363,2011-12-20,4,0,12,2,0,2,1,2,0.34,0.3636,0.61,0.0,1,10,11,11,True
8364,2011-12-20,4,0,12,3,0,2,1,2,0.34,0.3636,0.61,0.0,1,1,2,2,True
8365,2011-12-20,4,0,12,4,0,2,1,2,0.36,0.3636,0.53,0.1045,0,4,4,4,True
8366,2011-12-20,4,0,12,5,0,2,1,2,0.36,0.3788,0.57,0.0,0,15,15,15,True
8367,2011-12-20,4,0,12,6,0,2,1,2,0.36,0.3788,0.57,0.0,1,71,72,72,True
8368,2011-12-20,4,0,12,7,0,2,1,2,0.36,0.3788,0.62,0.0,7,261,268,268,True
8369,2011-12-20,4,0,12,8,0,2,1,2,0.42,0.4242,0.54,0.0896,10,422,432,432,True
8370,2011-12-20,4,0,12,9,0,2,1,2,0.36,0.3788,0.66,0.0,14,245,259,259,True
8371,2011-12-20,4,0,12,10,0,2,1,2,0.42,0.4242,0.58,0.194,20,109,129,129,True
8372,2011-12-20,4,0,12,11,0,2,1,2,0.4,0.4091,0.62,0.1642,13,116,129,129,True
8373,2011-12-20,4,0,12,12,0,2,1,2,0.44,0.4394,0.54,0.1343,16,159,175,175,True
8374,2011-12-20,4,0,12,13,0,2,1,2,0.44,0.4394,0.54,0.1343,18,163,181,181,True
8375,2011-12-20,4,0,12,14,0,2,1,2,0.44,0.4394,0.58,0.1045,11,127,138,138,True
8376,2011-12-20,4,0,12,15,0,2,1,2,0.44,0.4394,0.54,0.0,15,139,154,154,True
8377,2011-12-20,4,0,12,16,0,2,1,1,0.44,0.4394,0.54,0.0,20,218,238,238,True
8378,2011-12-20,4,0,12,17,0,2,1,1,0.4,0.4091,0.62,0.1642,14,417,431,431,True
8379,2011-12-20,4,0,12,18,0,2,1,1,0.38,0.3939,0.66,0.194,26,385,411,411,True
8380,2011-12-20,4,0,12,19,0,2,1,1,0.38,0.3939,0.66,0.0,6,218,224,224,True
8381,2011-12-20,4,0,12,20,0,2,1,1,0.36,0.3788,0.66,0.0,3,144,147,147,True
8382,2011-12-20,4,0,12,21,0,2,1,1,0.36,0.3636,0.66,0.0896,4,139,143,143,True
8383,2011-12-20,4,0,12,22,0,2,1,2,0.36,0.3788,0.66,0.0,3,104,107,107,True
8384,2011-12-20,4,0,12,23,0,2,1,2,0.38,0.3939,0.62,0.0,13,40,53,53,True
8385,2011-12-21,1,0,12,0,0,3,1,2,0.34,0.3333,0.71,0.1343,7,18,25,25,True
8386,2011-12-21,1,0,12,1,0,3,1,2,0.36,0.3636,0.66,0.1045,1,10,11,11,True
8387,2011-12-21,1,0,12,2,0,3,1,2,0.36,0.3788,0.71,0.0,0,4,4,4,True
8388,2011-12-21,1,0,12,3,0,3,1,2,0.36,0.3788,0.71,0.0,0,2,2,2,True
8389,2011-12-21,1,0,12,4,0,3,1,2,0.36,0.3788,0.71,0.0,0,2,2,2,True
8390,2011-12-21,1,0,12,5,0,3,1,2,0.38,0.3939,0.82,0.1045,0,28,28,28,True
8391,2011-12-21,1,0,12,6,0,3,1,2,0.36,0.3788,0.87,0.0,1,75,76,76,True
8392,2011-12-21,1,0,12,7,0,3,1,2,0.36,0.3636,0.87,0.1045,5,224,229,229,True
8393,2011-12-21,1,0,12,8,0,3,1,3,0.36,0.3788,0.93,0.0,12,393,405,405,True
8394,2011-12-21,1,0,12,9,0,3,1,2,0.4,0.4091,0.87,0.2239,14,220,234,234,True
8395,2011-12-21,1,0,12,10,0,3,1,2,0.48,0.4697,0.82,0.4179,6,83,89,89,True
8396,2011-12-21,1,0,12,11,0,3,1,2,0.48,0.4697,0.82,0.4179,3,53,56,56,True
8397,2011-12-21,1,0,12,12,0,3,1,3,0.46,0.4545,0.88,0.3881,3,58,61,61,True
8398,2011-12-21,1,0,12,13,0,3,1,3,0.44,0.4394,0.94,0.2985,3,55,58,58,True
8399,2011-12-21,1,0,12,14,0,3,1,2,0.48,0.4697,0.88,0.3582,11,40,51,51,True
8400,2011-12-21,1,0,12,15,0,3,1,2,0.48,0.4697,0.88,0.3881,4,57,61,61,True
8401,2011-12-21,1,0,12,16,0,3,1,3,0.44,0.4394,1.0,0.3284,6,95,101,101,True
8402,2011-12-21,1,0,12,17,0,3,1,3,0.44,0.4394,1.0,0.3284,3,226,229,229,True
8403,2011-12-21,1,0,12,18,0,3,1,2,0.44,0.4394,1.0,0.2985,2,278,280,280,True
8404,2011-12-21,1,0,12,19,0,3,1,2,0.5,0.4848,0.94,0.3284,9,200,209,209,True
8405,2011-12-21,1,0,12,20,0,3,1,2,0.5,0.4848,0.94,0.3582,5,162,167,167,True
8406,2011-12-21,1,0,12,21,0,3,1,1,0.5,0.4848,0.88,0.2836,9,114,123,123,True
8407,2011-12-21,1,0,12,22,0,3,1,1,0.5,0.4848,0.88,0.2537,3,102,105,105,True
8408,2011-12-21,1,0,12,23,0,3,1,1,0.5,0.4848,0.88,0.194,0,54,54,54,True
8409,2011-12-22,1,0,12,0,0,4,1,2,0.5,0.4848,0.82,0.1045,3,24,27,27,True
8410,2011-12-22,1,0,12,1,0,4,1,1,0.44,0.4394,0.94,0.0896,0,15,15,15,True
8411,2011-12-22,1,0,12,2,0,4,1,1,0.48,0.4697,0.82,0.1045,1,10,11,11,True
8412,2011-12-22,1,0,12,3,0,4,1,1,0.44,0.4394,0.67,0.1642,0,6,6,6,True
8413,2011-12-22,1,0,12,4,0,4,1,1,0.38,0.3939,0.82,0.1343,0,3,3,3,True
8414,2011-12-22,1,0,12,5,0,4,1,1,0.38,0.3939,0.82,0.0,1,15,16,16,True
8415,2011-12-22,1,0,12,6,0,4,1,1,0.36,0.3788,0.87,0.0,1,63,64,64,True
8416,2011-12-22,1,0,12,7,0,4,1,1,0.34,0.3636,0.93,0.0,4,182,186,186,True
8417,2011-12-22,1,0,12,8,0,4,1,2,0.36,0.3788,0.87,0.0,10,333,343,343,True
8418,2011-12-22,1,0,12,9,0,4,1,2,0.38,0.3939,0.87,0.0896,10,218,228,228,True
8419,2011-12-22,1,0,12,10,0,4,1,2,0.4,0.4091,0.82,0.0896,13,128,141,141,True
8420,2011-12-22,1,0,12,11,0,4,1,2,0.44,0.4394,0.77,0.0,10,135,145,145,True
8421,2011-12-22,1,0,12,12,0,4,1,2,0.48,0.4697,0.55,0.0,22,180,202,202,True
8422,2011-12-22,1,0,12,13,0,4,1,2,0.46,0.4545,0.63,0.0,21,167,188,188,True
8423,2011-12-22,1,0,12,14,0,4,1,2,0.46,0.4545,0.63,0.0,23,136,159,159,True
8424,2011-12-22,1,0,12,15,0,4,1,2,0.48,0.4697,0.59,0.0,28,186,214,214,True
8425,2011-12-22,1,0,12,16,0,4,1,2,0.46,0.4545,0.63,0.0,30,226,256,256,True
8426,2011-12-22,1,0,12,17,0,4,1,2,0.44,0.4394,0.67,0.1642,24,332,356,356,True
8427,2011-12-22,1,0,12,18,0,4,1,2,0.44,0.4394,0.62,0.0896,11,277,288,288,True
8428,2011-12-22,1,0,12,19,0,4,1,2,0.44,0.4394,0.62,0.0,12,130,142,142,True
8429,2011-12-22,1,0,12,20,0,4,1,3,0.42,0.4242,0.71,0.0,0,33,33,33,True
8430,2011-12-22,1,0,12,21,0,4,1,3,0.42,0.4242,0.71,0.0,2,15,17,17,True
8431,2011-12-22,1,0,12,22,0,4,1,3,0.36,0.3636,0.93,0.1045,0,17,17,17,True
8432,2011-12-22,1,0,12,23,0,4,1,3,0.4,0.4091,0.87,0.0,1,10,11,11,True
8433,2011-12-23,1,0,12,0,0,5,1,3,0.4,0.4091,0.87,0.194,2,7,9,9,True
8434,2011-12-23,1,0,12,1,0,5,1,3,0.4,0.4091,0.87,0.194,1,11,12,12,True
8435,2011-12-23,1,0,12,2,0,5,1,3,0.38,0.3939,0.94,0.1343,1,12,13,13,True
8436,2011-12-23,1,0,12,3,0,5,1,3,0.38,0.3939,0.94,0.1343,0,4,4,4,True
8437,2011-12-23,1,0,12,4,0,5,1,3,0.38,0.3939,0.94,0.2836,0,2,2,2,True
8438,2011-12-23,1,0,12,5,0,5,1,1,0.36,0.3485,0.93,0.194,0,8,8,8,True
8439,2011-12-23,1,0,12,6,0,5,1,1,0.38,0.3939,0.82,0.2537,0,40,40,40,True
8440,2011-12-23,1,0,12,7,0,5,1,1,0.38,0.3939,0.82,0.2239,4,88,92,92,True
8441,2011-12-23,1,0,12,8,0,5,1,1,0.4,0.4091,0.76,0.2537,9,173,182,182,True
8442,2011-12-23,1,0,12,9,0,5,1,1,0.4,0.4091,0.66,0.2985,4,152,156,156,True
8443,2011-12-23,1,0,12,10,0,5,1,1,0.4,0.4091,0.62,0.3582,8,96,104,104,True
8444,2011-12-23,1,0,12,11,0,5,1,1,0.4,0.4091,0.58,0.4478,26,148,174,174,True
8445,2011-12-23,1,0,12,12,0,5,1,1,0.4,0.4091,0.54,0.4775,14,156,170,170,True
8446,2011-12-23,1,0,12,13,0,5,1,1,0.4,0.4091,0.5,0.4627,17,177,194,194,True
8447,2011-12-23,1,0,12,14,0,5,1,1,0.4,0.4091,0.54,0.4179,23,177,200,200,True
8448,2011-12-23,1,0,12,15,0,5,1,1,0.38,0.3939,0.54,0.3582,12,191,203,203,True
8449,2011-12-23,1,0,12,16,0,5,1,1,0.38,0.3939,0.5,0.2985,15,166,181,181,True
8450,2011-12-23,1,0,12,17,0,5,1,1,0.36,0.3485,0.53,0.2239,11,129,140,140,True
8451,2011-12-23,1,0,12,18,0,5,1,1,0.36,0.3333,0.5,0.2537,4,91,95,95,True
8452,2011-12-23,1,0,12,19,0,5,1,1,0.34,0.3333,0.53,0.194,1,75,76,76,True
8453,2011-12-23,1,0,12,20,0,5,1,1,0.32,0.303,0.61,0.3284,3,47,50,50,True
8454,2011-12-23,1,0,12,21,0,5,1,1,0.32,0.303,0.61,0.2239,0,32,32,32,True
8455,2011-12-23,1,0,12,22,0,5,1,1,0.32,0.3182,0.66,0.194,4,43,47,47,True
8456,2011-12-23,1,0,12,23,0,5,1,1,0.32,0.3333,0.66,0.1343,4,21,25,25,True
8457,2011-12-24,1,0,12,0,0,6,0,2,0.32,0.3182,0.7,0.1642,3,20,23,23,True
8458,2011-12-24,1,0,12,1,0,6,0,2,0.32,0.3485,0.66,0.0,1,15,16,16,True
8459,2011-12-24,1,0,12,2,0,6,0,2,0.32,0.3333,0.66,0.0896,4,22,26,26,True
8460,2011-12-24,1,0,12,3,0,6,0,2,0.32,0.3333,0.7,0.0896,0,5,5,5,True
8461,2011-12-24,1,0,12,4,0,6,0,2,0.32,0.3182,0.66,0.1642,0,3,3,3,True
8462,2011-12-24,1,0,12,5,0,6,0,2,0.32,0.3182,0.66,0.1642,1,3,4,4,True
8463,2011-12-24,1,0,12,6,0,6,0,2,0.3,0.303,0.75,0.1642,0,10,10,10,True
8464,2011-12-24,1,0,12,7,0,6,0,1,0.3,0.2727,0.7,0.3582,0,10,10,10,True
8465,2011-12-24,1,0,12,8,0,6,0,1,0.28,0.2727,0.7,0.194,0,27,27,27,True
8466,2011-12-24,1,0,12,9,0,6,0,1,0.3,0.2727,0.45,0.4179,3,53,56,56,True
8467,2011-12-24,1,0,12,10,0,6,0,1,0.3,0.2576,0.42,0.4775,4,52,56,56,True
8468,2011-12-24,1,0,12,11,0,6,0,1,0.32,0.2879,0.39,0.3582,9,62,71,71,True
8469,2011-12-24,1,0,12,12,0,6,0,1,0.34,0.3182,0.39,0.2836,15,79,94,94,True
8470,2011-12-24,1,0,12,13,0,6,0,1,0.34,0.303,0.39,0.2985,24,97,121,121,True
8471,2011-12-24,1,0,12,14,0,6,0,1,0.34,0.303,0.39,0.2985,15,70,85,85,True
8472,2011-12-24,1,0,12,15,0,6,0,1,0.32,0.303,0.39,0.2239,15,82,97,97,True
8473,2011-12-24,1,0,12,16,0,6,0,1,0.32,0.3182,0.42,0.194,25,74,99,99,True
8474,2011-12-24,1,0,12,17,0,6,0,1,0.28,0.2879,0.45,0.1343,15,53,68,68,True
8475,2011-12-24,1,0,12,18,0,6,0,1,0.3,0.3182,0.42,0.0896,2,33,35,35,True
8476,2011-12-24,1,0,12,19,0,6,0,1,0.3,0.3182,0.52,0.0896,1,24,25,25,True
8477,2011-12-24,1,0,12,20,0,6,0,1,0.26,0.2727,0.56,0.1343,5,19,24,24,True
8478,2011-12-24,1,0,12,21,0,6,0,1,0.26,0.2576,0.56,0.1642,4,15,19,19,True
8479,2011-12-24,1,0,12,22,0,6,0,1,0.24,0.2879,0.52,0.0,8,12,20,20,True
8480,2011-12-24,1,0,12,23,0,6,0,1,0.24,0.2576,0.56,0.0,1,16,17,17,True
8481,2011-12-25,1,0,12,0,0,0,0,1,0.24,0.2273,0.6,0.194,2,4,6,6,True
8482,2011-12-25,1,0,12,1,0,0,0,1,0.22,0.2273,0.69,0.1343,2,2,4,4,True
8483,2011-12-25,1,0,12,2,0,0,0,1,0.22,0.2576,0.75,0.0896,0,2,2,2,True
8484,2011-12-25,1,0,12,3,0,0,0,1,0.22,0.2727,0.72,0.0,1,3,4,4,True
8485,2011-12-25,1,0,12,5,0,0,0,1,0.2,0.2273,0.75,0.1045,0,1,1,1,True
8486,2011-12-25,1,0,12,6,0,0,0,1,0.2,0.2273,0.75,0.1045,0,1,1,1,True
8487,2011-12-25,1,0,12,7,0,0,0,1,0.22,0.2424,0.8,0.1045,0,4,4,4,True
8488,2011-12-25,1,0,12,8,0,0,0,1,0.2,0.2121,0.8,0.1642,1,4,5,5,True
8489,2011-12-25,1,0,12,9,0,0,0,1,0.24,0.2424,0.87,0.1642,3,20,23,23,True
8490,2011-12-25,1,0,12,10,0,0,0,1,0.26,0.2424,0.81,0.2537,31,12,43,43,True
8491,2011-12-25,1,0,12,11,0,0,0,1,0.3,0.303,0.7,0.1642,43,42,85,85,True
8492,2011-12-25,1,0,12,12,0,0,0,1,0.3,0.2727,0.75,0.2985,25,41,66,66,True
8493,2011-12-25,1,0,12,13,0,0,0,1,0.32,0.303,0.7,0.2537,40,39,79,79,True
8494,2011-12-25,1,0,12,14,0,0,0,1,0.34,0.3182,0.61,0.2537,41,45,86,86,True
8495,2011-12-25,1,0,12,15,0,0,0,1,0.34,0.3333,0.61,0.194,43,48,91,91,True
8496,2011-12-25,1,0,12,16,0,0,0,1,0.36,0.3636,0.57,0.1045,35,51,86,86,True
8497,2011-12-25,1,0,12,17,0,0,0,1,0.34,0.3333,0.61,0.1343,11,33,44,44,True
8498,2011-12-25,1,0,12,18,0,0,0,1,0.32,0.3182,0.7,0.194,7,23,30,30,True
8499,2011-12-25,1,0,12,19,0,0,0,1,0.32,0.3333,0.57,0.1343,2,14,16,16,True
8500,2011-12-25,1,0,12,20,0,0,0,1,0.32,0.3333,0.49,0.0896,8,18,26,26,True
8501,2011-12-25,1,0,12,21,0,0,0,1,0.3,0.303,0.56,0.1343,4,15,19,19,True
8502,2011-12-25,1,0,12,22,0,0,0,1,0.28,0.2727,0.61,0.1642,2,15,17,17,True
8503,2011-12-25,1,0,12,23,0,0,0,1,0.26,0.2727,0.65,0.1343,2,14,16,16,True
8504,2011-12-26,1,0,12,0,1,1,0,1,0.22,0.2273,0.75,0.1642,5,6,11,11,True
8505,2011-12-26,1,0,12,1,1,1,0,1,0.28,0.2727,0.56,0.194,3,7,10,10,True
8506,2011-12-26,1,0,12,2,1,1,0,1,0.34,0.3182,0.46,0.2239,2,5,7,7,True
8507,2011-12-26,1,0,12,4,1,1,0,1,0.34,0.303,0.46,0.2985,0,2,2,2,True
8508,2011-12-26,1,0,12,5,1,1,0,1,0.34,0.303,0.42,0.3881,0,4,4,4,True
8509,2011-12-26,1,0,12,6,1,1,0,1,0.32,0.303,0.45,0.2836,0,4,4,4,True
8510,2011-12-26,1,0,12,7,1,1,0,1,0.32,0.3182,0.45,0.194,2,17,19,19,True
8511,2011-12-26,1,0,12,8,1,1,0,1,0.32,0.3333,0.45,0.1343,5,13,18,18,True
8512,2011-12-26,1,0,12,9,1,1,0,1,0.34,0.303,0.46,0.2985,24,38,62,62,True
8513,2011-12-26,1,0,12,10,1,1,0,1,0.34,0.2879,0.42,0.4775,31,39,70,70,True
8514,2011-12-26,1,0,12,11,1,1,0,1,0.34,0.2879,0.46,0.4775,40,51,91,91,True
8515,2011-12-26,1,0,12,12,1,1,0,1,0.36,0.3182,0.43,0.4627,34,66,100,100,True
8516,2011-12-26,1,0,12,13,1,1,0,1,0.38,0.3939,0.4,0.2985,57,83,140,140,True
8517,2011-12-26,1,0,12,14,1,1,0,1,0.38,0.3939,0.4,0.3284,73,80,153,153,True
8518,2011-12-26,1,0,12,15,1,1,0,1,0.38,0.3939,0.4,0.2537,26,105,131,131,True
8519,2011-12-26,1,0,12,16,1,1,0,1,0.36,0.3333,0.43,0.2836,28,69,97,97,True
8520,2011-12-26,1,0,12,17,1,1,0,1,0.34,0.3182,0.46,0.2239,30,67,97,97,True
8521,2011-12-26,1,0,12,18,1,1,0,1,0.32,0.3333,0.49,0.0896,21,54,75,75,True
8522,2011-12-26,1,0,12,19,1,1,0,1,0.3,0.3182,0.65,0.0896,16,49,65,65,True
8523,2011-12-26,1,0,12,20,1,1,0,1,0.3,0.3182,0.56,0.0896,14,42,56,56,True
8524,2011-12-26,1,0,12,21,1,1,0,1,0.26,0.303,0.7,0.0,10,39,49,49,True
8525,2011-12-26,1,0,12,22,1,1,0,1,0.26,0.303,0.7,0.0,5,22,27,27,True
8526,2011-12-26,1,0,12,23,1,1,0,1,0.26,0.2727,0.7,0.1045,4,25,29,29,True
8527,2011-12-27,1,0,12,0,0,2,1,1,0.26,0.2576,0.7,0.1642,3,9,12,12,True
8528,2011-12-27,1,0,12,1,0,2,1,1,0.26,0.2727,0.7,0.1343,0,6,6,6,True
8529,2011-12-27,1,0,12,2,0,2,1,1,0.26,0.2727,0.7,0.1343,2,2,4,4,True
8530,2011-12-27,1,0,12,3,0,2,1,2,0.3,0.2879,0.61,0.2239,0,3,3,3,True
8531,2011-12-27,1,0,12,4,0,2,1,2,0.3,0.2879,0.65,0.2239,0,3,3,3,True
8532,2011-12-27,1,0,12,5,0,2,1,2,0.3,0.2727,0.64,0.2836,0,8,8,8,True
8533,2011-12-27,1,0,12,6,0,2,1,2,0.3,0.2727,0.61,0.2985,0,35,35,35,True
8534,2011-12-27,1,0,12,7,0,2,1,2,0.3,0.2879,0.65,0.2836,1,79,80,80,True
8535,2011-12-27,1,0,12,8,0,2,1,2,0.3,0.303,0.65,0.1642,9,155,164,164,True
8536,2011-12-27,1,0,12,9,0,2,1,3,0.32,0.3333,0.66,0.1045,19,85,104,104,True
8537,2011-12-27,1,0,12,10,0,2,1,2,0.32,0.3333,0.66,0.0896,13,47,60,60,True
8538,2011-12-27,1,0,12,11,0,2,1,3,0.32,0.3333,0.66,0.1045,6,24,30,30,True
8539,2011-12-27,1,0,12,12,0,2,1,3,0.3,0.3182,0.81,0.0896,8,16,24,24,True
8540,2011-12-27,1,0,12,13,0,2,1,3,0.3,0.303,0.87,0.1343,1,19,20,20,True
8541,2011-12-27,1,0,12,14,0,2,1,3,0.42,0.4242,0.82,0.3881,0,14,14,14,True
8542,2011-12-27,1,0,12,15,0,2,1,3,0.42,0.4242,0.82,0.3881,2,17,19,19,True
8543,2011-12-27,1,0,12,16,0,2,1,3,0.44,0.4394,0.88,0.3284,2,44,46,46,True
8544,2011-12-27,1,0,12,17,0,2,1,3,0.4,0.4091,0.87,0.1343,6,109,115,115,True
8545,2011-12-27,1,0,12,18,0,2,1,1,0.38,0.3939,0.87,0.2836,9,126,135,135,True
8546,2011-12-27,1,0,12,19,0,2,1,1,0.34,0.3333,0.87,0.1642,3,87,90,90,True
8547,2011-12-27,1,0,12,20,0,2,1,1,0.32,0.3333,0.93,0.0896,3,66,69,69,True
8548,2011-12-27,1,0,12,21,0,2,1,1,0.32,0.3333,0.87,0.0896,11,52,63,63,True
8549,2011-12-27,1,0,12,22,0,2,1,1,0.32,0.3333,0.87,0.0896,3,29,32,32,True
8550,2011-12-27,1,0,12,23,0,2,1,1,0.3,0.303,0.93,0.1343,2,24,26,26,True
8551,2011-12-28,1,0,12,0,0,3,1,1,0.32,0.3182,0.87,0.1642,0,10,10,10,True
8552,2011-12-28,1,0,12,1,0,3,1,1,0.32,0.3182,0.76,0.1642,0,12,12,12,True
8553,2011-12-28,1,0,12,2,0,3,1,1,0.32,0.303,0.61,0.2537,0,7,7,7,True
8554,2011-12-28,1,0,12,3,0,3,1,1,0.32,0.303,0.61,0.2537,0,4,4,4,True
8555,2011-12-28,1,0,12,5,0,3,1,1,0.32,0.2879,0.57,0.3582,0,9,9,9,True
8556,2011-12-28,1,0,12,6,0,3,1,1,0.32,0.303,0.57,0.2537,1,42,43,43,True
8557,2011-12-28,1,0,12,7,0,3,1,1,0.32,0.303,0.57,0.2537,4,106,110,110,True
8558,2011-12-28,1,0,12,8,0,3,1,1,0.32,0.2879,0.57,0.3582,11,206,217,217,True
8559,2011-12-28,1,0,12,9,0,3,1,1,0.32,0.303,0.57,0.3284,18,171,189,189,True
8560,2011-12-28,1,0,12,10,0,3,1,1,0.34,0.3182,0.57,0.2239,12,84,96,96,True
8561,2011-12-28,1,0,12,11,0,3,1,1,0.36,0.3333,0.46,0.3582,18,93,111,111,True
8562,2011-12-28,1,0,12,12,0,3,1,1,0.34,0.2879,0.46,0.4775,32,108,140,140,True
8563,2011-12-28,1,0,12,13,0,3,1,1,0.34,0.2879,0.39,0.4627,24,135,159,159,True
8564,2011-12-28,1,0,12,14,0,3,1,1,0.32,0.2879,0.39,0.3881,24,96,120,120,True
8565,2011-12-28,1,0,12,15,0,3,1,1,0.32,0.2879,0.36,0.4179,16,101,117,117,True
8566,2011-12-28,1,0,12,16,0,3,1,1,0.3,0.2727,0.36,0.4179,23,144,167,167,True
8567,2011-12-28,1,0,12,17,0,3,1,1,0.28,0.2727,0.38,0.2537,25,225,250,250,True
8568,2011-12-28,1,0,12,18,0,3,1,1,0.26,0.2273,0.38,0.3284,10,159,169,169,True
8569,2011-12-28,1,0,12,19,0,3,1,1,0.24,0.2273,0.41,0.2537,16,135,151,151,True
8570,2011-12-28,1,0,12,20,0,3,1,1,0.24,0.2273,0.41,0.2239,9,70,79,79,True
8571,2011-12-28,1,0,12,21,0,3,1,1,0.22,0.2273,0.44,0.1343,7,63,70,70,True
8572,2011-12-28,1,0,12,22,0,3,1,1,0.22,0.2424,0.44,0.1045,2,31,33,33,True
8573,2011-12-28,1,0,12,23,0,3,1,1,0.22,0.2121,0.44,0.2537,3,36,39,39,True
8574,2011-12-29,1,0,12,0,0,4,1,2,0.22,0.2273,0.47,0.194,4,24,28,28,True
8575,2011-12-29,1,0,12,1,0,4,1,1,0.22,0.2121,0.47,0.2239,0,15,15,15,True
8576,2011-12-29,1,0,12,2,0,4,1,1,0.2,0.2273,0.51,0.1045,0,3,3,3,True
8577,2011-12-29,1,0,12,3,0,4,1,1,0.2,0.197,0.55,0.194,0,2,2,2,True
8578,2011-12-29,1,0,12,4,0,4,1,1,0.2,0.2121,0.55,0.1642,1,2,3,3,True
8579,2011-12-29,1,0,12,5,0,4,1,1,0.2,0.2273,0.55,0.1045,0,10,10,10,True
8580,2011-12-29,1,0,12,6,0,4,1,1,0.2,0.2576,0.59,0.0,2,39,41,41,True
8581,2011-12-29,1,0,12,7,0,4,1,1,0.18,0.2121,0.64,0.0896,2,104,106,106,True
8582,2011-12-29,1,0,12,8,0,4,1,2,0.2,0.2576,0.64,0.0,3,207,210,210,True
8583,2011-12-29,1,0,12,9,0,4,1,2,0.2,0.2121,0.64,0.1343,15,155,170,170,True
8584,2011-12-29,1,0,12,10,0,4,1,2,0.22,0.2273,0.64,0.1642,13,97,110,110,True
8585,2011-12-29,1,0,12,11,0,4,1,2,0.24,0.2576,0.6,0.0896,23,99,122,122,True
8586,2011-12-29,1,0,12,12,0,4,1,2,0.26,0.2727,0.56,0.1045,12,118,130,130,True
8587,2011-12-29,1,0,12,13,0,4,1,2,0.28,0.2879,0.52,0.1045,36,95,131,131,True
8588,2011-12-29,1,0,12,14,0,4,1,2,0.3,0.3333,0.52,0.0,30,112,142,142,True
8589,2011-12-29,1,0,12,15,0,4,1,2,0.3,0.3182,0.52,0.0896,27,150,177,177,True
8590,2011-12-29,1,0,12,16,0,4,1,1,0.3,0.303,0.52,0.1642,22,155,177,177,True
8591,2011-12-29,1,0,12,17,0,4,1,1,0.3,0.303,0.61,0.1642,14,226,240,240,True
8592,2011-12-29,1,0,12,18,0,4,1,1,0.3,0.303,0.56,0.1343,15,192,207,207,True
8593,2011-12-29,1,0,12,19,0,4,1,1,0.3,0.3182,0.56,0.1045,11,124,135,135,True
8594,2011-12-29,1,0,12,20,0,4,1,1,0.28,0.2879,0.65,0.1045,8,88,96,96,True
8595,2011-12-29,1,0,12,21,0,4,1,2,0.28,0.2879,0.61,0.1343,8,60,68,68,True
8596,2011-12-29,1,0,12,22,0,4,1,1,0.28,0.2879,0.65,0.1343,7,48,55,55,True
8597,2011-12-29,1,0,12,23,0,4,1,1,0.3,0.303,0.65,0.1642,1,44,45,45,True
8598,2011-12-30,1,0,12,0,0,5,1,1,0.28,0.2879,0.7,0.1343,4,26,30,30,True
8599,2011-12-30,1,0,12,1,0,5,1,1,0.26,0.2879,0.65,0.0896,9,11,20,20,True
8600,2011-12-30,1,0,12,2,0,5,1,1,0.24,0.2576,0.7,0.1045,2,10,12,12,True
8601,2011-12-30,1,0,12,3,0,5,1,1,0.24,0.2576,0.7,0.1045,0,6,6,6,True
8602,2011-12-30,1,0,12,4,0,5,1,1,0.24,0.2576,0.7,0.0896,0,2,2,2,True
8603,2011-12-30,1,0,12,5,0,5,1,1,0.22,0.2576,0.75,0.0896,0,10,10,10,True
8604,2011-12-30,1,0,12,6,0,5,1,1,0.24,0.2576,0.7,0.0896,1,31,32,32,True
8605,2011-12-30,1,0,12,7,0,5,1,1,0.24,0.2576,0.75,0.0896,3,92,95,95,True
8606,2011-12-30,1,0,12,8,0,5,1,2,0.24,0.2576,0.75,0.0896,12,193,205,205,True
8607,2011-12-30,1,0,12,9,0,5,1,1,0.26,0.303,0.75,0.0,19,175,194,194,True
8608,2011-12-30,1,0,12,10,0,5,1,1,0.3,0.2879,0.65,0.2537,10,108,118,118,True
8609,2011-12-30,1,0,12,11,0,5,1,1,0.32,0.3182,0.66,0.194,45,126,171,171,True
8610,2011-12-30,1,0,12,12,0,5,1,1,0.32,0.3333,0.57,0.1343,38,159,197,197,True
8611,2011-12-30,1,0,12,13,0,5,1,2,0.36,0.3485,0.53,0.1343,53,154,207,207,True
8612,2011-12-30,1,0,12,14,0,5,1,2,0.4,0.4091,0.47,0.0896,67,178,245,245,True
8613,2011-12-30,1,0,12,15,0,5,1,1,0.42,0.4242,0.44,0.0,56,236,292,292,True
8614,2011-12-30,1,0,12,16,0,5,1,1,0.42,0.4242,0.47,0.194,36,247,283,283,True
8615,2011-12-30,1,0,12,17,0,5,1,1,0.38,0.3939,0.54,0.1642,54,188,242,242,True
8616,2011-12-30,1,0,12,18,0,5,1,1,0.36,0.3485,0.62,0.1343,19,163,182,182,True
8617,2011-12-30,1,0,12,19,0,5,1,2,0.34,0.303,0.49,0.4179,16,96,112,112,True
8618,2011-12-30,1,0,12,20,0,5,1,2,0.34,0.3485,0.66,0.1045,16,75,91,91,True
8619,2011-12-30,1,0,12,21,0,5,1,2,0.36,0.3636,0.66,0.1045,11,84,95,95,True
8620,2011-12-30,1,0,12,22,0,5,1,2,0.34,0.3333,0.71,0.1642,7,78,85,85,True
8621,2011-12-30,1,0,12,23,0,5,1,2,0.36,0.3333,0.66,0.2537,13,60,73,73,True
8622,2011-12-31,1,0,12,0,0,6,0,2,0.38,0.3939,0.62,0.3284,7,37,44,44,True
8623,2011-12-31,1,0,12,1,0,6,0,2,0.4,0.4091,0.62,0.2836,4,31,35,35,True
8624,2011-12-31,1,0,12,2,0,6,0,2,0.4,0.4091,0.62,0.2836,1,27,28,28,True
8625,2011-12-31,1,0,12,3,0,6,0,2,0.4,0.4091,0.62,0.2836,1,17,18,18,True
8626,2011-12-31,1,0,12,4,0,6,0,1,0.38,0.3939,0.71,0.2239,1,9,10,10,True
8627,2011-12-31,1,0,12,5,0,6,0,2,0.36,0.3485,0.76,0.2239,1,0,1,1,True
8628,2011-12-31,1,0,12,6,0,6,0,2,0.4,0.4091,0.71,0.0896,1,5,6,6,True
8629,2011-12-31,1,0,12,7,0,6,0,3,0.38,0.3939,0.76,0.0,6,13,19,19,True
8630,2011-12-31,1,0,12,8,0,6,0,1,0.34,0.3333,0.81,0.1343,7,42,49,49,True
8631,2011-12-31,1,0,12,9,0,6,0,1,0.38,0.3939,0.76,0.0,18,72,90,90,True
8632,2011-12-31,1,0,12,10,0,6,0,1,0.4,0.4091,0.76,0.1642,20,108,128,128,True
8633,2011-12-31,1,0,12,11,0,6,0,1,0.42,0.4242,0.71,0.1642,65,152,217,217,True
8634,2011-12-31,1,0,12,12,0,6,0,1,0.52,0.5,0.39,0.2985,93,180,273,273,True
8635,2011-12-31,1,0,12,13,0,6,0,1,0.5,0.4848,0.42,0.4775,108,205,313,313,True
8636,2011-12-31,1,0,12,14,0,6,0,1,0.46,0.4545,0.51,0.3284,114,185,299,299,True
8637,2011-12-31,1,0,12,15,0,6,0,1,0.46,0.4545,0.47,0.4775,89,164,253,253,True
8638,2011-12-31,1,0,12,16,0,6,0,1,0.44,0.4394,0.51,0.3881,52,143,195,195,True
8639,2011-12-31,1,0,12,17,0,6,0,1,0.42,0.4242,0.54,0.194,28,101,129,129,True
8640,2011-12-31,1,0,12,18,0,6,0,1,0.42,0.4242,0.54,0.1343,13,80,93,93,True
8641,2011-12-31,1,0,12,19,0,6,0,1,0.42,0.4242,0.54,0.2239,19,73,92,92,True
8642,2011-12-31,1,0,12,20,0,6,0,1,0.42,0.4242,0.54,0.2239,8,63,71,71,True
8643,2011-12-31,1,0,12,21,0,6,0,1,0.4,0.4091,0.58,0.194,2,50,52,52,True
8644,2011-12-31,1,0,12,22,0,6,0,1,0.38,0.3939,0.62,0.1343,2,36,38,38,True
8645,2011-12-31,1,0,12,23,0,6,0,1,0.36,0.3788,0.66,0.0,4,27,31,31,True
8646,2012-01-01,1,1,1,0,0,0,0,1,0.36,0.3788,0.66,0.0,5,43,48,48,True
8647,2012-01-01,1,1,1,1,0,0,0,1,0.36,0.3485,0.66,0.1343,15,78,93,93,True
8648,2012-01-01,1,1,1,2,0,0,0,1,0.32,0.3485,0.76,0.0,16,59,75,75,True
8649,2012-01-01,1,1,1,3,0,0,0,1,0.3,0.3333,0.81,0.0,11,41,52,52,True
8650,2012-01-01,1,1,1,4,0,0,0,1,0.28,0.303,0.81,0.0896,0,8,8,8,True
8651,2012-01-01,1,1,1,5,0,0,0,1,0.28,0.2879,0.81,0.1045,0,5,5,5,True
8652,2012-01-01,1,1,1,6,0,0,0,1,0.26,0.2727,0.93,0.1343,1,1,2,2,True
8653,2012-01-01,1,1,1,7,0,0,0,1,0.26,0.2576,0.93,0.1642,1,6,7,7,True
8654,2012-01-01,1,1,1,8,0,0,0,1,0.26,0.2727,0.87,0.1045,4,10,14,14,True
8655,2012-01-01,1,1,1,9,0,0,0,1,0.26,0.2727,0.93,0.1045,13,27,40,40,True
8656,2012-01-01,1,1,1,10,0,0,0,1,0.3,0.3182,0.81,0.1045,18,52,70,70,True
8657,2012-01-01,1,1,1,11,0,0,0,1,0.34,0.3333,0.76,0.1343,40,98,138,138,True
8658,2012-01-01,1,1,1,12,0,0,0,1,0.4,0.4091,0.62,0.2836,58,143,201,201,True
8659,2012-01-01,1,1,1,13,0,0,0,1,0.42,0.4242,0.58,0.2836,82,141,223,223,True
8660,2012-01-01,1,1,1,14,0,0,0,1,0.44,0.4394,0.54,0.2985,114,147,261,261,True
8661,2012-01-01,1,1,1,15,0,0,0,1,0.46,0.4545,0.51,0.2985,101,164,265,265,True
8662,2012-01-01,1,1,1,16,0,0,0,2,0.44,0.4394,0.54,0.2985,68,147,215,215,True
8663,2012-01-01,1,1,1,17,0,0,0,2,0.48,0.4697,0.48,0.1642,36,75,111,111,True
8664,2012-01-01,1,1,1,18,0,0,0,3,0.46,0.4545,0.59,0.2537,25,81,106,106,True
8665,2012-01-01,1,1,1,19,0,0,0,3,0.42,0.4242,0.67,0.3881,20,85,105,105,True
8666,2012-01-01,1,1,1,20,0,0,0,2,0.44,0.4394,0.62,0.2985,25,58,83,83,True
8667,2012-01-01,1,1,1,21,0,0,0,2,0.44,0.4394,0.67,0.2537,10,61,71,71,True
8668,2012-01-01,1,1,1,22,0,0,0,1,0.46,0.4545,0.55,0.4179,13,53,66,66,True
8669,2012-01-01,1,1,1,23,0,0,0,1,0.44,0.4394,0.51,0.2985,4,25,29,29,True
8670,2012-01-02,1,1,1,0,1,1,0,1,0.4,0.4091,0.4,0.4627,8,31,39,39,True
8671,2012-01-02,1,1,1,1,1,1,0,1,0.36,0.3333,0.43,0.4179,1,11,12,12,True
8672,2012-01-02,1,1,1,2,1,1,0,1,0.36,0.3182,0.34,0.4478,1,6,7,7,True
8673,2012-01-02,1,1,1,4,1,1,0,1,0.28,0.2576,0.45,0.3284,0,4,4,4,True
8674,2012-01-02,1,1,1,5,1,1,0,1,0.28,0.2576,0.45,0.3284,1,3,4,4,True
8675,2012-01-02,1,1,1,6,1,1,0,1,0.26,0.2273,0.41,0.3881,0,14,14,14,True
8676,2012-01-02,1,1,1,7,1,1,0,1,0.24,0.2121,0.32,0.3881,0,16,16,16,True
8677,2012-01-02,1,1,1,8,1,1,0,1,0.24,0.2273,0.35,0.2537,2,51,53,53,True
8678,2012-01-02,1,1,1,9,1,1,0,1,0.24,0.2576,0.35,0.0,15,53,68,68,True
8679,2012-01-02,1,1,1,10,1,1,0,1,0.26,0.2424,0.35,0.2836,20,89,109,109,True
8680,2012-01-02,1,1,1,11,1,1,0,1,0.26,0.2121,0.35,0.4775,33,142,175,175,True
8681,2012-01-02,1,1,1,12,1,1,0,1,0.28,0.2727,0.36,0.2537,41,161,202,202,True
8682,2012-01-02,1,1,1,13,1,1,0,1,0.3,0.2727,0.36,0.2985,26,150,176,176,True
8683,2012-01-02,1,1,1,14,1,1,0,1,0.3,0.2727,0.36,0.4179,10,141,151,151,True
8684,2012-01-02,1,1,1,15,1,1,0,1,0.28,0.2424,0.38,0.4478,29,139,168,168,True
8685,2012-01-02,1,1,1,16,1,1,0,1,0.26,0.2273,0.35,0.4179,10,144,154,154,True
8686,2012-01-02,1,1,1,17,1,1,0,1,0.26,0.2273,0.35,0.3881,17,136,153,153,True
8687,2012-01-02,1,1,1,18,1,1,0,1,0.26,0.2424,0.33,0.2537,13,113,126,126,True
8688,2012-01-02,1,1,1,19,1,1,0,1,0.24,0.2273,0.38,0.2239,4,89,93,93,True
8689,2012-01-02,1,1,1,20,1,1,0,1,0.24,0.2273,0.41,0.2239,5,83,88,88,True
8690,2012-01-02,1,1,1,21,1,1,0,2,0.24,0.2121,0.41,0.3284,3,63,66,66,True
8691,2012-01-02,1,1,1,22,1,1,0,2,0.22,0.2121,0.44,0.2836,3,36,39,39,True
8692,2012-01-02,1,1,1,23,1,1,0,1,0.22,0.2121,0.44,0.2537,2,32,34,34,True
8693,2012-01-03,1,1,1,0,0,2,1,1,0.2,0.197,0.51,0.2537,0,13,13,13,True
8694,2012-01-03,1,1,1,1,0,2,1,1,0.18,0.1818,0.55,0.2239,1,5,6,6,True
8695,2012-01-03,1,1,1,2,0,2,1,1,0.18,0.1667,0.51,0.2537,0,3,3,3,True
8696,2012-01-03,1,1,1,3,0,2,1,1,0.16,0.1364,0.55,0.2836,0,2,2,2,True
8697,2012-01-03,1,1,1,4,0,2,1,1,0.16,0.1515,0.55,0.2537,0,5,5,5,True
8698,2012-01-03,1,1,1,5,0,2,1,1,0.14,0.1364,0.54,0.194,0,12,12,12,True
8699,2012-01-03,1,1,1,6,0,2,1,1,0.14,0.1212,0.59,0.2836,4,81,85,85,True
8700,2012-01-03,1,1,1,7,0,2,1,1,0.14,0.1212,0.59,0.2537,2,168,170,170,True
8701,2012-01-03,1,1,1,8,0,2,1,1,0.16,0.1364,0.55,0.2836,5,349,354,354,True
8702,2012-01-03,1,1,1,9,0,2,1,1,0.16,0.1364,0.5,0.2836,8,145,153,153,True
8703,2012-01-03,1,1,1,10,0,2,1,1,0.16,0.1212,0.47,0.4627,5,55,60,60,True
8704,2012-01-03,1,1,1,11,0,2,1,1,0.18,0.1364,0.37,0.4775,12,63,75,75,True
8705,2012-01-03,1,1,1,12,0,2,1,1,0.18,0.1364,0.37,0.4775,4,70,74,74,True
8706,2012-01-03,1,1,1,13,0,2,1,1,0.18,0.1212,0.34,0.4775,5,68,73,73,True
8707,2012-01-03,1,1,1,14,0,2,1,1,0.16,0.1212,0.43,0.4775,7,72,79,79,True
8708,2012-01-03,1,1,1,15,0,2,1,1,0.16,0.1212,0.37,0.4179,9,68,77,77,True
8709,2012-01-03,1,1,1,16,0,2,1,1,0.14,0.0909,0.39,0.4775,7,129,136,136,True
8710,2012-01-03,1,1,1,17,0,2,1,1,0.14,0.1061,0.26,0.4627,4,241,245,245,True
8711,2012-01-03,1,1,1,18,0,2,1,1,0.14,0.0909,0.26,0.4775,10,214,224,224,True
8712,2012-01-03,1,1,1,19,0,2,1,1,0.12,0.0909,0.28,0.4179,4,152,156,156,True
8713,2012-01-03,1,1,1,20,0,2,1,1,0.12,0.1212,0.33,0.2537,0,115,115,115,True
8714,2012-01-03,1,1,1,21,0,2,1,1,0.1,0.1061,0.36,0.2239,2,66,68,68,True
8715,2012-01-03,1,1,1,22,0,2,1,1,0.1,0.1061,0.46,0.2537,0,33,33,33,True
8716,2012-01-03,1,1,1,23,0,2,1,1,0.1,0.0758,0.46,0.3881,0,18,18,18,True
8717,2012-01-04,1,1,1,0,0,3,1,1,0.08,0.0606,0.42,0.3284,0,9,9,9,True
8718,2012-01-04,1,1,1,1,0,3,1,1,0.04,0.0303,0.38,0.2985,0,3,3,3,True
8719,2012-01-04,1,1,1,2,0,3,1,1,0.02,0.0152,0.34,0.2836,0,1,1,1,True
8720,2012-01-04,1,1,1,3,0,3,1,1,0.02,0.0152,0.34,0.2836,0,1,1,1,True
8721,2012-01-04,1,1,1,4,0,3,1,1,0.02,0.0455,0.41,0.194,0,2,2,2,True
8722,2012-01-04,1,1,1,5,0,3,1,1,0.02,0.0455,0.41,0.194,0,14,14,14,True
8723,2012-01-04,1,1,1,6,0,3,1,1,0.02,0.0455,0.41,0.1642,0,59,59,59,True
8724,2012-01-04,1,1,1,7,0,3,1,1,0.02,0.0455,0.44,0.194,1,151,152,152,True
8725,2012-01-04,1,1,1,8,0,3,1,1,0.02,0.0606,0.44,0.1343,5,310,315,315,True
8726,2012-01-04,1,1,1,9,0,3,1,1,0.04,0.0606,0.45,0.1343,7,173,180,180,True
8727,2012-01-04,1,1,1,10,0,3,1,1,0.06,0.1061,0.45,0.0,7,57,64,64,True
8728,2012-01-04,1,1,1,11,0,3,1,2,0.08,0.1212,0.42,0.0896,6,40,46,46,True
8729,2012-01-04,1,1,1,12,0,3,1,2,0.1,0.1061,0.46,0.194,9,75,84,84,True
8730,2012-01-04,1,1,1,13,0,3,1,2,0.14,0.1212,0.43,0.2537,9,82,91,91,True
8731,2012-01-04,1,1,1,14,0,3,1,2,0.14,0.1212,0.46,0.2537,6,69,75,75,True
8732,2012-01-04,1,1,1,15,0,3,1,2,0.18,0.1515,0.37,0.3284,9,81,90,90,True
8733,2012-01-04,1,1,1,16,0,3,1,2,0.18,0.1667,0.4,0.2836,8,123,131,131,True
8734,2012-01-04,1,1,1,17,0,3,1,2,0.2,0.197,0.4,0.194,9,272,281,281,True
8735,2012-01-04,1,1,1,18,0,3,1,2,0.2,0.2121,0.37,0.1343,9,280,289,289,True
8736,2012-01-04,1,1,1,19,0,3,1,2,0.2,0.2273,0.4,0.1045,2,182,184,184,True
8737,2012-01-04,1,1,1,20,0,3,1,2,0.2,0.197,0.4,0.194,2,121,123,123,True
8738,2012-01-04,1,1,1,21,0,3,1,2,0.2,0.2576,0.44,0.0,2,88,90,90,True
8739,2012-01-04,1,1,1,22,0,3,1,2,0.2,0.2273,0.47,0.0896,4,48,52,52,True
8740,2012-01-04,1,1,1,23,0,3,1,2,0.2,0.2273,0.44,0.1045,0,32,32,32,True
8741,2012-01-05,1,1,1,0,0,4,1,2,0.22,0.2273,0.47,0.194,1,13,14,14,True
8742,2012-01-05,1,1,1,1,0,4,1,1,0.2,0.2273,0.51,0.0896,0,5,5,5,True
8743,2012-01-05,1,1,1,2,0,4,1,1,0.2,0.2273,0.51,0.0896,0,4,4,4,True
8744,2012-01-05,1,1,1,3,0,4,1,1,0.2,0.2576,0.61,0.0,0,4,4,4,True
8745,2012-01-05,1,1,1,4,0,4,1,2,0.2,0.2273,0.59,0.0896,0,5,5,5,True
8746,2012-01-05,1,1,1,5,0,4,1,2,0.2,0.2273,0.59,0.0896,0,26,26,26,True
8747,2012-01-05,1,1,1,6,0,4,1,2,0.2,0.2121,0.75,0.1343,0,78,78,78,True
8748,2012-01-05,1,1,1,7,0,4,1,2,0.2,0.2273,0.69,0.0896,3,212,215,215,True
8749,2012-01-05,1,1,1,8,0,4,1,2,0.2,0.2576,0.75,0.0,11,377,388,388,True
8750,2012-01-05,1,1,1,9,0,4,1,2,0.22,0.2727,0.69,0.0,7,220,227,227,True
8751,2012-01-05,1,1,1,10,0,4,1,2,0.24,0.2576,0.52,0.0896,5,81,86,86,True
8752,2012-01-05,1,1,1,11,0,4,1,1,0.3,0.3333,0.49,0.0,6,78,84,84,True
8753,2012-01-05,1,1,1,12,0,4,1,1,0.3,0.2879,0.49,0.2537,6,114,120,120,True
8754,2012-01-05,1,1,1,13,0,4,1,1,0.34,0.303,0.42,0.2985,6,112,118,118,True
8755,2012-01-05,1,1,1,14,0,4,1,1,0.34,0.3182,0.39,0.2836,13,104,117,117,True
8756,2012-01-05,1,1,1,15,0,4,1,1,0.36,0.3333,0.34,0.2836,6,113,119,119,True
8757,2012-01-05,1,1,1,16,0,4,1,1,0.36,0.3333,0.34,0.2836,19,178,197,197,True
8758,2012-01-05,1,1,1,17,0,4,1,2,0.36,0.3485,0.34,0.194,19,393,412,412,True
8759,2012-01-05,1,1,1,18,0,4,1,1,0.34,0.3333,0.36,0.1642,9,374,383,383,True
8760,2012-01-05,1,1,1,19,0,4,1,1,0.34,0.3485,0.34,0.0896,10,255,265,265,True
8761,2012-01-05,1,1,1,20,0,4,1,1,0.3,0.3333,0.49,0.0,5,172,177,177,True
8762,2012-01-05,1,1,1,21,0,4,1,1,0.26,0.2727,0.6,0.1343,9,88,97,97,True
8763,2012-01-05,1,1,1,22,0,4,1,1,0.26,0.2576,0.6,0.1642,1,70,71,71,True
8764,2012-01-05,1,1,1,23,0,4,1,1,0.24,0.2576,0.7,0.1045,4,56,60,60,True
8765,2012-01-06,1,1,1,0,0,5,1,1,0.22,0.2576,0.75,0.0896,1,24,25,25,True
8766,2012-01-06,1,1,1,1,0,5,1,1,0.22,0.2727,0.75,0.0,2,6,8,8,True
8767,2012-01-06,1,1,1,2,0,5,1,1,0.22,0.2273,0.69,0.1642,2,3,5,5,True
8768,2012-01-06,1,1,1,3,0,5,1,1,0.22,0.2424,0.69,0.1045,1,3,4,4,True
8769,2012-01-06,1,1,1,4,0,5,1,1,0.22,0.2273,0.69,0.1343,0,3,3,3,True
8770,2012-01-06,1,1,1,5,0,5,1,2,0.2,0.2121,0.8,0.1343,0,13,13,13,True
8771,2012-01-06,1,1,1,6,0,5,1,2,0.22,0.2424,0.73,0.1045,1,69,70,70,True
8772,2012-01-06,1,1,1,7,0,5,1,2,0.24,0.2879,0.65,0.0,4,201,205,205,True
8773,2012-01-06,1,1,1,8,0,5,1,1,0.24,0.2424,0.7,0.1343,11,436,447,447,True
8774,2012-01-06,1,1,1,9,0,5,1,1,0.24,0.2424,0.7,0.1642,4,237,241,241,True
8775,2012-01-06,1,1,1,10,0,5,1,1,0.26,0.2576,0.65,0.194,14,102,116,116,True
8776,2012-01-06,1,1,1,11,0,5,1,1,0.3,0.303,0.56,0.1642,8,130,138,138,True
8777,2012-01-06,1,1,1,12,0,5,1,1,0.36,0.3333,0.5,0.2537,23,168,191,191,True
8778,2012-01-06,1,1,1,13,0,5,1,1,0.4,0.4091,0.43,0.2836,16,188,204,204,True
8779,2012-01-06,1,1,1,14,0,5,1,1,0.46,0.4545,0.36,0.194,26,152,178,178,True
8780,2012-01-06,1,1,1,15,0,5,1,1,0.52,0.5,0.27,0.2537,44,178,222,222,True
8781,2012-01-06,1,1,1,16,0,5,1,1,0.52,0.5,0.27,0.2836,35,259,294,294,True
8782,2012-01-06,1,1,1,17,0,5,1,1,0.46,0.4545,0.36,0.2239,20,456,476,476,True
8783,2012-01-06,1,1,1,18,0,5,1,1,0.5,0.4848,0.29,0.2537,28,391,419,419,True
8784,2012-01-06,1,1,1,19,0,5,1,1,0.46,0.4545,0.33,0.2836,11,261,272,272,True
8785,2012-01-06,1,1,1,20,0,5,1,1,0.42,0.4242,0.41,0.194,14,163,177,177,True
8786,2012-01-06,1,1,1,21,0,5,1,1,0.4,0.4091,0.43,0.2239,17,137,154,154,True
8787,2012-01-06,1,1,1,22,0,5,1,1,0.36,0.3485,0.5,0.194,12,123,135,135,True
8788,2012-01-06,1,1,1,23,0,5,1,1,0.36,0.3788,0.5,0.0,13,88,101,101,True
8789,2012-01-07,1,1,1,0,0,6,0,1,0.36,0.3485,0.5,0.1642,2,77,79,79,True
8790,2012-01-07,1,1,1,1,0,6,0,1,0.38,0.3939,0.46,0.1642,6,56,62,62,True
8791,2012-01-07,1,1,1,2,0,6,0,1,0.36,0.3636,0.5,0.1045,2,36,38,38,True
8792,2012-01-07,1,1,1,3,0,6,0,1,0.32,0.3333,0.57,0.1045,1,19,20,20,True
8793,2012-01-07,1,1,1,4,0,6,0,1,0.32,0.3333,0.57,0.0896,1,9,10,10,True
8794,2012-01-07,1,1,1,5,0,6,0,1,0.26,0.2727,0.75,0.1045,2,7,9,9,True
8795,2012-01-07,1,1,1,6,0,6,0,1,0.26,0.2727,0.75,0.1045,0,7,7,7,True
8796,2012-01-07,1,1,1,7,0,6,0,1,0.22,0.2273,0.87,0.194,0,20,20,20,True
8797,2012-01-07,1,1,1,8,0,6,0,1,0.24,0.2576,0.75,0.1045,0,64,64,64,True
8798,2012-01-07,1,1,1,9,0,6,0,1,0.22,0.2273,0.8,0.1343,14,116,130,130,True
8799,2012-01-07,1,1,1,10,0,6,0,1,0.28,0.303,0.75,0.0896,43,160,203,203,True
8800,2012-01-07,1,1,1,11,0,6,0,1,0.34,0.3182,0.57,0.2239,74,250,324,324,True
8801,2012-01-07,1,1,1,12,0,6,0,1,0.4,0.4091,0.43,0.2239,100,276,376,376,True
8802,2012-01-07,1,1,1,13,0,6,0,1,0.44,0.4394,0.44,0.194,114,296,410,410,True
8803,2012-01-07,1,1,1,14,0,6,0,1,0.5,0.4848,0.42,0.2836,114,356,470,470,True
8804,2012-01-07,1,1,1,15,0,6,0,1,0.58,0.5455,0.37,0.2985,114,317,431,431,True
8805,2012-01-07,1,1,1,16,0,6,0,2,0.56,0.5303,0.37,0.2836,114,268,382,382,True
8806,2012-01-07,1,1,1,17,0,6,0,2,0.54,0.5152,0.43,0.1343,87,235,322,322,True
8807,2012-01-07,1,1,1,18,0,6,0,1,0.54,0.5152,0.45,0.1343,49,248,297,297,True
8808,2012-01-07,1,1,1,19,0,6,0,1,0.52,0.5,0.42,0.1045,44,171,215,215,True
8809,2012-01-07,1,1,1,20,0,6,0,1,0.5,0.4848,0.39,0.2537,21,149,170,170,True
8810,2012-01-07,1,1,1,21,0,6,0,1,0.44,0.4394,0.44,0.2239,22,118,140,140,True
8811,2012-01-07,1,1,1,22,0,6,0,1,0.44,0.4394,0.38,0.2537,16,93,109,109,True
8812,2012-01-07,1,1,1,23,0,6,0,1,0.42,0.4242,0.38,0.2239,16,103,119,119,True
8813,2012-01-08,1,1,1,0,0,0,0,1,0.38,0.3939,0.4,0.2836,14,77,91,91,True
8814,2012-01-08,1,1,1,1,0,0,0,1,0.34,0.3333,0.42,0.194,10,62,72,72,True
8815,2012-01-08,1,1,1,2,0,0,0,1,0.36,0.3333,0.37,0.2836,10,57,67,67,True
8816,2012-01-08,1,1,1,3,0,0,0,1,0.34,0.3333,0.42,0.1343,6,26,32,32,True
8817,2012-01-08,1,1,1,4,0,0,0,1,0.32,0.303,0.49,0.2537,2,4,6,6,True
8818,2012-01-08,1,1,1,5,0,0,0,2,0.32,0.3333,0.49,0.1045,0,2,2,2,True
8819,2012-01-08,1,1,1,6,0,0,0,2,0.3,0.3333,0.52,0.0,0,2,2,2,True
8820,2012-01-08,1,1,1,7,0,0,0,2,0.3,0.3333,0.52,0.0,1,23,24,24,True
8821,2012-01-08,1,1,1,8,0,0,0,1,0.3,0.303,0.52,0.1343,4,53,57,57,True
8822,2012-01-08,1,1,1,9,0,0,0,1,0.32,0.3333,0.53,0.1343,23,102,125,125,True
8823,2012-01-08,1,1,1,10,0,0,0,1,0.34,0.3333,0.49,0.1642,27,181,208,208,True
8824,2012-01-08,1,1,1,11,0,0,0,1,0.36,0.3485,0.46,0.2239,55,201,256,256,True
8825,2012-01-08,1,1,1,12,0,0,0,1,0.38,0.3939,0.43,0.2239,78,273,351,351,True
8826,2012-01-08,1,1,1,13,0,0,0,1,0.4,0.4091,0.37,0.2985,77,266,343,343,True
8827,2012-01-08,1,1,1,14,0,0,0,1,0.4,0.4091,0.4,0.194,75,253,328,328,True
8828,2012-01-08,1,1,1,15,0,0,0,1,0.4,0.4091,0.37,0.2836,89,241,330,330,True
8829,2012-01-08,1,1,1,16,0,0,0,1,0.4,0.4091,0.37,0.2985,58,256,314,314,True
8830,2012-01-08,1,1,1,17,0,0,0,1,0.38,0.3939,0.4,0.2239,22,197,219,219,True
8831,2012-01-08,1,1,1,18,0,0,0,1,0.34,0.3182,0.46,0.2239,19,162,181,181,True
8832,2012-01-08,1,1,1,19,0,0,0,1,0.32,0.3182,0.49,0.194,8,104,112,112,True
8833,2012-01-08,1,1,1,20,0,0,0,1,0.3,0.303,0.52,0.1642,7,119,126,126,True
8834,2012-01-08,1,1,1,21,0,0,0,1,0.28,0.2727,0.56,0.2239,10,81,91,91,True
8835,2012-01-08,1,1,1,22,0,0,0,1,0.26,0.2727,0.6,0.1045,4,54,58,58,True
8836,2012-01-08,1,1,1,23,0,0,0,1,0.26,0.2424,0.56,0.2537,0,30,30,30,True
8837,2012-01-09,1,1,1,0,0,1,1,1,0.24,0.2273,0.6,0.2239,3,12,15,15,True
8838,2012-01-09,1,1,1,1,0,1,1,1,0.24,0.2424,0.6,0.1343,1,4,5,5,True
8839,2012-01-09,1,1,1,2,0,1,1,1,0.24,0.2424,0.56,0.1343,2,3,5,5,True
8840,2012-01-09,1,1,1,3,0,1,1,1,0.24,0.2424,0.52,0.1642,0,3,3,3,True
8841,2012-01-09,1,1,1,4,0,1,1,1,0.22,0.2424,0.64,0.1045,0,4,4,4,True
8842,2012-01-09,1,1,1,5,0,1,1,2,0.2,0.2273,0.64,0.0896,0,21,21,21,True
8843,2012-01-09,1,1,1,6,0,1,1,2,0.22,0.2273,0.6,0.1343,3,85,88,88,True
8844,2012-01-09,1,1,1,7,0,1,1,2,0.22,0.2424,0.6,0.1045,1,239,240,240,True
8845,2012-01-09,1,1,1,8,0,1,1,2,0.22,0.2576,0.55,0.0896,13,407,420,420,True
8846,2012-01-09,1,1,1,9,0,1,1,2,0.22,0.2727,0.64,0.0,9,188,197,197,True
8847,2012-01-09,1,1,1,10,0,1,1,1,0.24,0.2879,0.6,0.0,13,95,108,108,True
8848,2012-01-09,1,1,1,11,0,1,1,2,0.26,0.2879,0.56,0.0896,6,82,88,88,True
8849,2012-01-09,1,1,1,12,0,1,1,2,0.26,0.2727,0.56,0.1045,10,93,103,103,True
8850,2012-01-09,1,1,1,13,0,1,1,2,0.26,0.2727,0.56,0.1045,3,77,80,80,True
8851,2012-01-09,1,1,1,14,0,1,1,3,0.22,0.2273,0.75,0.1642,5,45,50,50,True
8852,2012-01-09,1,1,1,15,0,1,1,3,0.22,0.2273,0.75,0.1642,5,64,69,69,True
8853,2012-01-09,1,1,1,16,0,1,1,3,0.22,0.2576,0.87,0.0896,3,46,49,49,True
8854,2012-01-09,1,1,1,17,0,1,1,3,0.22,0.2727,0.87,0.0,5,147,152,152,True
8855,2012-01-09,1,1,1,18,0,1,1,4,0.2,0.2273,0.86,0.0896,6,158,164,164,True
8856,2012-01-09,1,1,1,19,0,1,1,3,0.2,0.2273,0.93,0.0896,3,187,190,190,True
8857,2012-01-09,1,1,1,20,0,1,1,2,0.2,0.2273,0.86,0.0896,5,127,132,132,True
8858,2012-01-09,1,1,1,21,0,1,1,2,0.2,0.2576,0.93,0.0,1,78,79,79,True
8859,2012-01-09,1,1,1,22,0,1,1,2,0.2,0.2273,0.92,0.1045,8,54,62,62,True
8860,2012-01-09,1,1,1,23,0,1,1,2,0.22,0.2424,0.87,0.1045,1,51,52,52,True
8861,2012-01-10,1,1,1,0,0,2,1,2,0.22,0.2424,0.87,0.1045,0,14,14,14,True
8862,2012-01-10,1,1,1,1,0,2,1,2,0.22,0.2424,0.93,0.1045,2,3,5,5,True
8863,2012-01-10,1,1,1,2,0,2,1,2,0.22,0.2273,0.87,0.1642,2,2,4,4,True
8864,2012-01-10,1,1,1,4,0,2,1,2,0.2,0.2121,0.86,0.1642,0,4,4,4,True
8865,2012-01-10,1,1,1,5,0,2,1,1,0.4,0.4091,0.47,0.2239,0,23,23,23,True
8866,2012-01-10,1,1,1,6,0,2,1,2,0.18,0.1818,0.93,0.194,0,79,79,79,True
8867,2012-01-10,1,1,1,7,0,2,1,2,0.18,0.197,0.93,0.1642,3,219,222,222,True
8868,2012-01-10,1,1,1,8,0,2,1,2,0.18,0.197,0.93,0.1642,6,465,471,471,True
8869,2012-01-10,1,1,1,9,0,2,1,2,0.18,0.197,0.93,0.1642,11,184,195,195,True
8870,2012-01-10,1,1,1,10,0,2,1,2,0.18,0.197,0.93,0.1642,3,80,83,83,True
8871,2012-01-10,1,1,1,11,0,2,1,1,0.42,0.4242,0.38,0.2985,8,93,101,101,True
8872,2012-01-10,1,1,1,12,0,2,1,1,0.42,0.4242,0.38,0.2985,13,127,140,140,True
8873,2012-01-10,1,1,1,13,0,2,1,1,0.42,0.4242,0.38,0.2985,15,163,178,178,True
8874,2012-01-10,1,1,1,14,0,2,1,1,0.42,0.4242,0.38,0.2985,10,96,106,106,True
8875,2012-01-10,1,1,1,15,0,2,1,1,0.42,0.4242,0.38,0.2985,17,119,136,136,True
8876,2012-01-10,1,1,1,16,0,2,1,1,0.42,0.4242,0.38,0.3582,15,225,240,240,True
8877,2012-01-10,1,1,1,17,0,2,1,1,0.42,0.4242,0.38,0.2537,14,446,460,460,True
8878,2012-01-10,1,1,1,18,0,2,1,1,0.4,0.4091,0.4,0.1045,13,372,385,385,True
8879,2012-01-10,1,1,1,19,0,2,1,1,0.38,0.3939,0.46,0.1045,11,270,281,281,True
8880,2012-01-10,1,1,1,20,0,2,1,1,0.34,0.3485,0.53,0.1045,10,190,200,200,True
8881,2012-01-10,1,1,1,21,0,2,1,1,0.32,0.3333,0.66,0.0896,7,109,116,116,True
8882,2012-01-10,1,1,1,22,0,2,1,1,0.3,0.303,0.7,0.0896,10,104,114,114,True
8883,2012-01-10,1,1,1,23,0,2,1,1,0.26,0.2727,0.81,0.1045,3,38,41,41,True
8884,2012-01-11,1,1,1,0,0,3,1,1,0.26,0.303,0.81,0.0,2,26,28,28,True
8885,2012-01-11,1,1,1,1,0,3,1,1,0.24,0.2576,0.87,0.0896,1,6,7,7,True
8886,2012-01-11,1,1,1,2,0,3,1,1,0.2,0.2121,0.85,0.1642,0,5,5,5,True
8887,2012-01-11,1,1,1,3,0,3,1,1,0.22,0.2727,0.8,0.0,0,4,4,4,True
8888,2012-01-11,1,1,1,4,0,3,1,1,0.2,0.2121,0.8,0.1343,0,2,2,2,True
8889,2012-01-11,1,1,1,5,0,3,1,1,0.2,0.2121,0.8,0.1343,0,22,22,22,True
8890,2012-01-11,1,1,1,6,0,3,1,1,0.2,0.2121,0.86,0.1343,2,72,74,74,True
8891,2012-01-11,1,1,1,7,0,3,1,1,0.2,0.2121,0.8,0.1343,9,247,256,256,True
8892,2012-01-11,1,1,1,8,0,3,1,1,0.2,0.2273,0.82,0.1045,11,488,499,499,True
8893,2012-01-11,1,1,1,9,0,3,1,2,0.2,0.2121,0.86,0.1343,7,218,225,225,True
8894,2012-01-11,1,1,1,10,0,3,1,2,0.24,0.2424,0.87,0.1343,13,84,97,97,True
8895,2012-01-11,1,1,1,11,0,3,1,2,0.26,0.2879,0.87,0.0896,9,90,99,99,True
8896,2012-01-11,1,1,1,12,0,3,1,3,0.3,0.3333,0.81,0.0,4,51,55,55,True
8897,2012-01-11,1,1,1,13,0,3,1,3,0.32,0.3485,0.76,0.0,8,57,65,65,True
8898,2012-01-11,1,1,1,14,0,3,1,3,0.32,0.3333,0.81,0.1045,3,70,73,73,True
8899,2012-01-11,1,1,1,15,0,3,1,2,0.34,0.3485,0.87,0.0896,6,73,79,79,True
8900,2012-01-11,1,1,1,16,0,3,1,2,0.34,0.3182,0.87,0.2537,6,112,118,118,True
8901,2012-01-11,1,1,1,17,0,3,1,3,0.34,0.3182,0.87,0.2239,6,128,134,134,True
8902,2012-01-11,1,1,1,18,0,3,1,3,0.34,0.3333,0.87,0.194,2,96,98,98,True
8903,2012-01-11,1,1,1,19,0,3,1,3,0.32,0.303,0.93,0.2239,1,92,93,93,True
8904,2012-01-11,1,1,1,20,0,3,1,3,0.32,0.3182,0.93,0.1642,2,55,57,57,True
8905,2012-01-11,1,1,1,21,0,3,1,3,0.34,0.3182,0.87,0.2239,0,29,29,29,True
8906,2012-01-11,1,1,1,22,0,3,1,3,0.34,0.3333,0.87,0.194,0,49,49,49,True
8907,2012-01-11,1,1,1,23,0,3,1,3,0.34,0.3182,0.87,0.2239,0,9,9,9,True
8908,2012-01-12,1,1,1,0,0,4,1,3,0.34,0.3333,0.93,0.194,0,3,3,3,True
8909,2012-01-12,1,1,1,1,0,4,1,3,0.36,0.3485,0.93,0.194,0,3,3,3,True
8910,2012-01-12,1,1,1,2,0,4,1,3,0.36,0.3485,0.93,0.2537,1,1,2,2,True
8911,2012-01-12,1,1,1,3,0,4,1,3,0.36,0.3485,0.93,0.2537,0,3,3,3,True
8912,2012-01-12,1,1,1,4,0,4,1,3,0.36,0.3485,0.93,0.194,0,2,2,2,True
8913,2012-01-12,1,1,1,5,0,4,1,3,0.34,0.3485,0.93,0.0896,0,16,16,16,True
8914,2012-01-12,1,1,1,6,0,4,1,3,0.36,0.3485,0.93,0.1343,1,88,89,89,True
8915,2012-01-12,1,1,1,7,0,4,1,2,0.34,0.3182,0.87,0.2836,2,218,220,220,True
8916,2012-01-12,1,1,1,8,0,4,1,1,0.32,0.3182,0.81,0.194,11,497,508,508,True
8917,2012-01-12,1,1,1,9,0,4,1,1,0.32,0.3333,0.81,0.1045,10,220,230,230,True
8918,2012-01-12,1,1,1,10,0,4,1,1,0.34,0.3485,0.81,0.1045,6,84,90,90,True
8919,2012-01-12,1,1,1,11,0,4,1,2,0.34,0.3485,0.81,0.1045,18,101,119,119,True
8920,2012-01-12,1,1,1,12,0,4,1,2,0.34,0.3485,0.81,0.1045,14,130,144,144,True
8921,2012-01-12,1,1,1,13,0,4,1,1,0.42,0.4242,0.77,0.1642,13,170,183,183,True
8922,2012-01-12,1,1,1,14,0,4,1,1,0.42,0.4242,0.77,0.1642,24,132,156,156,True
8923,2012-01-12,1,1,1,15,0,4,1,1,0.44,0.4394,0.72,0.1343,32,156,188,188,True
8924,2012-01-12,1,1,1,16,0,4,1,1,0.46,0.4545,0.67,0.194,33,248,281,281,True
8925,2012-01-12,1,1,1,17,0,4,1,1,0.46,0.4545,0.63,0.1642,23,472,495,495,True
8926,2012-01-12,1,1,1,18,0,4,1,1,0.44,0.4394,0.67,0.194,22,399,421,421,True
8927,2012-01-12,1,1,1,19,0,4,1,2,0.42,0.4242,0.71,0.1642,17,313,330,330,True
8928,2012-01-12,1,1,1,20,0,4,1,2,0.42,0.4242,0.71,0.194,11,229,240,240,True
8929,2012-01-12,1,1,1,21,0,4,1,1,0.44,0.4394,0.67,0.1343,12,162,174,174,True
8930,2012-01-12,1,1,1,22,0,4,1,1,0.38,0.3939,0.76,0.2985,12,121,133,133,True
8931,2012-01-12,1,1,1,23,0,4,1,1,0.4,0.4091,0.76,0.3284,7,60,67,67,True
8932,2012-01-13,1,1,1,0,0,5,1,2,0.4,0.4091,0.71,0.2836,4,38,42,42,True
8933,2012-01-13,1,1,1,1,0,5,1,2,0.38,0.3939,0.76,0.2985,0,12,12,12,True
8934,2012-01-13,1,1,1,2,0,5,1,1,0.4,0.4091,0.76,0.3582,1,13,14,14,True
8935,2012-01-13,1,1,1,3,0,5,1,1,0.36,0.3333,0.87,0.2537,3,4,7,7,True
8936,2012-01-13,1,1,1,4,0,5,1,3,0.32,0.2879,0.7,0.4775,1,2,3,3,True
8937,2012-01-13,1,1,1,5,0,5,1,2,0.3,0.2424,0.7,0.4775,0,21,21,21,True
8938,2012-01-13,1,1,1,6,0,5,1,2,0.26,0.2576,0.75,0.2239,2,71,73,73,True
8939,2012-01-13,1,1,1,7,0,5,1,1,0.26,0.2576,0.6,0.2239,3,174,177,177,True
8940,2012-01-13,1,1,1,8,0,5,1,1,0.24,0.2121,0.52,0.3582,11,408,419,419,True
8941,2012-01-13,1,1,1,9,0,5,1,1,0.22,0.197,0.47,0.3881,10,204,214,214,True
8942,2012-01-13,1,1,1,10,0,5,1,1,0.24,0.197,0.44,0.4478,2,101,103,103,True
8943,2012-01-13,1,1,1,11,0,5,1,1,0.24,0.1818,0.38,0.4775,12,102,114,114,True
8944,2012-01-13,1,1,1,12,0,5,1,1,0.24,0.197,0.38,0.4775,14,140,154,154,True
8945,2012-01-13,1,1,1,13,0,5,1,1,0.26,0.2121,0.33,0.4775,14,140,154,154,True
8946,2012-01-13,1,1,1,14,0,5,1,1,0.26,0.2121,0.33,0.4775,10,119,129,129,True
8947,2012-01-13,1,1,1,15,0,5,1,1,0.26,0.2121,0.33,0.4775,15,123,138,138,True
8948,2012-01-13,1,1,1,16,0,5,1,1,0.28,0.2424,0.3,0.4627,18,215,233,233,True
8949,2012-01-13,1,1,1,17,0,5,1,1,0.28,0.2424,0.33,0.4179,15,317,332,332,True
8950,2012-01-13,1,1,1,18,0,5,1,1,0.26,0.2273,0.38,0.2985,7,294,301,301,True
8951,2012-01-13,1,1,1,19,0,5,1,1,0.26,0.2424,0.38,0.2836,7,199,206,206,True
8952,2012-01-13,1,1,1,20,0,5,1,1,0.24,0.2424,0.41,0.1642,6,130,136,136,True
8953,2012-01-13,1,1,1,21,0,5,1,1,0.24,0.2121,0.41,0.2836,7,95,102,102,True
8954,2012-01-13,1,1,1,22,0,5,1,1,0.2,0.1818,0.47,0.3284,7,58,65,65,True
8955,2012-01-13,1,1,1,23,0,5,1,1,0.18,0.1818,0.47,0.194,5,60,65,65,True
8956,2012-01-14,1,1,1,0,0,6,0,1,0.16,0.1818,0.47,0.1045,2,42,44,44,True
8957,2012-01-14,1,1,1,1,0,6,0,1,0.16,0.1515,0.47,0.194,6,44,50,50,True
8958,2012-01-14,1,1,1,2,0,6,0,1,0.16,0.1667,0.47,0.1642,6,32,38,38,True
8959,2012-01-14,1,1,1,3,0,6,0,1,0.14,0.1667,0.54,0.1045,6,14,20,20,True
8960,2012-01-14,1,1,1,4,0,6,0,1,0.14,0.1515,0.5,0.1343,0,3,3,3,True
8961,2012-01-14,1,1,1,5,0,6,0,1,0.14,0.1515,0.5,0.1343,0,4,4,4,True
8962,2012-01-14,1,1,1,6,0,6,0,1,0.14,0.1515,0.5,0.0,0,5,5,5,True
8963,2012-01-14,1,1,1,7,0,6,0,1,0.14,0.1515,0.5,0.1343,0,24,24,24,True
8964,2012-01-14,1,1,1,8,0,6,0,1,0.12,0.1515,0.54,0.1045,3,89,92,92,True
8965,2012-01-14,1,1,1,9,0,6,0,1,0.14,0.1667,0.5,0.1045,3,78,81,81,True
8966,2012-01-14,1,1,1,10,0,6,0,1,0.16,0.2273,0.47,0.0,14,135,149,149,True
8967,2012-01-14,1,1,1,11,0,6,0,1,0.2,0.197,0.4,0.194,28,150,178,178,True
8968,2012-01-14,1,1,1,12,0,6,0,1,0.22,0.2121,0.41,0.2537,30,189,219,219,True
8969,2012-01-14,1,1,1,13,0,6,0,1,0.22,0.2121,0.44,0.2836,38,182,220,220,True
8970,2012-01-14,1,1,1,14,0,6,0,1,0.24,0.2121,0.41,0.2985,52,179,231,231,True
8971,2012-01-14,1,1,1,15,0,6,0,1,0.24,0.2121,0.38,0.2985,49,177,226,226,True
8972,2012-01-14,1,1,1,16,0,6,0,1,0.24,0.2273,0.38,0.2239,28,178,206,206,True
8973,2012-01-14,1,1,1,17,0,6,0,1,0.24,0.2273,0.41,0.2537,15,129,144,144,True
8974,2012-01-14,1,1,1,18,0,6,0,1,0.22,0.2273,0.41,0.194,21,122,143,143,True
8975,2012-01-14,1,1,1,19,0,6,0,1,0.2,0.197,0.47,0.2239,12,90,102,102,True
8976,2012-01-14,1,1,1,20,0,6,0,1,0.2,0.197,0.44,0.2537,8,95,103,103,True
8977,2012-01-14,1,1,1,21,0,6,0,1,0.18,0.1667,0.43,0.2537,3,66,69,69,True
8978,2012-01-14,1,1,1,22,0,6,0,1,0.16,0.1364,0.47,0.3582,4,62,66,66,True
8979,2012-01-14,1,1,1,23,0,6,0,1,0.16,0.1515,0.47,0.2239,5,71,76,76,True
8980,2012-01-15,1,1,1,0,0,0,0,1,0.16,0.1364,0.47,0.3284,9,50,59,59,True
8981,2012-01-15,1,1,1,1,0,0,0,2,0.16,0.1364,0.47,0.2985,2,40,42,42,True
8982,2012-01-15,1,1,1,2,0,0,0,2,0.16,0.1364,0.47,0.2836,5,38,43,43,True
8983,2012-01-15,1,1,1,3,0,0,0,2,0.16,0.1364,0.48,0.3881,1,24,25,25,True
8984,2012-01-15,1,1,1,4,0,0,0,2,0.16,0.1364,0.47,0.3881,1,5,6,6,True
8985,2012-01-15,1,1,1,5,0,0,0,2,0.16,0.1364,0.47,0.3284,0,5,5,5,True
8986,2012-01-15,1,1,1,6,0,0,0,2,0.14,0.1212,0.5,0.2836,1,7,8,8,True
8987,2012-01-15,1,1,1,7,0,0,0,1,0.12,0.1212,0.54,0.2836,3,14,17,17,True
8988,2012-01-15,1,1,1,8,0,0,0,1,0.12,0.1212,0.54,0.2239,2,34,36,36,True
8989,2012-01-15,1,1,1,9,0,0,0,1,0.12,0.1364,0.54,0.194,10,80,90,90,True
8990,2012-01-15,1,1,1,10,0,0,0,1,0.14,0.1212,0.54,0.2836,11,115,126,126,True
8991,2012-01-15,1,1,1,11,0,0,0,1,0.16,0.1515,0.47,0.2239,21,144,165,165,True
8992,2012-01-15,1,1,1,12,0,0,0,1,0.18,0.1667,0.4,0.2985,42,192,234,234,True
8993,2012-01-15,1,1,1,13,0,0,0,1,0.2,0.1818,0.34,0.2836,40,184,224,224,True
8994,2012-01-15,1,1,1,14,0,0,0,1,0.2,0.1818,0.32,0.3582,25,163,188,188,True
8995,2012-01-15,1,1,1,15,0,0,0,1,0.22,0.2273,0.27,0.194,33,173,206,206,True
8996,2012-01-15,1,1,1,16,0,0,0,1,0.22,0.2121,0.29,0.2985,31,174,205,205,True
8997,2012-01-15,1,1,1,17,0,0,0,1,0.22,0.2121,0.25,0.2537,15,131,146,146,True
8998,2012-01-15,1,1,1,18,0,0,0,1,0.18,0.1818,0.29,0.2239,7,113,120,120,True
8999,2012-01-15,1,1,1,19,0,0,0,1,0.16,0.1667,0.37,0.1642,9,101,110,110,True
9000,2012-01-15,1,1,1,20,0,0,0,1,0.16,0.1818,0.37,0.1045,10,85,95,95,True
9001,2012-01-15,1,1,1,21,0,0,0,1,0.16,0.1667,0.4,0.1642,1,71,72,72,True
9002,2012-01-15,1,1,1,22,0,0,0,1,0.18,0.2121,0.37,0.0896,2,58,60,60,True
9003,2012-01-15,1,1,1,23,0,0,0,1,0.16,0.197,0.43,0.0896,3,26,29,29,True
9004,2012-01-16,1,1,1,0,1,1,0,1,0.14,0.1515,0.46,0.1343,2,23,25,25,True
9005,2012-01-16,1,1,1,1,1,1,0,1,0.14,0.1667,0.43,0.1045,2,18,20,20,True
9006,2012-01-16,1,1,1,2,1,1,0,1,0.14,0.2121,0.46,0.0,3,14,17,17,True
9007,2012-01-16,1,1,1,3,1,1,0,1,0.12,0.197,0.5,0.0,0,3,3,3,True
9008,2012-01-16,1,1,1,4,1,1,0,1,0.12,0.1515,0.58,0.1045,2,6,8,8,True
9009,2012-01-16,1,1,1,5,1,1,0,1,0.12,0.1667,0.54,0.0896,1,5,6,6,True
9010,2012-01-16,1,1,1,6,1,1,0,1,0.1,0.1364,0.54,0.0896,0,13,13,13,True
9011,2012-01-16,1,1,1,7,1,1,0,1,0.1,0.1364,0.54,0.1045,5,28,33,33,True
9012,2012-01-16,1,1,1,8,1,1,0,1,0.1,0.1212,0.58,0.1642,3,75,78,78,True
9013,2012-01-16,1,1,1,9,1,1,0,1,0.1,0.1212,0.58,0.1642,7,89,96,96,True
9014,2012-01-16,1,1,1,10,1,1,0,2,0.14,0.1364,0.59,0.194,19,107,126,126,True
9015,2012-01-16,1,1,1,11,1,1,0,1,0.16,0.1515,0.59,0.2537,21,158,179,179,True
9016,2012-01-16,1,1,1,12,1,1,0,1,0.2,0.1818,0.55,0.3284,20,165,185,185,True
9017,2012-01-16,1,1,1,13,1,1,0,2,0.24,0.197,0.41,0.4179,26,202,228,228,True
9018,2012-01-16,1,1,1,14,1,1,0,1,0.24,0.2121,0.44,0.3881,23,158,181,181,True
9019,2012-01-16,1,1,1,15,1,1,0,1,0.26,0.2121,0.44,0.4478,17,175,192,192,True
9020,2012-01-16,1,1,1,16,1,1,0,1,0.26,0.2273,0.44,0.3582,22,158,180,180,True
9021,2012-01-16,1,1,1,17,1,1,0,1,0.26,0.2273,0.48,0.3284,19,174,193,193,True
9022,2012-01-16,1,1,1,18,1,1,0,1,0.26,0.2273,0.52,0.3284,6,175,181,181,True
9023,2012-01-16,1,1,1,19,1,1,0,1,0.26,0.2424,0.56,0.2836,10,134,144,144,True
9024,2012-01-16,1,1,1,20,1,1,0,1,0.26,0.2424,0.6,0.2836,2,88,90,90,True
9025,2012-01-16,1,1,1,21,1,1,0,1,0.28,0.2576,0.52,0.3284,3,46,49,49,True
9026,2012-01-16,1,1,1,22,1,1,0,2,0.3,0.2727,0.49,0.3582,4,39,43,43,True
9027,2012-01-16,1,1,1,23,1,1,0,3,0.26,0.2273,0.7,0.2985,0,28,28,28,True
9028,2012-01-17,1,1,1,0,0,2,1,2,0.26,0.2273,0.7,0.3284,0,12,12,12,True
9029,2012-01-17,1,1,1,1,0,2,1,2,0.28,0.2576,0.65,0.3582,0,2,2,2,True
9030,2012-01-17,1,1,1,2,0,2,1,3,0.28,0.2727,0.75,0.2537,0,12,12,12,True
9031,2012-01-17,1,1,1,4,0,2,1,3,0.32,0.303,0.66,0.3284,0,2,2,2,True
9032,2012-01-17,1,1,1,5,0,2,1,3,0.32,0.303,0.66,0.3284,0,13,13,13,True
9033,2012-01-17,1,1,1,6,0,2,1,3,0.3,0.2879,0.75,0.2537,0,57,57,57,True
9034,2012-01-17,1,1,1,7,0,2,1,3,0.3,0.2879,0.81,0.2239,5,121,126,126,True
9035,2012-01-17,1,1,1,8,0,2,1,3,0.3,0.2879,0.81,0.2836,3,90,93,93,True
9036,2012-01-17,1,1,1,9,0,2,1,3,0.32,0.303,0.81,0.2537,7,61,68,68,True
9037,2012-01-17,1,1,1,10,0,2,1,3,0.3,0.2879,0.87,0.2537,1,61,62,62,True
9038,2012-01-17,1,1,1,11,0,2,1,2,0.34,0.3485,0.87,0.1045,2,73,75,75,True
9039,2012-01-17,1,1,1,12,0,2,1,2,0.32,0.303,0.87,0.2836,3,83,86,86,True
9040,2012-01-17,1,1,1,13,0,2,1,2,0.38,0.3939,0.76,0.3284,8,95,103,103,True
9041,2012-01-17,1,1,1,14,0,2,1,1,0.44,0.4394,0.62,0.4775,12,120,132,132,True
9042,2012-01-17,1,1,1,15,0,2,1,1,0.44,0.4394,0.62,0.4775,6,123,129,129,True
9043,2012-01-17,1,1,1,16,0,2,1,1,0.46,0.4545,0.63,0.4775,14,205,219,219,True
9044,2012-01-17,1,1,1,17,0,2,1,1,0.46,0.4545,0.63,0.4478,20,442,462,462,True
9045,2012-01-17,1,1,1,18,0,2,1,1,0.46,0.4545,0.63,0.4478,12,451,463,463,True
9046,2012-01-17,1,1,1,19,0,2,1,1,0.46,0.4545,0.63,0.4179,11,297,308,308,True
9047,2012-01-17,1,1,1,20,0,2,1,1,0.46,0.4545,0.63,0.3582,11,169,180,180,True
9048,2012-01-17,1,1,1,21,0,2,1,1,0.46,0.4545,0.67,0.4627,6,174,180,180,True
9049,2012-01-17,1,1,1,22,0,2,1,1,0.46,0.4545,0.72,0.3881,5,85,90,90,True
9050,2012-01-17,1,1,1,23,0,2,1,1,0.46,0.4545,0.72,0.3881,1,60,61,61,True
9051,2012-01-18,1,1,1,0,0,3,1,2,0.46,0.4545,0.77,0.3284,3,14,17,17,True
9052,2012-01-18,1,1,1,1,0,3,1,2,0.46,0.4545,0.77,0.3284,0,10,10,10,True
9053,2012-01-18,1,1,1,2,0,3,1,2,0.44,0.4394,0.51,0.4775,1,1,2,2,True
9054,2012-01-18,1,1,1,3,0,3,1,2,0.44,0.4394,0.51,0.4775,1,3,4,4,True
9055,2012-01-18,1,1,1,4,0,3,1,1,0.34,0.2879,0.46,0.4775,0,1,1,1,True
9056,2012-01-18,1,1,1,5,0,3,1,1,0.34,0.2879,0.46,0.4775,0,29,29,29,True
9057,2012-01-18,1,1,1,6,0,3,1,1,0.34,0.2879,0.36,0.4775,0,88,88,88,True
9058,2012-01-18,1,1,1,7,0,3,1,1,0.32,0.2879,0.42,0.3582,1,262,263,263,True
9059,2012-01-18,1,1,1,8,0,3,1,1,0.3,0.2727,0.52,0.4179,15,474,489,489,True
9060,2012-01-18,1,1,1,9,0,3,1,1,0.28,0.2576,0.52,0.3284,6,196,202,202,True
9061,2012-01-18,1,1,1,10,0,3,1,1,0.3,0.2727,0.42,0.4627,5,88,93,93,True
9062,2012-01-18,1,1,1,11,0,3,1,1,0.3,0.2727,0.42,0.3881,4,110,114,114,True
9063,2012-01-18,1,1,1,12,0,3,1,1,0.3,0.2576,0.39,0.4775,6,155,161,161,True
9064,2012-01-18,1,1,1,13,0,3,1,1,0.3,0.2727,0.42,0.4627,6,124,130,130,True
9065,2012-01-18,1,1,1,14,0,3,1,1,0.3,0.2727,0.33,0.3881,7,98,105,105,True
9066,2012-01-18,1,1,1,15,0,3,1,1,0.3,0.2576,0.33,0.4775,8,122,130,130,True
9067,2012-01-18,1,1,1,16,0,3,1,1,0.28,0.2273,0.3,0.4775,13,163,176,176,True
9068,2012-01-18,1,1,1,17,0,3,1,1,0.26,0.2121,0.33,0.4478,8,338,346,346,True
9069,2012-01-18,1,1,1,18,0,3,1,1,0.24,0.2121,0.32,0.3582,8,347,355,355,True
9070,2012-01-18,1,1,1,19,0,3,1,1,0.22,0.197,0.37,0.3881,5,251,256,256,True
9071,2012-01-18,1,1,1,20,0,3,1,1,0.22,0.2121,0.37,0.2537,1,164,165,165,True
9072,2012-01-18,1,1,1,21,0,3,1,1,0.2,0.1667,0.4,0.4179,5,119,124,124,True
9073,2012-01-18,1,1,1,22,0,3,1,1,0.18,0.1667,0.47,0.2537,4,74,78,78,True
9074,2012-01-18,1,1,1,23,0,3,1,1,0.16,0.1364,0.47,0.2985,2,36,38,38,True
9075,2012-01-19,1,1,1,0,0,4,1,1,0.14,0.1364,0.5,0.194,0,16,16,16,True
9076,2012-01-19,1,1,1,1,0,4,1,1,0.14,0.1515,0.5,0.1642,0,5,5,5,True
9077,2012-01-19,1,1,1,2,0,4,1,1,0.14,0.1515,0.5,0.1343,0,3,3,3,True
9078,2012-01-19,1,1,1,3,0,4,1,1,0.12,0.1515,0.54,0.1045,0,4,4,4,True
9079,2012-01-19,1,1,1,4,0,4,1,1,0.12,0.1515,0.54,0.1045,0,1,1,1,True
9080,2012-01-19,1,1,1,5,0,4,1,1,0.12,0.1212,0.55,0.2537,0,19,19,19,True
9081,2012-01-19,1,1,1,6,0,4,1,1,0.12,0.1364,0.54,0.1642,0,86,86,86,True
9082,2012-01-19,1,1,1,7,0,4,1,1,0.12,0.1667,0.54,0.0896,2,204,206,206,True
9083,2012-01-19,1,1,1,8,0,4,1,1,0.12,0.1515,0.54,0.1045,9,414,423,423,True
9084,2012-01-19,1,1,1,9,0,4,1,1,0.12,0.197,0.54,0.0,6,204,210,210,True
9085,2012-01-19,1,1,1,10,0,4,1,1,0.14,0.2121,0.59,0.0,10,98,108,108,True
9086,2012-01-19,1,1,1,11,0,4,1,1,0.16,0.1667,0.55,0.1642,6,93,99,99,True
9087,2012-01-19,1,1,1,12,0,4,1,1,0.2,0.197,0.51,0.194,5,106,111,111,True
9088,2012-01-19,1,1,1,13,0,4,1,1,0.22,0.2121,0.47,0.2836,6,118,124,124,True
9089,2012-01-19,1,1,1,14,0,4,1,1,0.24,0.2273,0.44,0.194,15,104,119,119,True
9090,2012-01-19,1,1,1,15,0,4,1,1,0.26,0.2273,0.44,0.2985,9,118,127,127,True
9091,2012-01-19,1,1,1,16,0,4,1,1,0.26,0.2273,0.41,0.3284,8,185,193,193,True
9092,2012-01-19,1,1,1,17,0,4,1,2,0.26,0.2273,0.44,0.3284,21,364,385,385,True
9093,2012-01-19,1,1,1,18,0,4,1,2,0.26,0.2273,0.44,0.3284,16,345,361,361,True
9094,2012-01-19,1,1,1,19,0,4,1,2,0.26,0.2273,0.48,0.2985,5,229,234,234,True
9095,2012-01-19,1,1,1,20,0,4,1,1,0.26,0.2121,0.52,0.4478,7,184,191,191,True
9096,2012-01-19,1,1,1,21,0,4,1,1,0.26,0.2273,0.44,0.3582,4,117,121,121,True
9097,2012-01-19,1,1,1,22,0,4,1,2,0.26,0.2273,0.44,0.4179,0,90,90,90,True
9098,2012-01-19,1,1,1,23,0,4,1,1,0.26,0.2273,0.48,0.3284,1,55,56,56,True
9099,2012-01-20,1,1,1,0,0,5,1,2,0.26,0.2273,0.48,0.2985,3,24,27,27,True
9100,2012-01-20,1,1,1,1,0,5,1,1,0.26,0.2727,0.48,0.1343,0,15,15,15,True
9101,2012-01-20,1,1,1,2,0,5,1,1,0.26,0.2727,0.48,0.1343,0,11,11,11,True
9102,2012-01-20,1,1,1,3,0,5,1,1,0.24,0.2576,0.52,0.1045,0,4,4,4,True
9103,2012-01-20,1,1,1,4,0,5,1,1,0.22,0.2424,0.6,0.1045,0,3,3,3,True
9104,2012-01-20,1,1,1,5,0,5,1,1,0.22,0.2424,0.6,0.1045,0,19,19,19,True
9105,2012-01-20,1,1,1,6,0,5,1,1,0.24,0.2121,0.6,0.2836,0,68,68,68,True
9106,2012-01-20,1,1,1,7,0,5,1,1,0.22,0.2121,0.69,0.2239,2,183,185,185,True
9107,2012-01-20,1,1,1,8,0,5,1,1,0.22,0.2121,0.64,0.2537,4,421,425,425,True
9108,2012-01-20,1,1,1,9,0,5,1,1,0.22,0.197,0.47,0.3881,21,242,263,263,True
9109,2012-01-20,1,1,1,10,0,5,1,2,0.22,0.2121,0.44,0.2836,1,96,97,97,True
9110,2012-01-20,1,1,1,11,0,5,1,2,0.2,0.1818,0.32,0.3582,6,117,123,123,True
9111,2012-01-20,1,1,1,12,0,5,1,2,0.2,0.1818,0.34,0.3284,5,119,124,124,True
9112,2012-01-20,1,1,1,13,0,5,1,1,0.22,0.2121,0.32,0.2985,12,144,156,156,True
9113,2012-01-20,1,1,1,14,0,5,1,2,0.22,0.2121,0.35,0.2985,8,107,115,115,True
9114,2012-01-20,1,1,1,15,0,5,1,2,0.22,0.2273,0.35,0.194,12,144,156,156,True
9115,2012-01-20,1,1,1,16,0,5,1,2,0.2,0.2121,0.37,0.1642,11,163,174,174,True
9116,2012-01-20,1,1,1,17,0,5,1,2,0.22,0.2576,0.32,0.0896,9,340,349,349,True
9117,2012-01-20,1,1,1,18,0,5,1,2,0.2,0.2273,0.34,0.0896,5,296,301,301,True
9118,2012-01-20,1,1,1,19,0,5,1,2,0.2,0.2273,0.37,0.1045,6,186,192,192,True
9119,2012-01-20,1,1,1,20,0,5,1,2,0.2,0.2273,0.34,0.0896,1,141,142,142,True
9120,2012-01-20,1,1,1,21,0,5,1,2,0.2,0.2273,0.37,0.0896,5,99,104,104,True
9121,2012-01-20,1,1,1,22,0,5,1,2,0.2,0.197,0.37,0.2239,1,71,72,72,True
9122,2012-01-20,1,1,1,23,0,5,1,3,0.16,0.1515,0.64,0.2239,3,35,38,38,True
9123,2012-01-21,1,1,1,0,0,6,0,3,0.16,0.1515,0.64,0.2239,0,24,24,24,True
9124,2012-01-21,1,1,1,1,0,6,0,4,0.14,0.1364,0.86,0.194,1,22,23,23,True
9125,2012-01-21,1,1,1,2,0,6,0,3,0.14,0.2121,0.86,0.0,1,25,26,26,True
9126,2012-01-21,1,1,1,3,0,6,0,3,0.14,0.1818,0.93,0.0896,0,13,13,13,True
9127,2012-01-21,1,1,1,4,0,6,0,3,0.16,0.197,0.86,0.0896,0,1,1,1,True
9128,2012-01-21,1,1,1,5,0,6,0,3,0.16,0.1818,0.86,0.1045,0,2,2,2,True
9129,2012-01-21,1,1,1,6,0,6,0,3,0.16,0.1667,0.93,0.1642,0,1,1,1,True
9130,2012-01-21,1,1,1,7,0,6,0,3,0.16,0.1667,0.93,0.1642,3,10,13,13,True
9131,2012-01-21,1,1,1,8,0,6,0,2,0.16,0.1515,0.93,0.2537,3,22,25,25,True
9132,2012-01-21,1,1,1,9,0,6,0,2,0.16,0.1515,0.93,0.2537,2,40,42,42,True
9133,2012-01-21,1,1,1,10,0,6,0,3,0.16,0.1515,0.93,0.2537,0,45,45,45,True
9134,2012-01-21,1,1,1,11,0,6,0,2,0.18,0.2121,0.86,0.1045,1,62,63,63,True
9135,2012-01-21,1,1,1,12,0,6,0,2,0.2,0.2121,0.8,0.1642,5,62,67,67,True
9136,2012-01-21,1,1,1,13,0,6,0,2,0.2,0.197,0.8,0.2537,10,66,76,76,True
9137,2012-01-21,1,1,1,14,0,6,0,3,0.2,0.197,0.8,0.194,6,89,95,95,True
9138,2012-01-21,1,1,1,15,0,6,0,3,0.2,0.197,0.8,0.194,6,113,119,119,True
9139,2012-01-21,1,1,1,16,0,6,0,2,0.2,0.1818,0.8,0.2985,5,113,118,118,True
9140,2012-01-21,1,1,1,17,0,6,0,2,0.2,0.1818,0.8,0.3881,7,99,106,106,True
9141,2012-01-21,1,1,1,18,0,6,0,2,0.2,0.1818,0.75,0.3881,3,107,110,110,True
9142,2012-01-21,1,1,1,19,0,6,0,2,0.18,0.1515,0.8,0.3881,0,85,85,85,True
9143,2012-01-21,1,1,1,20,0,6,0,2,0.18,0.1667,0.8,0.2985,5,62,67,67,True
9144,2012-01-21,1,1,1,21,0,6,0,1,0.18,0.1515,0.74,0.3284,5,64,69,69,True
9145,2012-01-21,1,1,1,22,0,6,0,2,0.18,0.1667,0.74,0.2985,3,56,59,59,True
9146,2012-01-21,1,1,1,23,0,6,0,2,0.16,0.1515,0.8,0.2537,1,51,52,52,True
9147,2012-01-22,1,1,1,0,0,0,0,1,0.16,0.1364,0.8,0.2985,1,51,52,52,True
9148,2012-01-22,1,1,1,1,0,0,0,2,0.18,0.1667,0.74,0.2985,1,49,50,50,True
9149,2012-01-22,1,1,1,2,0,0,0,2,0.18,0.1667,0.74,0.2836,1,46,47,47,True
9150,2012-01-22,1,1,1,3,0,0,0,2,0.18,0.1667,0.69,0.2836,1,20,21,21,True
9151,2012-01-22,1,1,1,4,0,0,0,3,0.16,0.1364,0.8,0.2836,1,1,2,2,True
9152,2012-01-22,1,1,1,5,0,0,0,3,0.16,0.1515,0.74,0.2239,1,2,3,3,True
9153,2012-01-22,1,1,1,6,0,0,0,2,0.16,0.1515,0.74,0.2239,0,4,4,4,True
9154,2012-01-22,1,1,1,7,0,0,0,2,0.16,0.1515,0.74,0.2239,2,11,13,13,True
9155,2012-01-22,1,1,1,8,0,0,0,2,0.16,0.1515,0.74,0.2239,3,29,32,32,True
9156,2012-01-22,1,1,1,9,0,0,0,2,0.16,0.1515,0.74,0.2239,9,54,63,63,True
9157,2012-01-22,1,1,1,10,0,0,0,2,0.16,0.1364,0.74,0.2836,9,120,129,129,True
9158,2012-01-22,1,1,1,11,0,0,0,3,0.16,0.1515,0.8,0.2537,18,115,133,133,True
9159,2012-01-22,1,1,1,12,0,0,0,2,0.16,0.1515,0.8,0.2239,24,161,185,185,True
9160,2012-01-22,1,1,1,13,0,0,0,2,0.16,0.1818,0.8,0.1343,24,175,199,199,True
9161,2012-01-22,1,1,1,14,0,0,0,2,0.16,0.1667,0.8,0.1642,19,163,182,182,True
9162,2012-01-22,1,1,1,15,0,0,0,2,0.16,0.1515,0.8,0.194,27,149,176,176,True
9163,2012-01-22,1,1,1,16,0,0,0,2,0.16,0.1515,0.8,0.194,12,143,155,155,True
9164,2012-01-22,1,1,1,17,0,0,0,2,0.16,0.1818,0.8,0.1045,8,100,108,108,True
9165,2012-01-22,1,1,1,18,0,0,0,3,0.16,0.1818,0.86,0.1045,11,110,121,121,True
9166,2012-01-22,1,1,1,19,0,0,0,3,0.16,0.1818,0.86,0.1045,9,80,89,89,True
9167,2012-01-22,1,1,1,20,0,0,0,3,0.16,0.1667,0.86,0.1642,5,69,74,74,True
9168,2012-01-22,1,1,1,21,0,0,0,3,0.16,0.1818,0.86,0.1045,8,36,44,44,True
9169,2012-01-22,1,1,1,22,0,0,0,2,0.16,0.197,0.93,0.0896,0,58,58,58,True
9170,2012-01-22,1,1,1,23,0,0,0,2,0.16,0.1818,0.93,0.1045,2,35,37,37,True
9171,2012-01-23,1,1,1,0,0,1,1,2,0.18,0.2424,0.86,0.0,2,17,19,19,True
9172,2012-01-23,1,1,1,1,0,1,1,2,0.18,0.2121,0.86,0.1045,0,4,4,4,True
9173,2012-01-23,1,1,1,2,0,1,1,2,0.18,0.2121,0.86,0.1045,0,2,2,2,True
9174,2012-01-23,1,1,1,3,0,1,1,2,0.18,0.2424,0.86,0.0,0,1,1,1,True
9175,2012-01-23,1,1,1,4,0,1,1,2,0.2,0.2576,0.8,0.0,0,1,1,1,True
9176,2012-01-23,1,1,1,5,0,1,1,2,0.2,0.2576,0.86,0.0,0,19,19,19,True
9177,2012-01-23,1,1,1,6,0,1,1,2,0.2,0.2576,0.86,0.0,6,36,42,42,True
9178,2012-01-23,1,1,1,7,0,1,1,3,0.2,0.2576,0.86,0.0,8,114,122,122,True
9179,2012-01-23,1,1,1,8,0,1,1,3,0.2,0.2121,0.86,0.1343,5,267,272,272,True
9180,2012-01-23,1,1,1,9,0,1,1,2,0.2,0.2273,0.86,0.0896,13,198,211,211,True
9181,2012-01-23,1,1,1,10,0,1,1,2,0.2,0.2576,0.93,0.0,10,139,149,149,True
9182,2012-01-23,1,1,1,11,0,1,1,2,0.2,0.2273,0.93,0.0896,5,57,62,62,True
9183,2012-01-23,1,1,1,12,0,1,1,2,0.22,0.2727,0.93,0.0,10,52,62,62,True
9184,2012-01-23,1,1,1,13,0,1,1,3,0.22,0.2576,0.93,0.0896,5,32,37,37,True
9185,2012-01-23,1,1,1,14,0,1,1,3,0.22,0.2273,0.93,0.194,13,48,61,61,True
9186,2012-01-23,1,1,1,15,0,1,1,2,0.22,0.2121,1.0,0.2239,10,64,74,74,True
9187,2012-01-23,1,1,1,16,0,1,1,2,0.24,0.2424,0.93,0.1642,14,108,122,122,True
9188,2012-01-23,1,1,1,17,0,1,1,2,0.24,0.2576,0.96,0.1045,6,270,276,276,True
9189,2012-01-23,1,1,1,18,0,1,1,2,0.24,0.2424,0.93,0.1343,7,275,282,282,True
9190,2012-01-23,1,1,1,19,0,1,1,2,0.26,0.2576,0.93,0.1642,9,211,220,220,True
9191,2012-01-23,1,1,1,20,0,1,1,2,0.26,0.2576,1.0,0.1642,8,161,169,169,True
9192,2012-01-23,1,1,1,21,0,1,1,2,0.26,0.2424,1.0,0.2836,8,112,120,120,True
9193,2012-01-23,1,1,1,22,0,1,1,2,0.26,0.2424,1.0,0.2836,4,64,68,68,True
9194,2012-01-23,1,1,1,23,0,1,1,2,0.28,0.2576,0.93,0.3284,2,35,37,37,True
9195,2012-01-24,1,1,1,0,0,2,1,2,0.3,0.2879,1.0,0.2836,6,19,25,25,True
9196,2012-01-24,1,1,1,1,0,2,1,2,0.32,0.303,0.93,0.2537,2,7,9,9,True
9197,2012-01-24,1,1,1,2,0,2,1,2,0.32,0.303,0.93,0.2239,2,6,8,8,True
9198,2012-01-24,1,1,1,3,0,2,1,2,0.32,0.3333,0.93,0.1343,0,3,3,3,True
9199,2012-01-24,1,1,1,4,0,2,1,2,0.3,0.3182,1.0,0.0896,0,2,2,2,True
9200,2012-01-24,1,1,1,5,0,2,1,2,0.3,0.3182,1.0,0.0896,0,26,26,26,True
9201,2012-01-24,1,1,1,6,0,2,1,2,0.32,0.3182,0.93,0.194,1,88,89,89,True
9202,2012-01-24,1,1,1,7,0,2,1,2,0.32,0.3333,0.93,0.1343,11,221,232,232,True
9203,2012-01-24,1,1,1,8,0,2,1,2,0.32,0.3333,0.93,0.1343,11,479,490,490,True
9204,2012-01-24,1,1,1,9,0,2,1,2,0.32,0.3333,0.87,0.0896,11,244,255,255,True
9205,2012-01-24,1,1,1,10,0,2,1,1,0.32,0.3333,0.93,0.0896,23,93,116,116,True
9206,2012-01-24,1,1,1,11,0,2,1,1,0.34,0.3333,0.87,0.1343,30,123,153,153,True
9207,2012-01-24,1,1,1,12,0,2,1,1,0.34,0.3333,0.87,0.1642,25,150,175,175,True
9208,2012-01-24,1,1,1,13,0,2,1,1,0.34,0.3333,0.87,0.1642,33,170,203,203,True
9209,2012-01-24,1,1,1,14,0,2,1,1,0.36,0.3485,0.81,0.2239,35,138,173,173,True
9210,2012-01-24,1,1,1,15,0,2,1,2,0.4,0.4091,0.71,0.1642,52,156,208,208,True
9211,2012-01-24,1,1,1,16,0,2,1,1,0.4,0.4091,0.71,0.1343,35,243,278,278,True
9212,2012-01-24,1,1,1,17,0,2,1,1,0.42,0.4242,0.67,0.0896,41,474,515,515,True
9213,2012-01-24,1,1,1,18,0,2,1,1,0.4,0.4091,0.62,0.0896,32,391,423,423,True
9214,2012-01-24,1,1,1,19,0,2,1,1,0.44,0.4394,0.51,0.0896,20,311,331,331,True
9215,2012-01-24,1,1,1,20,0,2,1,1,0.32,0.3485,0.76,0.0,18,211,229,229,True
9216,2012-01-24,1,1,1,21,0,2,1,1,0.36,0.3788,0.71,0.0,18,154,172,172,True
9217,2012-01-24,1,1,1,22,0,2,1,1,0.32,0.3485,0.81,0.0,14,111,125,125,True
9218,2012-01-24,1,1,1,23,0,2,1,1,0.32,0.3485,0.76,0.0,19,80,99,99,True
9219,2012-01-25,1,1,1,0,0,3,1,1,0.26,0.303,0.93,0.0,6,25,31,31,True
9220,2012-01-25,1,1,1,1,0,3,1,1,0.3,0.2879,0.7,0.2239,4,9,13,13,True
9221,2012-01-25,1,1,1,2,0,3,1,1,0.28,0.2727,0.7,0.194,3,3,6,6,True
9222,2012-01-25,1,1,1,3,0,3,1,1,0.26,0.2576,0.75,0.194,0,1,1,1,True
9223,2012-01-25,1,1,1,4,0,3,1,1,0.26,0.2424,0.7,0.2836,0,4,4,4,True
9224,2012-01-25,1,1,1,5,0,3,1,1,0.26,0.2424,0.7,0.2836,0,33,33,33,True
9225,2012-01-25,1,1,1,6,0,3,1,1,0.24,0.2273,0.73,0.2239,1,87,88,88,True
9226,2012-01-25,1,1,1,7,0,3,1,1,0.24,0.2273,0.75,0.2239,14,243,257,257,True
9227,2012-01-25,1,1,1,8,0,3,1,1,0.24,0.2273,0.7,0.2537,18,495,513,513,True
9228,2012-01-25,1,1,1,9,0,3,1,1,0.24,0.2273,0.7,0.2537,18,218,236,236,True
9229,2012-01-25,1,1,1,10,0,3,1,2,0.26,0.2273,0.7,0.3284,30,111,141,141,True
9230,2012-01-25,1,1,1,11,0,3,1,2,0.3,0.2727,0.61,0.2985,52,105,157,157,True
9231,2012-01-25,1,1,1,12,0,3,1,1,0.32,0.3333,0.53,0.1343,46,147,193,193,True
9232,2012-01-25,1,1,1,13,0,3,1,1,0.34,0.3333,0.49,0.1343,63,149,212,212,True
9233,2012-01-25,1,1,1,14,0,3,1,1,0.34,0.3485,0.49,0.0896,53,107,160,160,True
9234,2012-01-25,1,1,1,15,0,3,1,1,0.36,0.3788,0.46,0.0,30,125,155,155,True
9235,2012-01-25,1,1,1,16,0,3,1,1,0.34,0.3333,0.53,0.1642,29,217,246,246,True
9236,2012-01-25,1,1,1,17,0,3,1,1,0.36,0.3485,0.53,0.1642,27,443,470,470,True
9237,2012-01-25,1,1,1,18,0,3,1,1,0.32,0.3333,0.66,0.1343,24,415,439,439,True
9238,2012-01-25,1,1,1,19,0,3,1,2,0.34,0.3636,0.53,0.0,5,311,316,316,True
9239,2012-01-25,1,1,1,20,0,3,1,1,0.32,0.3182,0.61,0.194,10,225,235,235,True
9240,2012-01-25,1,1,1,21,0,3,1,1,0.3,0.3333,0.65,0.0,19,166,185,185,True
9241,2012-01-25,1,1,1,22,0,3,1,1,0.3,0.3182,0.65,0.0896,12,101,113,113,True
9242,2012-01-25,1,1,1,23,0,3,1,2,0.28,0.3182,0.65,0.0,3,63,66,66,True
9243,2012-01-26,1,1,1,0,0,4,1,2,0.28,0.2879,0.75,0.1045,3,22,25,25,True
9244,2012-01-26,1,1,1,1,0,4,1,2,0.28,0.3182,0.75,0.0,5,16,21,21,True
9245,2012-01-26,1,1,1,2,0,4,1,2,0.28,0.2727,0.75,0.1642,1,6,7,7,True
9246,2012-01-26,1,1,1,3,0,4,1,2,0.28,0.303,0.75,0.0896,1,5,6,6,True
9247,2012-01-26,1,1,1,4,0,4,1,1,0.28,0.3182,0.75,0.0,0,3,3,3,True
9248,2012-01-26,1,1,1,5,0,4,1,2,0.3,0.3182,0.75,0.1045,0,28,28,28,True
9249,2012-01-26,1,1,1,6,0,4,1,2,0.28,0.3182,0.81,0.0,0,88,88,88,True
9250,2012-01-26,1,1,1,7,0,4,1,2,0.28,0.303,0.81,0.0896,11,228,239,239,True
9251,2012-01-26,1,1,1,8,0,4,1,2,0.28,0.303,0.81,0.0896,16,499,515,515,True
9252,2012-01-26,1,1,1,9,0,4,1,2,0.3,0.3333,0.81,0.0,18,256,274,274,True
9253,2012-01-26,1,1,1,10,0,4,1,2,0.3,0.303,0.81,0.1343,16,92,108,108,True
9254,2012-01-26,1,1,1,11,0,4,1,2,0.3,0.3182,0.87,0.1045,11,100,111,111,True
9255,2012-01-26,1,1,1,12,0,4,1,2,0.34,0.3333,0.81,0.1343,29,136,165,165,True
9256,2012-01-26,1,1,1,13,0,4,1,2,0.38,0.3939,0.71,0.0,17,156,173,173,True
9257,2012-01-26,1,1,1,14,0,4,1,2,0.4,0.4091,0.71,0.1045,16,112,128,128,True
9258,2012-01-26,1,1,1,15,0,4,1,2,0.42,0.4242,0.71,0.1045,22,142,164,164,True
9259,2012-01-26,1,1,1,16,0,4,1,2,0.4,0.4091,0.71,0.0896,15,209,224,224,True
9260,2012-01-26,1,1,1,17,0,4,1,2,0.42,0.4242,0.71,0.0,16,397,413,413,True
9261,2012-01-26,1,1,1,18,0,4,1,2,0.42,0.4242,0.71,0.0,12,394,406,406,True
9262,2012-01-26,1,1,1,19,0,4,1,2,0.4,0.4091,0.76,0.1045,11,302,313,313,True
9263,2012-01-26,1,1,1,20,0,4,1,2,0.4,0.4091,0.82,0.1343,8,216,224,224,True
9264,2012-01-26,1,1,1,21,0,4,1,2,0.4,0.4091,0.76,0.1045,8,184,192,192,True
9265,2012-01-26,1,1,1,22,0,4,1,1,0.38,0.3939,0.82,0.1045,3,139,142,142,True
9266,2012-01-26,1,1,1,23,0,4,1,2,0.4,0.4091,0.82,0.0,5,86,91,91,True
9267,2012-01-27,1,1,1,0,0,5,1,2,0.4,0.4091,0.82,0.2537,6,32,38,38,True
9268,2012-01-27,1,1,1,1,0,5,1,2,0.4,0.4091,0.87,0.2239,6,23,29,29,True
9269,2012-01-27,1,1,1,2,0,5,1,1,0.42,0.4242,0.94,0.1343,2,11,13,13,True
9270,2012-01-27,1,1,1,3,0,5,1,2,0.42,0.4242,0.94,0.2836,3,5,8,8,True
9271,2012-01-27,1,1,1,4,0,5,1,2,0.4,0.4091,1.0,0.2985,1,3,4,4,True
9272,2012-01-27,1,1,1,5,0,5,1,2,0.42,0.4242,0.94,0.3284,0,24,24,24,True
9273,2012-01-27,1,1,1,6,0,5,1,2,0.42,0.4242,1.0,0.3284,0,72,72,72,True
9274,2012-01-27,1,1,1,7,0,5,1,2,0.42,0.4242,1.0,0.2985,6,128,134,134,True
9275,2012-01-27,1,1,1,8,0,5,1,3,0.5,0.4848,0.88,0.2836,14,206,220,220,True
9276,2012-01-27,1,1,1,9,0,5,1,3,0.5,0.4848,0.88,0.2836,6,101,107,107,True
9277,2012-01-27,1,1,1,10,0,5,1,3,0.48,0.4697,1.0,0.1642,9,117,126,126,True
9278,2012-01-27,1,1,1,11,0,5,1,2,0.48,0.4697,0.94,0.1343,10,95,105,105,True
9279,2012-01-27,1,1,1,12,0,5,1,2,0.5,0.4848,0.88,0.1642,25,155,180,180,True
9280,2012-01-27,1,1,1,13,0,5,1,1,0.5,0.4848,0.59,0.4627,26,175,201,201,True
9281,2012-01-27,1,1,1,14,0,5,1,1,0.5,0.4848,0.55,0.4775,23,153,176,176,True
9282,2012-01-27,1,1,1,15,0,5,1,1,0.48,0.4697,0.51,0.3284,27,170,197,197,True
9283,2012-01-27,1,1,1,16,0,5,1,1,0.44,0.4394,0.51,0.4775,26,241,267,267,True
9284,2012-01-27,1,1,1,17,0,5,1,1,0.42,0.4242,0.5,0.4775,16,406,422,422,True
9285,2012-01-27,1,1,1,18,0,5,1,1,0.4,0.4091,0.5,0.4775,20,363,383,383,True
9286,2012-01-27,1,1,1,19,0,5,1,1,0.36,0.3333,0.5,0.3881,10,241,251,251,True
9287,2012-01-27,1,1,1,20,0,5,1,1,0.34,0.303,0.53,0.3582,6,153,159,159,True
9288,2012-01-27,1,1,1,21,0,5,1,1,0.34,0.2879,0.53,0.4775,8,127,135,135,True
9289,2012-01-27,1,1,1,22,0,5,1,1,0.34,0.303,0.49,0.3881,11,108,119,119,True
9290,2012-01-27,1,1,1,23,0,5,1,1,0.32,0.2879,0.49,0.4179,8,78,86,86,True
9291,2012-01-28,1,1,1,0,0,6,0,1,0.3,0.2879,0.52,0.2836,1,68,69,69,True
9292,2012-01-28,1,1,1,1,0,6,0,1,0.3,0.303,0.52,0.1642,1,57,58,58,True
9293,2012-01-28,1,1,1,2,0,6,0,1,0.26,0.303,0.6,0.0,3,38,41,41,True
9294,2012-01-28,1,1,1,3,0,6,0,1,0.26,0.2879,0.6,0.0896,1,16,17,17,True
9295,2012-01-28,1,1,1,4,0,6,0,1,0.26,0.2576,0.6,0.1642,0,8,8,8,True
9296,2012-01-28,1,1,1,5,0,6,0,1,0.24,0.2576,0.75,0.0896,0,10,10,10,True
9297,2012-01-28,1,1,1,6,0,6,0,1,0.24,0.2879,0.7,0.0,3,12,15,15,True
9298,2012-01-28,1,1,1,7,0,6,0,1,0.22,0.2727,0.75,0.0,3,28,31,31,True
9299,2012-01-28,1,1,1,8,0,6,0,1,0.2,0.2273,0.8,0.0896,9,82,91,91,True
9300,2012-01-28,1,1,1,9,0,6,0,1,0.22,0.2727,0.8,0.0,13,145,158,158,True
9301,2012-01-28,1,1,1,10,0,6,0,1,0.26,0.2727,0.7,0.1343,27,164,191,191,True
9302,2012-01-28,1,1,1,11,0,6,0,1,0.3,0.303,0.56,0.1343,55,241,296,296,True
9303,2012-01-28,1,1,1,12,0,6,0,1,0.3,0.2879,0.61,0.2836,70,244,314,314,True
9304,2012-01-28,1,1,1,13,0,6,0,1,0.34,0.3182,0.57,0.2537,80,293,373,373,True
9305,2012-01-28,1,1,1,14,0,6,0,1,0.38,0.3939,0.5,0.3881,114,239,353,353,True
9306,2012-01-28,1,1,1,15,0,6,0,1,0.4,0.4091,0.47,0.3284,90,320,410,410,True
9307,2012-01-28,1,1,1,16,0,6,0,1,0.42,0.4242,0.44,0.3582,114,276,390,390,True
9308,2012-01-28,1,1,1,17,0,6,0,1,0.42,0.4242,0.44,0.3881,57,233,290,290,True
9309,2012-01-28,1,1,1,18,0,6,0,1,0.42,0.4242,0.41,0.2239,40,201,241,241,True
9310,2012-01-28,1,1,1,19,0,6,0,2,0.42,0.4242,0.41,0.4775,33,173,206,206,True
9311,2012-01-28,1,1,1,20,0,6,0,1,0.4,0.4091,0.35,0.3881,5,115,120,120,True
9312,2012-01-28,1,1,1,21,0,6,0,1,0.36,0.3333,0.29,0.3582,18,109,127,127,True
9313,2012-01-28,1,1,1,22,0,6,0,1,0.34,0.3333,0.34,0.194,6,97,103,103,True
9314,2012-01-28,1,1,1,23,0,6,0,1,0.32,0.3182,0.31,0.194,6,79,85,85,True
9315,2012-01-29,1,1,1,0,0,0,0,1,0.3,0.2879,0.33,0.2239,15,81,96,96,True
9316,2012-01-29,1,1,1,1,0,0,0,1,0.3,0.2727,0.28,0.3582,5,68,73,73,True
9317,2012-01-29,1,1,1,2,0,0,0,1,0.28,0.2576,0.26,0.3284,3,48,51,51,True
9318,2012-01-29,1,1,1,3,0,0,0,1,0.26,0.2576,0.28,0.194,4,17,21,21,True
9319,2012-01-29,1,1,1,4,0,0,0,1,0.24,0.2576,0.3,0.0,0,5,5,5,True
9320,2012-01-29,1,1,1,5,0,0,0,1,0.2,0.2121,0.51,0.1343,1,6,7,7,True
9321,2012-01-29,1,1,1,6,0,0,0,1,0.2,0.2273,0.4,0.1045,1,4,5,5,True
9322,2012-01-29,1,1,1,7,0,0,0,1,0.2,0.2121,0.37,0.1343,0,12,12,12,True
9323,2012-01-29,1,1,1,8,0,0,0,1,0.18,0.197,0.4,0.1343,9,61,70,70,True
9324,2012-01-29,1,1,1,9,0,0,0,1,0.18,0.197,0.43,0.1343,13,98,111,111,True
9325,2012-01-29,1,1,1,10,0,0,0,1,0.24,0.2424,0.35,0.1343,38,153,191,191,True
9326,2012-01-29,1,1,1,11,0,0,0,1,0.28,0.2727,0.28,0.2239,57,198,255,255,True
9327,2012-01-29,1,1,1,12,0,0,0,1,0.32,0.303,0.26,0.2239,73,215,288,288,True
9328,2012-01-29,1,1,1,13,0,0,0,1,0.32,0.303,0.26,0.2239,78,238,316,316,True
9329,2012-01-29,1,1,1,14,0,0,0,1,0.32,0.303,0.26,0.2537,51,229,280,280,True
9330,2012-01-29,1,1,1,15,0,0,0,1,0.36,0.3333,0.25,0.2836,68,242,310,310,True
9331,2012-01-29,1,1,1,16,0,0,0,1,0.36,0.3333,0.21,0.4179,54,268,322,322,True
9332,2012-01-29,1,1,1,17,0,0,0,1,0.36,0.3333,0.21,0.4179,33,201,234,234,True
9333,2012-01-29,1,1,1,18,0,0,0,1,0.34,0.303,0.23,0.3582,17,151,168,168,True
9334,2012-01-29,1,1,1,19,0,0,0,1,0.32,0.303,0.29,0.2537,14,145,159,159,True
9335,2012-01-29,1,1,1,20,0,0,0,1,0.3,0.2879,0.39,0.2239,13,98,111,111,True
9336,2012-01-29,1,1,1,21,0,0,0,1,0.3,0.2879,0.33,0.2836,0,69,69,69,True
9337,2012-01-29,1,1,1,22,0,0,0,1,0.32,0.2879,0.26,0.3881,7,57,64,64,True
9338,2012-01-29,1,1,1,23,0,0,0,1,0.3,0.2727,0.33,0.3284,4,21,25,25,True
9339,2012-01-30,1,1,1,0,0,1,1,2,0.32,0.2879,0.26,0.4179,0,10,10,10,True
9340,2012-01-30,1,1,1,1,0,1,1,1,0.26,0.2273,0.6,0.3582,0,9,9,9,True
9341,2012-01-30,1,1,1,2,0,1,1,1,0.24,0.2121,0.48,0.3582,1,6,7,7,True
9342,2012-01-30,1,1,1,3,0,1,1,1,0.24,0.2273,0.48,0.194,0,4,4,4,True
9343,2012-01-30,1,1,1,4,0,1,1,1,0.2,0.2121,0.51,0.1343,0,5,5,5,True
9344,2012-01-30,1,1,1,5,0,1,1,1,0.2,0.2121,0.51,0.1343,0,26,26,26,True
9345,2012-01-30,1,1,1,6,0,1,1,1,0.22,0.2121,0.44,0.2537,0,80,80,80,True
9346,2012-01-30,1,1,1,7,0,1,1,1,0.22,0.2121,0.44,0.2836,4,221,225,225,True
9347,2012-01-30,1,1,1,8,0,1,1,1,0.2,0.197,0.47,0.2239,12,481,493,493,True
9348,2012-01-30,1,1,1,9,0,1,1,1,0.2,0.197,0.47,0.2239,5,193,198,198,True
9349,2012-01-30,1,1,1,10,0,1,1,1,0.22,0.2121,0.41,0.2836,3,82,85,85,True
9350,2012-01-30,1,1,1,11,0,1,1,1,0.26,0.2576,0.38,0.0,6,93,99,99,True
9351,2012-01-30,1,1,1,12,0,1,1,1,0.26,0.2273,0.35,0.3881,5,129,134,134,True
9352,2012-01-30,1,1,1,13,0,1,1,1,0.3,0.2879,0.31,0.194,15,117,132,132,True
9353,2012-01-30,1,1,1,14,0,1,1,1,0.32,0.3333,0.24,0.1343,15,100,115,115,True
9354,2012-01-30,1,1,1,15,0,1,1,1,0.32,0.3182,0.24,0.194,7,131,138,138,True
9355,2012-01-30,1,1,1,16,0,1,1,1,0.34,0.3333,0.25,0.194,11,210,221,221,True
9356,2012-01-30,1,1,1,17,0,1,1,1,0.36,0.3485,0.21,0.194,16,422,438,438,True
9357,2012-01-30,1,1,1,18,0,1,1,1,0.34,0.3333,0.23,0.1642,11,399,410,410,True
9358,2012-01-30,1,1,1,19,0,1,1,1,0.3,0.3182,0.45,0.1045,8,298,306,306,True
9359,2012-01-30,1,1,1,20,0,1,1,1,0.3,0.303,0.39,0.1642,2,179,181,181,True
9360,2012-01-30,1,1,1,21,0,1,1,1,0.3,0.303,0.42,0.1642,3,159,162,162,True
9361,2012-01-30,1,1,1,22,0,1,1,1,0.28,0.2727,0.48,0.2239,2,92,94,94,True
9362,2012-01-30,1,1,1,23,0,1,1,1,0.26,0.2576,0.6,0.194,0,52,52,52,True
9363,2012-01-31,1,1,1,0,0,2,1,1,0.28,0.2727,0.52,0.2537,0,15,15,15,True
9364,2012-01-31,1,1,1,1,0,2,1,1,0.3,0.2727,0.42,0.2985,1,7,8,8,True
9365,2012-01-31,1,1,1,2,0,2,1,1,0.3,0.2879,0.42,0.2239,0,2,2,2,True
9366,2012-01-31,1,1,1,3,0,2,1,1,0.3,0.2879,0.45,0.2239,0,2,2,2,True
9367,2012-01-31,1,1,1,4,0,2,1,1,0.3,0.2879,0.49,0.194,0,1,1,1,True
9368,2012-01-31,1,1,1,5,0,2,1,1,0.3,0.2879,0.49,0.194,0,22,22,22,True
9369,2012-01-31,1,1,1,6,0,2,1,1,0.28,0.2727,0.52,0.1642,0,104,104,104,True
9370,2012-01-31,1,1,1,7,0,2,1,1,0.26,0.2576,0.6,0.194,6,273,279,279,True
9371,2012-01-31,1,1,1,8,0,2,1,1,0.26,0.2727,0.6,0.1045,14,498,512,512,True
9372,2012-01-31,1,1,1,9,0,2,1,1,0.3,0.2879,0.52,0.194,30,231,261,261,True
9373,2012-01-31,1,1,1,10,0,2,1,2,0.32,0.3182,0.57,0.194,34,110,144,144,True
9374,2012-01-31,1,1,1,11,0,2,1,1,0.4,0.4091,0.37,0.2836,14,125,139,139,True
9375,2012-01-31,1,1,1,12,0,2,1,1,0.4,0.4091,0.43,0.2985,13,181,194,194,True
9376,2012-01-31,1,1,1,13,0,2,1,1,0.46,0.4545,0.36,0.2239,27,171,198,198,True
9377,2012-01-31,1,1,1,14,0,2,1,1,0.5,0.4848,0.29,0.3284,18,142,160,160,True
9378,2012-01-31,1,1,1,15,0,2,1,1,0.54,0.5152,0.26,0.4478,27,150,177,177,True
9379,2012-01-31,1,1,1,16,0,2,1,1,0.54,0.5152,0.26,0.4478,30,277,307,307,True
9380,2012-01-31,1,1,1,17,0,2,1,1,0.54,0.5152,0.26,0.4179,41,499,540,540,True
9381,2012-01-31,1,1,1,18,0,2,1,1,0.54,0.5152,0.24,0.3582,16,486,502,502,True
9382,2012-01-31,1,1,1,19,0,2,1,1,0.5,0.4848,0.29,0.2836,22,306,328,328,True
9383,2012-01-31,1,1,1,20,0,2,1,1,0.4,0.4091,0.58,0.1045,15,223,238,238,True
9384,2012-01-31,1,1,1,21,0,2,1,1,0.46,0.4545,0.33,0.2985,3,162,165,165,True
9385,2012-01-31,1,1,1,22,0,2,1,1,0.44,0.4394,0.35,0.2985,11,118,129,129,True
9386,2012-01-31,1,1,1,23,0,2,1,1,0.44,0.4394,0.38,0.2537,2,61,63,63,True
9387,2012-02-01,1,1,2,0,0,3,1,1,0.44,0.4394,0.38,0.2836,0,31,31,31,True
9388,2012-02-01,1,1,2,1,0,3,1,1,0.44,0.4394,0.41,0.2836,0,4,4,4,True
9389,2012-02-01,1,1,2,2,0,3,1,1,0.44,0.4394,0.44,0.2836,1,6,7,7,True
9390,2012-02-01,1,1,2,3,0,3,1,1,0.44,0.4394,0.44,0.194,0,3,3,3,True
9391,2012-02-01,1,1,2,4,0,3,1,1,0.4,0.4091,0.5,0.1642,0,1,1,1,True
9392,2012-02-01,1,1,2,5,0,3,1,1,0.4,0.4091,0.5,0.1642,0,18,18,18,True
9393,2012-02-01,1,1,2,6,0,3,1,3,0.4,0.4091,0.54,0.1642,0,67,67,67,True
9394,2012-02-01,1,1,2,7,0,3,1,3,0.38,0.3939,0.62,0.0896,7,201,208,208,True
9395,2012-02-01,1,1,2,8,0,3,1,3,0.36,0.3636,0.73,0.1045,15,499,514,514,True
9396,2012-02-01,1,1,2,9,0,3,1,2,0.36,0.3485,0.71,0.194,9,267,276,276,True
9397,2012-02-01,1,1,2,10,0,3,1,1,0.4,0.4091,0.62,0.1343,9,124,133,133,True
9398,2012-02-01,1,1,2,11,0,3,1,1,0.4,0.4091,0.58,0.1642,27,116,143,143,True
9399,2012-02-01,1,1,2,12,0,3,1,1,0.44,0.4394,0.54,0.1045,26,153,179,179,True
9400,2012-02-01,1,1,2,13,0,3,1,1,0.46,0.4545,0.47,0.2239,12,174,186,186,True
9401,2012-02-01,1,1,2,14,0,3,1,1,0.62,0.6212,0.33,0.2239,33,159,192,192,True
9402,2012-02-01,1,1,2,15,0,3,1,1,0.6,0.6212,0.35,0.2836,25,169,194,194,True
9403,2012-02-01,1,1,2,16,0,3,1,1,0.6,0.6212,0.4,0.2239,22,261,283,283,True
9404,2012-02-01,1,1,2,17,0,3,1,1,0.58,0.5455,0.43,0.194,31,499,530,530,True
9405,2012-02-01,1,1,2,18,0,3,1,1,0.56,0.5303,0.46,0.1642,12,499,511,511,True
9406,2012-02-01,1,1,2,19,0,3,1,1,0.54,0.5152,0.52,0.2836,20,315,335,335,True
9407,2012-02-01,1,1,2,20,0,3,1,1,0.52,0.5,0.52,0.1642,10,254,264,264,True
9408,2012-02-01,1,1,2,21,0,3,1,1,0.52,0.5,0.52,0.1642,16,217,233,233,True
9409,2012-02-01,1,1,2,22,0,3,1,1,0.5,0.4848,0.55,0.194,7,133,140,140,True
9410,2012-02-01,1,1,2,23,0,3,1,1,0.46,0.4545,0.63,0.0896,22,75,97,97,True
9411,2012-02-02,1,1,2,0,0,4,1,1,0.46,0.4545,0.59,0.1343,7,24,31,31,True
9412,2012-02-02,1,1,2,1,0,4,1,2,0.46,0.4545,0.55,0.0,3,14,17,17,True
9413,2012-02-02,1,1,2,2,0,4,1,2,0.42,0.4242,0.67,0.1343,2,7,9,9,True
9414,2012-02-02,1,1,2,3,0,4,1,2,0.42,0.4242,0.67,0.1343,0,2,2,2,True
9415,2012-02-02,1,1,2,4,0,4,1,3,0.4,0.4091,0.82,0.0896,0,1,1,1,True
9416,2012-02-02,1,1,2,5,0,4,1,3,0.4,0.4091,0.82,0.0,0,19,19,19,True
9417,2012-02-02,1,1,2,6,0,4,1,3,0.36,0.3788,0.9,0.0,1,73,74,74,True
9418,2012-02-02,1,1,2,7,0,4,1,3,0.36,0.3788,0.93,0.0,4,201,205,205,True
9419,2012-02-02,1,1,2,8,0,4,1,3,0.4,0.4091,0.87,0.0,9,436,445,445,True
9420,2012-02-02,1,1,2,9,0,4,1,3,0.38,0.3939,0.87,0.0,15,213,228,228,True
9421,2012-02-02,1,1,2,10,0,4,1,3,0.42,0.4242,0.77,0.1045,6,72,78,78,True
9422,2012-02-02,1,1,2,11,0,4,1,3,0.4,0.4091,0.82,0.2537,6,99,105,105,True
9423,2012-02-02,1,1,2,12,0,4,1,1,0.42,0.4242,0.82,0.0,8,140,148,148,True
9424,2012-02-02,1,1,2,13,0,4,1,2,0.42,0.4242,0.77,0.0,13,124,137,137,True
9425,2012-02-02,1,1,2,14,0,4,1,1,0.4,0.4091,0.76,0.1045,12,129,141,141,True
9426,2012-02-02,1,1,2,15,0,4,1,1,0.46,0.4545,0.67,0.1642,24,150,174,174,True
9427,2012-02-02,1,1,2,16,0,4,1,1,0.46,0.4545,0.55,0.2836,18,211,229,229,True
9428,2012-02-02,1,1,2,17,0,4,1,1,0.42,0.4242,0.54,0.4775,13,437,450,450,True
9429,2012-02-02,1,1,2,18,0,4,1,1,0.4,0.4091,0.43,0.4627,17,393,410,410,True
9430,2012-02-02,1,1,2,19,0,4,1,1,0.38,0.3939,0.43,0.4775,16,311,327,327,True
9431,2012-02-02,1,1,2,20,0,4,1,1,0.36,0.3182,0.46,0.4775,9,204,213,213,True
9432,2012-02-02,1,1,2,21,0,4,1,1,0.34,0.303,0.46,0.4179,4,144,148,148,True
9433,2012-02-02,1,1,2,22,0,4,1,1,0.32,0.2879,0.49,0.4179,3,106,109,109,True
9434,2012-02-02,1,1,2,23,0,4,1,1,0.32,0.303,0.49,0.2537,0,61,61,61,True
9435,2012-02-03,1,1,2,0,0,5,1,1,0.32,0.2879,0.53,0.3881,1,37,38,38,True
9436,2012-02-03,1,1,2,1,0,5,1,1,0.3,0.2727,0.56,0.3284,3,19,22,22,True
9437,2012-02-03,1,1,2,2,0,5,1,1,0.3,0.2879,0.52,0.2239,0,6,6,6,True
9438,2012-02-03,1,1,2,3,0,5,1,1,0.28,0.2576,0.56,0.2985,0,4,4,4,True
9439,2012-02-03,1,1,2,4,0,5,1,1,0.26,0.2576,0.6,0.2239,0,2,2,2,True
9440,2012-02-03,1,1,2,5,0,5,1,1,0.26,0.2576,0.6,0.2239,0,17,17,17,True
9441,2012-02-03,1,1,2,6,0,5,1,1,0.24,0.2424,0.65,0.1642,0,88,88,88,True
9442,2012-02-03,1,1,2,7,0,5,1,1,0.24,0.2273,0.65,0.2239,10,216,226,226,True
9443,2012-02-03,1,1,2,8,0,5,1,1,0.24,0.2273,0.65,0.2239,12,429,441,441,True
9444,2012-02-03,1,1,2,9,0,5,1,1,0.24,0.2273,0.65,0.194,18,252,270,270,True
9445,2012-02-03,1,1,2,10,0,5,1,1,0.28,0.2576,0.56,0.2836,15,114,129,129,True
9446,2012-02-03,1,1,2,11,0,5,1,1,0.32,0.303,0.53,0.2985,15,149,164,164,True
9447,2012-02-03,1,1,2,12,0,5,1,1,0.34,0.3333,0.46,0.1343,25,191,216,216,True
9448,2012-02-03,1,1,2,13,0,5,1,1,0.36,0.3636,0.46,0.0,25,173,198,198,True
9449,2012-02-03,1,1,2,14,0,5,1,1,0.36,0.3485,0.46,0.2239,22,148,170,170,True
9450,2012-02-03,1,1,2,15,0,5,1,1,0.38,0.3939,0.4,0.0,48,168,216,216,True
9451,2012-02-03,1,1,2,16,0,5,1,1,0.4,0.4091,0.37,0.1045,36,275,311,311,True
9452,2012-02-03,1,1,2,17,0,5,1,1,0.4,0.4091,0.37,0.0896,30,458,488,488,True
9453,2012-02-03,1,1,2,18,0,5,1,1,0.38,0.3939,0.4,0.1343,17,368,385,385,True
9454,2012-02-03,1,1,2,19,0,5,1,1,0.34,0.3485,0.49,0.1045,11,256,267,267,True
9455,2012-02-03,1,1,2,20,0,5,1,1,0.34,0.3485,0.49,0.1045,8,155,163,163,True
9456,2012-02-03,1,1,2,21,0,5,1,1,0.34,0.3485,0.49,0.1045,8,126,134,134,True
9457,2012-02-03,1,1,2,22,0,5,1,1,0.34,0.3485,0.49,0.1045,3,116,119,119,True
9458,2012-02-03,1,1,2,23,0,5,1,1,0.26,0.2727,0.7,0.1045,3,74,77,77,True
9459,2012-02-04,1,1,2,0,0,6,0,1,0.26,0.2727,0.7,0.1045,10,76,86,86,True
9460,2012-02-04,1,1,2,1,0,6,0,1,0.26,0.2727,0.7,0.1045,0,43,43,43,True
9461,2012-02-04,1,1,2,2,0,6,0,1,0.24,0.2576,0.7,0.0896,6,38,44,44,True
9462,2012-02-04,1,1,2,3,0,6,0,1,0.24,0.2879,0.75,0.0,1,17,18,18,True
9463,2012-02-04,1,1,2,4,0,6,0,1,0.24,0.2576,0.81,0.0896,1,5,6,6,True
9464,2012-02-04,1,1,2,5,0,6,0,1,0.24,0.2576,0.81,0.0896,1,3,4,4,True
9465,2012-02-04,1,1,2,6,0,6,0,1,0.22,0.2273,0.87,0.1343,1,4,5,5,True
9466,2012-02-04,1,1,2,7,0,6,0,2,0.24,0.2424,0.87,0.1343,1,27,28,28,True
9467,2012-02-04,1,1,2,8,0,6,0,1,0.24,0.2879,0.87,0.0,4,86,90,90,True
9468,2012-02-04,1,1,2,9,0,6,0,1,0.24,0.2424,0.81,0.1343,16,141,157,157,True
9469,2012-02-04,1,1,2,10,0,6,0,1,0.24,0.2576,0.87,0.1045,31,193,224,224,True
9470,2012-02-04,1,1,2,11,0,6,0,1,0.3,0.3333,0.7,0.0,46,224,270,270,True
9471,2012-02-04,1,1,2,12,0,6,0,2,0.3,0.3182,0.7,0.0896,40,260,300,300,True
9472,2012-02-04,1,1,2,13,0,6,0,2,0.3,0.2879,0.7,0.194,58,244,302,302,True
9473,2012-02-04,1,1,2,14,0,6,0,2,0.32,0.303,0.66,0.2239,47,229,276,276,True
9474,2012-02-04,1,1,2,15,0,6,0,2,0.32,0.303,0.66,0.2239,61,244,305,305,True
9475,2012-02-04,1,1,2,16,0,6,0,2,0.34,0.3333,0.61,0.1642,20,123,143,143,True
9476,2012-02-04,1,1,2,17,0,6,0,3,0.3,0.2879,0.7,0.194,13,54,67,67,True
9477,2012-02-04,1,1,2,18,0,6,0,3,0.28,0.2727,0.75,0.1642,6,58,64,64,True
9478,2012-02-04,1,1,2,19,0,6,0,3,0.26,0.2727,0.87,0.1343,5,75,80,80,True
9479,2012-02-04,1,1,2,20,0,6,0,3,0.24,0.2273,0.93,0.194,4,73,77,77,True
9480,2012-02-04,1,1,2,21,0,6,0,3,0.24,0.2424,0.93,0.1343,4,74,78,78,True
9481,2012-02-04,1,1,2,22,0,6,0,2,0.24,0.2576,0.87,0.0896,4,91,95,95,True
9482,2012-02-04,1,1,2,23,0,6,0,2,0.24,0.2424,0.87,0.1343,4,66,70,70,True
9483,2012-02-05,1,1,2,0,0,0,0,2,0.24,0.2424,0.87,0.1343,3,58,61,61,True
9484,2012-02-05,1,1,2,1,0,0,0,2,0.24,0.2576,0.93,0.1045,5,46,51,51,True
9485,2012-02-05,1,1,2,2,0,0,0,2,0.24,0.2576,0.93,0.1045,4,59,63,63,True
9486,2012-02-05,1,1,2,3,0,0,0,3,0.24,0.2576,0.87,0.0896,4,13,17,17,True
9487,2012-02-05,1,1,2,4,0,0,0,2,0.24,0.2424,0.87,0.1343,0,9,9,9,True
9488,2012-02-05,1,1,2,5,0,0,0,3,0.26,0.2576,0.81,0.194,0,4,4,4,True
9489,2012-02-05,1,1,2,6,0,0,0,2,0.26,0.2424,0.7,0.2537,0,4,4,4,True
9490,2012-02-05,1,1,2,7,0,0,0,2,0.24,0.2424,0.75,0.1642,0,16,16,16,True
9491,2012-02-05,1,1,2,8,0,0,0,2,0.24,0.2424,0.75,0.1642,4,58,62,62,True
9492,2012-02-05,1,1,2,9,0,0,0,2,0.24,0.2273,0.7,0.2239,9,83,92,92,True
9493,2012-02-05,1,1,2,10,0,0,0,2,0.26,0.2424,0.65,0.2836,10,138,148,148,True
9494,2012-02-05,1,1,2,11,0,0,0,2,0.26,0.2576,0.7,0.194,22,160,182,182,True
9495,2012-02-05,1,1,2,12,0,0,0,2,0.26,0.2576,0.65,0.194,25,223,248,248,True
9496,2012-02-05,1,1,2,13,0,0,0,2,0.28,0.2727,0.61,0.1642,33,241,274,274,True
9497,2012-02-05,1,1,2,14,0,0,0,1,0.3,0.303,0.61,0.1642,40,203,243,243,True
9498,2012-02-05,1,1,2,15,0,0,0,2,0.3,0.2879,0.56,0.2537,55,217,272,272,True
9499,2012-02-05,1,1,2,16,0,0,0,1,0.3,0.2879,0.56,0.2239,35,261,296,296,True
9500,2012-02-05,1,1,2,17,0,0,0,1,0.32,0.3182,0.53,0.1642,31,275,306,306,True
9501,2012-02-05,1,1,2,18,0,0,0,1,0.3,0.2879,0.52,0.2537,10,171,181,181,True
9502,2012-02-05,1,1,2,19,0,0,0,1,0.3,0.2879,0.52,0.2239,6,63,69,69,True
9503,2012-02-05,1,1,2,20,0,0,0,1,0.28,0.2727,0.56,0.194,3,47,50,50,True
9504,2012-02-05,1,1,2,21,0,0,0,1,0.28,0.2879,0.56,0.1045,6,60,66,66,True
9505,2012-02-05,1,1,2,22,0,0,0,1,0.26,0.2727,0.6,0.1045,9,182,191,191,True
9506,2012-02-05,1,1,2,23,0,0,0,1,0.24,0.2424,0.7,0.1343,4,38,42,42,True
9507,2012-02-06,1,1,2,0,0,1,1,1,0.24,0.2424,0.65,0.1343,7,14,21,21,True
9508,2012-02-06,1,1,2,1,0,1,1,1,0.22,0.2576,0.75,0.0896,0,6,6,6,True
9509,2012-02-06,1,1,2,2,0,1,1,1,0.22,0.2727,0.75,0.0,0,3,3,3,True
9510,2012-02-06,1,1,2,4,0,1,1,1,0.18,0.2121,0.8,0.1045,0,2,2,2,True
9511,2012-02-06,1,1,2,5,0,1,1,1,0.18,0.2121,0.8,0.1045,0,17,17,17,True
9512,2012-02-06,1,1,2,6,0,1,1,1,0.16,0.1818,0.86,0.1045,0,72,72,72,True
9513,2012-02-06,1,1,2,7,0,1,1,1,0.16,0.1818,0.86,0.1045,5,229,234,234,True
9514,2012-02-06,1,1,2,8,0,1,1,1,0.16,0.1818,0.86,0.1343,10,434,444,444,True
9515,2012-02-06,1,1,2,9,0,1,1,1,0.18,0.2121,0.8,0.1045,8,269,277,277,True
9516,2012-02-06,1,1,2,10,0,1,1,1,0.22,0.2424,0.75,0.1045,20,96,116,116,True
9517,2012-02-06,1,1,2,11,0,1,1,1,0.26,0.2727,0.7,0.1343,12,104,116,116,True
9518,2012-02-06,1,1,2,12,0,1,1,1,0.32,0.3182,0.61,0.1642,19,131,150,150,True
9519,2012-02-06,1,1,2,13,0,1,1,1,0.38,0.3939,0.4,0.2239,17,124,141,141,True
9520,2012-02-06,1,1,2,14,0,1,1,1,0.4,0.4091,0.35,0.1642,14,126,140,140,True
9521,2012-02-06,1,1,2,15,0,1,1,1,0.42,0.4242,0.32,0.2836,25,146,171,171,True
9522,2012-02-06,1,1,2,16,0,1,1,1,0.4,0.4091,0.43,0.2537,13,215,228,228,True
9523,2012-02-06,1,1,2,17,0,1,1,1,0.4,0.4091,0.43,0.2537,13,417,430,430,True
9524,2012-02-06,1,1,2,18,0,1,1,1,0.38,0.3939,0.43,0.2239,11,426,437,437,True
9525,2012-02-06,1,1,2,19,0,1,1,1,0.36,0.3333,0.43,0.2537,7,284,291,291,True
9526,2012-02-06,1,1,2,20,0,1,1,1,0.34,0.3333,0.46,0.1642,7,194,201,201,True
9527,2012-02-06,1,1,2,21,0,1,1,1,0.32,0.3182,0.57,0.1642,11,143,154,154,True
9528,2012-02-06,1,1,2,22,0,1,1,1,0.3,0.303,0.65,0.1343,4,83,87,87,True
9529,2012-02-06,1,1,2,23,0,1,1,1,0.3,0.303,0.65,0.1343,3,43,46,46,True
9530,2012-02-07,1,1,2,0,0,2,1,1,0.3,0.2879,0.7,0.194,1,22,23,23,True
9531,2012-02-07,1,1,2,1,0,2,1,1,0.28,0.2879,0.61,0.1343,8,6,14,14,True
9532,2012-02-07,1,1,2,2,0,2,1,1,0.3,0.3333,0.61,0.0,0,4,4,4,True
9533,2012-02-07,1,1,2,3,0,2,1,2,0.3,0.3333,0.7,0.0,1,1,2,2,True
9534,2012-02-07,1,1,2,4,0,2,1,2,0.3,0.3333,0.7,0.0,0,3,3,3,True
9535,2012-02-07,1,1,2,5,0,2,1,1,0.32,0.3333,0.49,0.0896,0,15,15,15,True
9536,2012-02-07,1,1,2,6,0,2,1,1,0.32,0.303,0.45,0.2985,2,98,100,100,True
9537,2012-02-07,1,1,2,7,0,2,1,1,0.32,0.3485,0.45,0.0,6,293,299,299,True
9538,2012-02-07,1,1,2,8,0,2,1,1,0.3,0.3182,0.49,0.0,7,499,506,506,True
9539,2012-02-07,1,1,2,9,0,2,1,1,0.32,0.3333,0.49,0.0,11,278,289,289,True
9540,2012-02-07,1,1,2,10,0,2,1,1,0.34,0.3333,0.46,0.1642,12,104,116,116,True
9541,2012-02-07,1,1,2,11,0,2,1,1,0.36,0.3485,0.46,0.194,9,120,129,129,True
9542,2012-02-07,1,1,2,12,0,2,1,1,0.4,0.4091,0.4,0.3284,9,163,172,172,True
9543,2012-02-07,1,1,2,13,0,2,1,1,0.44,0.4394,0.38,0.2537,15,169,184,184,True
9544,2012-02-07,1,1,2,14,0,2,1,1,0.44,0.4394,0.38,0.2537,11,127,138,138,True
9545,2012-02-07,1,1,2,15,0,2,1,1,0.44,0.4394,0.38,0.194,13,133,146,146,True
9546,2012-02-07,1,1,2,16,0,2,1,1,0.44,0.4394,0.35,0.2537,19,257,276,276,True
9547,2012-02-07,1,1,2,17,0,2,1,1,0.44,0.4394,0.35,0.194,15,494,509,509,True
9548,2012-02-07,1,1,2,18,0,2,1,1,0.42,0.4242,0.38,0.194,10,499,509,509,True
9549,2012-02-07,1,1,2,19,0,2,1,1,0.38,0.3939,0.43,0.2239,11,327,338,338,True
9550,2012-02-07,1,1,2,20,0,2,1,1,0.36,0.3485,0.5,0.1343,6,206,212,212,True
9551,2012-02-07,1,1,2,21,0,2,1,1,0.34,0.3485,0.61,0.1045,20,170,190,190,True
9552,2012-02-07,1,1,2,22,0,2,1,1,0.32,0.3182,0.57,0.194,11,107,118,118,True
9553,2012-02-07,1,1,2,23,0,2,1,1,0.32,0.3333,0.57,0.1343,2,49,51,51,True
9554,2012-02-08,1,1,2,0,0,3,1,1,0.3,0.2879,0.56,0.2239,2,21,23,23,True
9555,2012-02-08,1,1,2,1,0,3,1,1,0.28,0.2727,0.61,0.1642,1,9,10,10,True
9556,2012-02-08,1,1,2,2,0,3,1,1,0.26,0.303,0.65,0.0,0,1,1,1,True
9557,2012-02-08,1,1,2,3,0,3,1,1,0.26,0.303,0.65,0.0,0,1,1,1,True
9558,2012-02-08,1,1,2,4,0,3,1,1,0.24,0.2576,0.7,0.0896,0,1,1,1,True
9559,2012-02-08,1,1,2,5,0,3,1,1,0.24,0.2576,0.7,0.0896,0,20,20,20,True
9560,2012-02-08,1,1,2,6,0,3,1,2,0.24,0.2879,0.7,0.0,3,95,98,98,True
9561,2012-02-08,1,1,2,7,0,3,1,2,0.24,0.2576,0.7,0.1045,5,276,281,281,True
9562,2012-02-08,1,1,2,8,0,3,1,2,0.24,0.2273,0.7,0.2239,13,495,508,508,True
9563,2012-02-08,1,1,2,9,0,3,1,2,0.24,0.2576,0.7,0.1642,8,245,253,253,True
9564,2012-02-08,1,1,2,10,0,3,1,2,0.26,0.2576,0.7,0.2239,1,107,108,108,True
9565,2012-02-08,1,1,2,11,0,3,1,2,0.26,0.2576,0.65,0.2239,5,97,102,102,True
9566,2012-02-08,1,1,2,12,0,3,1,2,0.28,0.2576,0.65,0.2836,14,124,138,138,True
9567,2012-02-08,1,1,2,13,0,3,1,2,0.28,0.2879,0.61,0.1045,15,111,126,126,True
9568,2012-02-08,1,1,2,14,0,3,1,2,0.3,0.303,0.56,0.1642,8,100,108,108,True
9569,2012-02-08,1,1,2,15,0,3,1,3,0.3,0.3182,0.61,0.1045,5,49,54,54,True
9570,2012-02-08,1,1,2,16,0,3,1,3,0.26,0.2727,0.81,0.1045,2,73,75,75,True
9571,2012-02-08,1,1,2,17,0,3,1,3,0.24,0.2576,0.87,0.1045,8,147,155,155,True
9572,2012-02-08,1,1,2,18,0,3,1,3,0.24,0.2576,0.87,0.1045,4,163,167,167,True
9573,2012-02-08,1,1,2,19,0,3,1,3,0.24,0.2576,0.87,0.1045,3,158,161,161,True
9574,2012-02-08,1,1,2,20,0,3,1,3,0.24,0.2424,0.87,0.1343,3,122,125,125,True
9575,2012-02-08,1,1,2,21,0,3,1,3,0.24,0.2273,0.87,0.194,3,126,129,129,True
9576,2012-02-08,1,1,2,22,0,3,1,2,0.24,0.2424,0.87,0.1343,3,95,98,98,True
9577,2012-02-08,1,1,2,23,0,3,1,2,0.24,0.2424,0.87,0.1642,3,57,60,60,True
9578,2012-02-09,1,1,2,0,0,4,1,2,0.24,0.2424,0.87,0.1642,3,23,26,26,True
9579,2012-02-09,1,1,2,1,0,4,1,2,0.24,0.2424,0.87,0.1343,2,10,12,12,True
9580,2012-02-09,1,1,2,2,0,4,1,1,0.22,0.2273,0.8,0.1343,0,2,2,2,True
9581,2012-02-09,1,1,2,3,0,4,1,1,0.22,0.2121,0.8,0.2836,0,4,4,4,True
9582,2012-02-09,1,1,2,4,0,4,1,2,0.22,0.197,0.75,0.4478,0,1,1,1,True
9583,2012-02-09,1,1,2,5,0,4,1,1,0.2,0.1818,0.75,0.2836,0,18,18,18,True
9584,2012-02-09,1,1,2,6,0,4,1,1,0.2,0.1818,0.75,0.2836,1,75,76,76,True
9585,2012-02-09,1,1,2,7,0,4,1,1,0.2,0.197,0.69,0.2537,4,263,267,267,True
9586,2012-02-09,1,1,2,8,0,4,1,1,0.2,0.197,0.64,0.2537,11,473,484,484,True
9587,2012-02-09,1,1,2,9,0,4,1,1,0.2,0.197,0.59,0.2239,9,229,238,238,True
9588,2012-02-09,1,1,2,10,0,4,1,1,0.22,0.2121,0.51,0.2239,7,90,97,97,True
9589,2012-02-09,1,1,2,11,0,4,1,1,0.24,0.2273,0.52,0.2239,4,95,99,99,True
9590,2012-02-09,1,1,2,12,0,4,1,1,0.26,0.2273,0.48,0.3284,10,148,158,158,True
9591,2012-02-09,1,1,2,13,0,4,1,1,0.3,0.2727,0.42,0.3284,10,144,154,154,True
9592,2012-02-09,1,1,2,14,0,4,1,1,0.32,0.303,0.39,0.2985,18,126,144,144,True
9593,2012-02-09,1,1,2,15,0,4,1,1,0.32,0.303,0.36,0.2985,14,120,134,134,True
9594,2012-02-09,1,1,2,16,0,4,1,1,0.34,0.3333,0.36,0.0,15,223,238,238,True
9595,2012-02-09,1,1,2,17,0,4,1,1,0.34,0.3333,0.34,0.1343,12,387,399,399,True
9596,2012-02-09,1,1,2,18,0,4,1,1,0.34,0.3333,0.31,0.1642,13,404,417,417,True
9597,2012-02-09,1,1,2,19,0,4,1,1,0.32,0.3333,0.33,0.1045,8,287,295,295,True
9598,2012-02-09,1,1,2,20,0,4,1,1,0.32,0.3485,0.36,0.0,2,197,199,199,True
9599,2012-02-09,1,1,2,21,0,4,1,1,0.3,0.3182,0.52,0.0896,8,169,177,177,True
9600,2012-02-09,1,1,2,22,0,4,1,2,0.3,0.3333,0.56,0.0,3,104,107,107,True
9601,2012-02-09,1,1,2,23,0,4,1,2,0.3,0.3333,0.52,0.0,9,75,84,84,True
9602,2012-02-10,1,1,2,0,0,5,1,2,0.28,0.303,0.65,0.0896,4,39,43,43,True
9603,2012-02-10,1,1,2,1,0,5,1,2,0.28,0.303,0.61,0.0896,2,11,13,13,True
9604,2012-02-10,1,1,2,2,0,5,1,1,0.26,0.2879,0.52,0.0896,7,9,16,16,True
9605,2012-02-10,1,1,2,3,0,5,1,1,0.26,0.2879,0.56,0.0896,0,5,5,5,True
9606,2012-02-10,1,1,2,4,0,5,1,1,0.26,0.2879,0.56,0.0896,0,2,2,2,True
9607,2012-02-10,1,1,2,5,0,5,1,1,0.24,0.2273,0.52,0.2239,0,17,17,17,True
9608,2012-02-10,1,1,2,6,0,5,1,1,0.2,0.197,0.59,0.194,3,61,64,64,True
9609,2012-02-10,1,1,2,7,0,5,1,1,0.2,0.2121,0.59,0.1642,5,225,230,230,True
9610,2012-02-10,1,1,2,8,0,5,1,1,0.2,0.2121,0.59,0.1642,1,447,448,448,True
9611,2012-02-10,1,1,2,9,0,5,1,1,0.22,0.2273,0.55,0.1642,10,265,275,275,True
9612,2012-02-10,1,1,2,10,0,5,1,2,0.26,0.2727,0.48,0.1343,5,119,124,124,True
9613,2012-02-10,1,1,2,11,0,5,1,2,0.28,0.2879,0.45,0.1045,19,134,153,153,True
9614,2012-02-10,1,1,2,12,0,5,1,2,0.3,0.303,0.42,0.1343,8,168,176,176,True
9615,2012-02-10,1,1,2,13,0,5,1,2,0.3,0.3182,0.42,0.0896,22,170,192,192,True
9616,2012-02-10,1,1,2,14,0,5,1,2,0.32,0.3333,0.39,0.0896,8,138,146,146,True
9617,2012-02-10,1,1,2,15,0,5,1,2,0.32,0.3333,0.45,0.1343,27,164,191,191,True
9618,2012-02-10,1,1,2,16,0,5,1,2,0.34,0.3182,0.42,0.2537,28,240,268,268,True
9619,2012-02-10,1,1,2,17,0,5,1,2,0.34,0.3333,0.42,0.194,15,381,396,396,True
9620,2012-02-10,1,1,2,18,0,5,1,3,0.3,0.303,0.61,0.1343,14,345,359,359,True
9621,2012-02-10,1,1,2,19,0,5,1,2,0.32,0.3485,0.57,0.0,16,246,262,262,True
9622,2012-02-10,1,1,2,20,0,5,1,2,0.32,0.3485,0.57,0.0,7,144,151,151,True
9623,2012-02-10,1,1,2,21,0,5,1,2,0.32,0.3333,0.66,0.0896,14,108,122,122,True
9624,2012-02-10,1,1,2,22,0,5,1,2,0.32,0.3485,0.66,0.0,11,102,113,113,True
9625,2012-02-10,1,1,2,23,0,5,1,2,0.3,0.3182,0.7,0.0896,1,64,65,65,True
9626,2012-02-11,1,1,2,0,0,6,0,2,0.3,0.303,0.7,0.1343,3,50,53,53,True
9627,2012-02-11,1,1,2,1,0,6,0,3,0.28,0.2879,0.81,0.1343,2,43,45,45,True
9628,2012-02-11,1,1,2,2,0,6,0,3,0.26,0.2576,0.81,0.194,2,24,26,26,True
9629,2012-02-11,1,1,2,3,0,6,0,3,0.24,0.2273,0.87,0.2239,0,9,9,9,True
9630,2012-02-11,1,1,2,4,0,6,0,3,0.24,0.2273,0.87,0.2239,0,4,4,4,True
9631,2012-02-11,1,1,2,5,0,6,0,3,0.22,0.2273,0.93,0.1642,0,2,2,2,True
9632,2012-02-11,1,1,2,6,0,6,0,3,0.22,0.2273,0.93,0.1343,1,8,9,9,True
9633,2012-02-11,1,1,2,7,0,6,0,3,0.22,0.2273,0.93,0.1343,0,19,19,19,True
9634,2012-02-11,1,1,2,8,0,6,0,3,0.22,0.2273,0.93,0.1343,1,77,78,78,True
9635,2012-02-11,1,1,2,9,0,6,0,3,0.22,0.2424,0.93,0.1045,5,85,90,90,True
9636,2012-02-11,1,1,2,10,0,6,0,3,0.22,0.2424,0.93,0.1045,23,143,166,166,True
9637,2012-02-11,1,1,2,11,0,6,0,2,0.24,0.2576,0.81,0.1045,26,157,183,183,True
9638,2012-02-11,1,1,2,12,0,6,0,2,0.26,0.2576,0.81,0.1642,25,196,221,221,True
9639,2012-02-11,1,1,2,13,0,6,0,2,0.26,0.2424,0.81,0.2836,18,217,235,235,True
9640,2012-02-11,1,1,2,14,0,6,0,2,0.26,0.2424,0.81,0.2537,38,205,243,243,True
9641,2012-02-11,1,1,2,15,0,6,0,2,0.3,0.2727,0.61,0.2985,12,112,124,124,True
9642,2012-02-11,1,1,2,16,0,6,0,3,0.22,0.197,0.75,0.4179,12,134,146,146,True
9643,2012-02-11,1,1,2,17,0,6,0,3,0.22,0.1818,0.69,0.4627,13,131,144,144,True
9644,2012-02-11,1,1,2,18,0,6,0,2,0.22,0.1818,0.47,0.4775,3,105,108,108,True
9645,2012-02-11,1,1,2,19,0,6,0,2,0.2,0.1515,0.4,0.4775,2,85,87,87,True
9646,2012-02-11,1,1,2,20,0,6,0,2,0.16,0.1212,0.43,0.4775,1,62,63,63,True
9647,2012-02-11,1,1,2,21,0,6,0,1,0.14,0.0758,0.43,0.4775,5,43,48,48,True
9648,2012-02-11,1,1,2,22,0,6,0,2,0.14,0.1061,0.39,0.3881,0,46,46,46,True
9649,2012-02-11,1,1,2,23,0,6,0,3,0.12,0.0758,0.5,0.4775,0,20,20,20,True
9650,2012-02-12,1,1,2,0,0,0,0,3,0.1,0.0758,0.68,0.3881,0,21,21,21,True
9651,2012-02-12,1,1,2,1,0,0,0,3,0.08,0.0455,0.79,0.4627,0,24,24,24,True
9652,2012-02-12,1,1,2,2,0,0,0,2,0.1,0.0606,0.58,0.4775,1,26,27,27,True
9653,2012-02-12,1,1,2,3,0,0,0,2,0.1,0.0455,0.46,0.4775,0,14,14,14,True
9654,2012-02-12,1,1,2,4,0,0,0,2,0.1,0.0455,0.46,0.4775,0,1,1,1,True
9655,2012-02-12,1,1,2,5,0,0,0,1,0.1,0.0758,0.49,0.3881,0,3,3,3,True
9656,2012-02-12,1,1,2,6,0,0,0,1,0.1,0.0758,0.49,0.3881,0,2,2,2,True
9657,2012-02-12,1,1,2,7,0,0,0,1,0.08,0.0909,0.53,0.194,0,18,18,18,True
9658,2012-02-12,1,1,2,8,0,0,0,1,0.08,0.0758,0.53,0.2537,0,26,26,26,True
9659,2012-02-12,1,1,2,9,0,0,0,1,0.1,0.0909,0.49,0.2985,3,60,63,63,True
9660,2012-02-12,1,1,2,10,0,0,0,1,0.12,0.1061,0.42,0.3582,8,83,91,91,True
9661,2012-02-12,1,1,2,11,0,0,0,1,0.12,0.1061,0.42,0.2985,3,121,124,124,True
9662,2012-02-12,1,1,2,12,0,0,0,1,0.14,0.0758,0.39,0.4775,7,133,140,140,True
9663,2012-02-12,1,1,2,13,0,0,0,1,0.16,0.1212,0.4,0.4478,10,128,138,138,True
9664,2012-02-12,1,1,2,14,0,0,0,1,0.16,0.1212,0.4,0.4775,9,102,111,111,True
9665,2012-02-12,1,1,2,15,0,0,0,1,0.16,0.1212,0.4,0.4775,5,150,155,155,True
9666,2012-02-12,1,1,2,16,0,0,0,1,0.2,0.1667,0.34,0.4627,16,148,164,164,True
9667,2012-02-12,1,1,2,17,0,0,0,1,0.18,0.1515,0.37,0.4179,4,83,87,87,True
9668,2012-02-12,1,1,2,18,0,0,0,1,0.16,0.1212,0.4,0.4627,4,92,96,96,True
9669,2012-02-12,1,1,2,19,0,0,0,1,0.16,0.1364,0.4,0.2836,2,78,80,80,True
9670,2012-02-12,1,1,2,20,0,0,0,1,0.14,0.1212,0.42,0.3284,1,56,57,57,True
9671,2012-02-12,1,1,2,21,0,0,0,1,0.14,0.1212,0.43,0.2985,0,36,36,36,True
9672,2012-02-12,1,1,2,22,0,0,0,1,0.14,0.1515,0.43,0.1642,0,28,28,28,True
9673,2012-02-12,1,1,2,23,0,0,0,1,0.14,0.1364,0.43,0.2239,0,23,23,23,True
9674,2012-02-13,1,1,2,0,0,1,1,1,0.14,0.1364,0.46,0.2239,0,9,9,9,True
9675,2012-02-13,1,1,2,1,0,1,1,1,0.12,0.1212,0.5,0.2239,0,6,6,6,True
9676,2012-02-13,1,1,2,2,0,1,1,1,0.14,0.1364,0.46,0.194,0,4,4,4,True
9677,2012-02-13,1,1,2,3,0,1,1,1,0.12,0.1515,0.54,0.1045,0,1,1,1,True
9678,2012-02-13,1,1,2,4,0,1,1,1,0.12,0.1667,0.54,0.0896,0,2,2,2,True
9679,2012-02-13,1,1,2,5,0,1,1,1,0.1,0.1212,0.58,0.1343,0,17,17,17,True
9680,2012-02-13,1,1,2,6,0,1,1,1,0.1,0.1061,0.54,0.2239,1,71,72,72,True
9681,2012-02-13,1,1,2,7,0,1,1,1,0.1,0.1061,0.54,0.194,1,194,195,195,True
9682,2012-02-13,1,1,2,8,0,1,1,1,0.1,0.1212,0.54,0.1343,4,413,417,417,True
9683,2012-02-13,1,1,2,9,0,1,1,1,0.12,0.1364,0.5,0.194,7,198,205,205,True
9684,2012-02-13,1,1,2,10,0,1,1,1,0.14,0.1515,0.5,0.1343,1,70,71,71,True
9685,2012-02-13,1,1,2,11,0,1,1,1,0.22,0.2273,0.37,0.194,5,85,90,90,True
9686,2012-02-13,1,1,2,12,0,1,1,1,0.28,0.2576,0.28,0.3284,7,111,118,118,True
9687,2012-02-13,1,1,2,13,0,1,1,1,0.32,0.303,0.22,0.2239,11,129,140,140,True
9688,2012-02-13,1,1,2,14,0,1,1,1,0.34,0.3485,0.23,0.1045,10,125,135,135,True
9689,2012-02-13,1,1,2,15,0,1,1,1,0.36,0.3485,0.27,0.1343,10,145,155,155,True
9690,2012-02-13,1,1,2,16,0,1,1,1,0.36,0.3485,0.23,0.194,5,206,211,211,True
9691,2012-02-13,1,1,2,17,0,1,1,1,0.36,0.3485,0.23,0.194,8,399,407,407,True
9692,2012-02-13,1,1,2,18,0,1,1,1,0.34,0.3182,0.25,0.2537,6,399,405,405,True
9693,2012-02-13,1,1,2,19,0,1,1,1,0.34,0.3333,0.25,0.1343,7,256,263,263,True
9694,2012-02-13,1,1,2,20,0,1,1,1,0.3,0.303,0.42,0.1642,4,210,214,214,True
9695,2012-02-13,1,1,2,21,0,1,1,1,0.28,0.2879,0.45,0.1343,2,145,147,147,True
9696,2012-02-13,1,1,2,22,0,1,1,1,0.26,0.2727,0.56,0.1045,3,99,102,102,True
9697,2012-02-13,1,1,2,23,0,1,1,1,0.28,0.3182,0.41,0.0,2,34,36,36,True
9698,2012-02-14,1,1,2,0,0,2,1,2,0.26,0.303,0.6,0.0,0,14,14,14,True
9699,2012-02-14,1,1,2,1,0,2,1,2,0.26,0.303,0.56,0.0,0,6,6,6,True
9700,2012-02-14,1,1,2,2,0,2,1,2,0.28,0.3182,0.41,0.0,0,3,3,3,True
9701,2012-02-14,1,1,2,3,0,2,1,2,0.26,0.303,0.52,0.0,0,3,3,3,True
9702,2012-02-14,1,1,2,4,0,2,1,2,0.26,0.2727,0.65,0.1045,0,2,2,2,True
9703,2012-02-14,1,1,2,5,0,2,1,2,0.26,0.2727,0.65,0.1045,2,20,22,22,True
9704,2012-02-14,1,1,2,6,0,2,1,2,0.26,0.303,0.56,0.0,1,89,90,90,True
9705,2012-02-14,1,1,2,7,0,2,1,2,0.24,0.2576,0.6,0.0896,4,276,280,280,True
9706,2012-02-14,1,1,2,8,0,2,1,2,0.24,0.2879,0.7,0.0,3,499,502,502,True
9707,2012-02-14,1,1,2,9,0,2,1,2,0.26,0.2879,0.56,0.0896,6,256,262,262,True
9708,2012-02-14,1,1,2,10,0,2,1,2,0.26,0.2727,0.6,0.1343,8,90,98,98,True
9709,2012-02-14,1,1,2,11,0,2,1,2,0.3,0.303,0.45,0.1642,5,107,112,112,True
9710,2012-02-14,1,1,2,12,0,2,1,2,0.3,0.2879,0.52,0.2239,10,162,172,172,True
9711,2012-02-14,1,1,2,13,0,2,1,2,0.36,0.3333,0.4,0.2537,6,167,173,173,True
9712,2012-02-14,1,1,2,14,0,2,1,1,0.4,0.4091,0.4,0.2239,13,111,124,124,True
9713,2012-02-14,1,1,2,15,0,2,1,2,0.42,0.4242,0.38,0.4478,7,138,145,145,True
9714,2012-02-14,1,1,2,16,0,2,1,1,0.42,0.4242,0.35,0.2985,15,251,266,266,True
9715,2012-02-14,1,1,2,17,0,2,1,1,0.42,0.4242,0.38,0.3582,19,499,518,518,True
9716,2012-02-14,1,1,2,18,0,2,1,2,0.38,0.3939,0.46,0.2985,8,398,406,406,True
9717,2012-02-14,1,1,2,19,0,2,1,2,0.36,0.3485,0.5,0.1642,11,270,281,281,True
9718,2012-02-14,1,1,2,20,0,2,1,2,0.38,0.3939,0.46,0.1343,6,178,184,184,True
9719,2012-02-14,1,1,2,21,0,2,1,2,0.36,0.3636,0.5,0.1045,4,105,109,109,True
9720,2012-02-14,1,1,2,22,0,2,1,2,0.36,0.3636,0.5,0.1045,5,72,77,77,True
9721,2012-02-14,1,1,2,23,0,2,1,2,0.36,0.3636,0.5,0.0896,2,55,57,57,True
9722,2012-02-15,1,1,2,0,0,3,1,1,0.32,0.3485,0.57,0.0,0,22,22,22,True
9723,2012-02-15,1,1,2,1,0,3,1,1,0.34,0.3636,0.53,0.0,0,5,5,5,True
9724,2012-02-15,1,1,2,2,0,3,1,1,0.3,0.3333,0.61,0.0,0,4,4,4,True
9725,2012-02-15,1,1,2,3,0,3,1,1,0.28,0.3182,0.75,0.0,0,3,3,3,True
9726,2012-02-15,1,1,2,4,0,3,1,1,0.28,0.2879,0.7,0.1045,0,1,1,1,True
9727,2012-02-15,1,1,2,5,0,3,1,1,0.28,0.2879,0.7,0.1045,0,25,25,25,True
9728,2012-02-15,1,1,2,6,0,3,1,1,0.3,0.303,0.61,0.1343,3,92,95,95,True
9729,2012-02-15,1,1,2,7,0,3,1,2,0.3,0.2879,0.65,0.194,3,318,321,321,True
9730,2012-02-15,1,1,2,8,0,3,1,1,0.32,0.2879,0.61,0.3582,7,499,506,506,True
9731,2012-02-15,1,1,2,9,0,3,1,1,0.32,0.303,0.61,0.3284,5,226,231,231,True
9732,2012-02-15,1,1,2,10,0,3,1,1,0.34,0.303,0.57,0.2985,12,108,120,120,True
9733,2012-02-15,1,1,2,11,0,3,1,1,0.36,0.3333,0.53,0.2836,13,125,138,138,True
9734,2012-02-15,1,1,2,12,0,3,1,1,0.38,0.3939,0.46,0.3881,11,152,163,163,True
9735,2012-02-15,1,1,2,13,0,3,1,1,0.4,0.4091,0.43,0.2836,11,159,170,170,True
9736,2012-02-15,1,1,2,14,0,3,1,1,0.42,0.4242,0.41,0.3582,6,128,134,134,True
9737,2012-02-15,1,1,2,15,0,3,1,1,0.42,0.4242,0.41,0.2239,7,164,171,171,True
9738,2012-02-15,1,1,2,16,0,3,1,1,0.42,0.4242,0.38,0.194,9,222,231,231,True
9739,2012-02-15,1,1,2,17,0,3,1,1,0.42,0.4242,0.38,0.194,17,470,487,487,True
9740,2012-02-15,1,1,2,18,0,3,1,1,0.4,0.4091,0.4,0.2239,9,459,468,468,True
9741,2012-02-15,1,1,2,19,0,3,1,1,0.38,0.3939,0.43,0.1642,9,302,311,311,True
9742,2012-02-15,1,1,2,20,0,3,1,1,0.36,0.3485,0.46,0.1642,4,207,211,211,True
9743,2012-02-15,1,1,2,21,0,3,1,1,0.34,0.3333,0.53,0.1642,8,170,178,178,True
9744,2012-02-15,1,1,2,22,0,3,1,1,0.34,0.3485,0.49,0.1045,3,104,107,107,True
9745,2012-02-15,1,1,2,23,0,3,1,1,0.34,0.3485,0.53,0.0896,4,54,58,58,True
9746,2012-02-16,1,1,2,0,0,4,1,2,0.3,0.303,0.7,0.1343,1,22,23,23,True
9747,2012-02-16,1,1,2,1,0,4,1,2,0.3,0.3333,0.7,0.0,0,5,5,5,True
9748,2012-02-16,1,1,2,2,0,4,1,2,0.3,0.3182,0.7,0.0896,1,6,7,7,True
9749,2012-02-16,1,1,2,3,0,4,1,2,0.3,0.3333,0.61,0.0,0,1,1,1,True
9750,2012-02-16,1,1,2,4,0,4,1,3,0.3,0.3182,0.7,0.0896,0,3,3,3,True
9751,2012-02-16,1,1,2,5,0,4,1,2,0.3,0.3333,0.7,0.0,0,20,20,20,True
9752,2012-02-16,1,1,2,6,0,4,1,2,0.3,0.3182,0.7,0.0896,4,83,87,87,True
9753,2012-02-16,1,1,2,7,0,4,1,2,0.3,0.303,0.7,0.1343,3,285,288,288,True
9754,2012-02-16,1,1,2,8,0,4,1,2,0.3,0.3182,0.7,0.0896,9,489,498,498,True
9755,2012-02-16,1,1,2,9,0,4,1,2,0.3,0.303,0.7,0.1642,3,199,202,202,True
9756,2012-02-16,1,1,2,10,0,4,1,3,0.32,0.3333,0.7,0.1343,2,42,44,44,True
9757,2012-02-16,1,1,2,11,0,4,1,3,0.32,0.3333,0.7,0.1045,2,69,71,71,True
9758,2012-02-16,1,1,2,12,0,4,1,3,0.32,0.3333,0.76,0.0896,1,44,45,45,True
9759,2012-02-16,1,1,2,13,0,4,1,3,0.34,0.3182,0.71,0.2537,2,62,64,64,True
9760,2012-02-16,1,1,2,14,0,4,1,3,0.32,0.3182,0.81,0.194,1,30,31,31,True
9761,2012-02-16,1,1,2,15,0,4,1,3,0.34,0.3636,0.76,0.0,3,50,53,53,True
9762,2012-02-16,1,1,2,16,0,4,1,3,0.34,0.3636,0.81,0.0,8,110,118,118,True
9763,2012-02-16,1,1,2,17,0,4,1,3,0.34,0.3636,0.87,0.0,8,281,289,289,True
9764,2012-02-16,1,1,2,18,0,4,1,3,0.34,0.3333,0.87,0.1343,8,345,353,353,True
9765,2012-02-16,1,1,2,19,0,4,1,2,0.32,0.3182,0.87,0.1642,4,254,258,258,True
9766,2012-02-16,1,1,2,20,0,4,1,2,0.32,0.3333,0.87,0.1343,5,211,216,216,True
9767,2012-02-16,1,1,2,21,0,4,1,2,0.34,0.3485,0.81,0.1045,3,142,145,145,True
9768,2012-02-16,1,1,2,22,0,4,1,2,0.32,0.3485,0.81,0.0,3,108,111,111,True
9769,2012-02-16,1,1,2,23,0,4,1,1,0.32,0.3333,0.81,0.0896,3,70,73,73,True
9770,2012-02-17,1,1,2,0,0,5,1,2,0.3,0.3333,0.87,0.0,2,32,34,34,True
9771,2012-02-17,1,1,2,1,0,5,1,2,0.3,0.3333,0.93,0.0,2,16,18,18,True
9772,2012-02-17,1,1,2,2,0,5,1,2,0.3,0.3182,0.93,0.1045,1,11,12,12,True
9773,2012-02-17,1,1,2,3,0,5,1,2,0.28,0.2879,0.93,0.1045,0,1,1,1,True
9774,2012-02-17,1,1,2,4,0,5,1,2,0.28,0.2727,0.93,0.194,0,1,1,1,True
9775,2012-02-17,1,1,2,5,0,5,1,2,0.28,0.2727,0.93,0.1642,0,16,16,16,True
9776,2012-02-17,1,1,2,6,0,5,1,2,0.28,0.2879,0.96,0.1343,1,70,71,71,True
9777,2012-02-17,1,1,2,7,0,5,1,2,0.28,0.2879,0.93,0.1045,4,222,226,226,True
9778,2012-02-17,1,1,2,8,0,5,1,2,0.26,0.303,1.0,0.0,4,499,503,503,True
9779,2012-02-17,1,1,2,9,0,5,1,2,0.26,0.303,1.0,0.0,8,275,283,283,True
9780,2012-02-17,1,1,2,10,0,5,1,1,0.34,0.3182,0.71,0.2836,13,103,116,116,True
9781,2012-02-17,1,1,2,11,0,5,1,1,0.36,0.3333,0.62,0.4179,9,133,142,142,True
9782,2012-02-17,1,1,2,12,0,5,1,1,0.38,0.3939,0.46,0.3881,21,177,198,198,True
9783,2012-02-17,1,1,2,13,0,5,1,1,0.4,0.4091,0.43,0.3582,34,171,205,205,True
9784,2012-02-17,1,1,2,14,0,5,1,1,0.4,0.4091,0.37,0.3582,33,137,170,170,True
9785,2012-02-17,1,1,2,15,0,5,1,1,0.42,0.4242,0.35,0.4179,41,180,221,221,True
9786,2012-02-17,1,1,2,16,0,5,1,1,0.42,0.4242,0.32,0.2985,56,251,307,307,True
9787,2012-02-17,1,1,2,17,0,5,1,1,0.42,0.4242,0.32,0.3284,36,429,465,465,True
9788,2012-02-17,1,1,2,18,0,5,1,1,0.4,0.4091,0.35,0.2537,15,362,377,377,True
9789,2012-02-17,1,1,2,19,0,5,1,1,0.38,0.3939,0.37,0.2239,16,266,282,282,True
9790,2012-02-17,1,1,2,20,0,5,1,1,0.4,0.4091,0.35,0.194,13,158,171,171,True
9791,2012-02-17,1,1,2,21,0,5,1,1,0.38,0.3939,0.37,0.194,15,114,129,129,True
9792,2012-02-17,1,1,2,22,0,5,1,1,0.36,0.3485,0.4,0.2239,15,92,107,107,True
9793,2012-02-17,1,1,2,23,0,5,1,1,0.36,0.3485,0.4,0.194,10,72,82,82,True
9794,2012-02-18,1,1,2,0,0,6,0,1,0.34,0.3333,0.42,0.1642,5,81,86,86,True
9795,2012-02-18,1,1,2,1,0,6,0,1,0.32,0.3182,0.49,0.1642,7,38,45,45,True
9796,2012-02-18,1,1,2,2,0,6,0,1,0.3,0.2879,0.61,0.2537,6,39,45,45,True
9797,2012-02-18,1,1,2,3,0,6,0,1,0.28,0.2879,0.65,0.1045,3,15,18,18,True
9798,2012-02-18,1,1,2,4,0,6,0,1,0.26,0.303,0.7,0.0,3,4,7,7,True
9799,2012-02-18,1,1,2,5,0,6,0,1,0.24,0.2576,0.7,0.0896,0,1,1,1,True
9800,2012-02-18,1,1,2,6,0,6,0,1,0.24,0.2879,0.7,0.0,1,8,9,9,True
9801,2012-02-18,1,1,2,7,0,6,0,1,0.24,0.2879,0.7,0.0,8,33,41,41,True
9802,2012-02-18,1,1,2,8,0,6,0,1,0.22,0.2727,0.87,0.0,10,92,102,102,True
9803,2012-02-18,1,1,2,9,0,6,0,1,0.22,0.2424,0.8,0.1045,22,116,138,138,True
9804,2012-02-18,1,1,2,10,0,6,0,1,0.26,0.2727,0.81,0.1045,48,157,205,205,True
9805,2012-02-18,1,1,2,11,0,6,0,1,0.32,0.3333,0.57,0.1343,102,184,286,286,True
9806,2012-02-18,1,1,2,12,0,6,0,1,0.36,0.3485,0.43,0.194,114,241,355,355,True
9807,2012-02-18,1,1,2,13,0,6,0,1,0.4,0.4091,0.43,0.2836,114,219,333,333,True
9808,2012-02-18,1,1,2,14,0,6,0,1,0.44,0.4394,0.35,0.3582,114,244,358,358,True
9809,2012-02-18,1,1,2,15,0,6,0,1,0.42,0.4242,0.41,0.2537,114,270,384,384,True
9810,2012-02-18,1,1,2,16,0,6,0,1,0.44,0.4394,0.44,0.3284,114,218,332,332,True
9811,2012-02-18,1,1,2,17,0,6,0,1,0.48,0.4697,0.36,0.2836,114,222,336,336,True
9812,2012-02-18,1,1,2,18,0,6,0,1,0.46,0.4545,0.38,0.2985,70,176,246,246,True
9813,2012-02-18,1,1,2,19,0,6,0,1,0.44,0.4394,0.44,0.1642,38,150,188,188,True
9814,2012-02-18,1,1,2,20,0,6,0,1,0.44,0.4394,0.44,0.1642,25,123,148,148,True
9815,2012-02-18,1,1,2,21,0,6,0,1,0.44,0.4394,0.33,0.2985,25,89,114,114,True
9816,2012-02-18,1,1,2,22,0,6,0,1,0.4,0.4091,0.4,0.4478,17,101,118,118,True
9817,2012-02-18,1,1,2,23,0,6,0,2,0.36,0.3333,0.4,0.3881,12,62,74,74,True
9818,2012-02-19,1,1,2,0,0,0,0,2,0.34,0.303,0.39,0.3582,9,65,74,74,True
9819,2012-02-19,1,1,2,1,0,0,0,2,0.32,0.303,0.39,0.2537,10,62,72,72,True
9820,2012-02-19,1,1,2,2,0,0,0,2,0.3,0.2879,0.36,0.2836,3,45,48,48,True
9821,2012-02-19,1,1,2,3,0,0,0,2,0.3,0.2879,0.36,0.2239,3,12,15,15,True
9822,2012-02-19,1,1,2,4,0,0,0,2,0.28,0.2576,0.41,0.3881,0,3,3,3,True
9823,2012-02-19,1,1,2,5,0,0,0,2,0.26,0.2273,0.48,0.2985,1,1,2,2,True
9824,2012-02-19,1,1,2,6,0,0,0,1,0.24,0.2121,0.52,0.3284,0,5,5,5,True
9825,2012-02-19,1,1,2,7,0,0,0,2,0.24,0.2121,0.52,0.2836,2,12,14,14,True
9826,2012-02-19,1,1,2,8,0,0,0,2,0.24,0.2273,0.56,0.194,8,48,56,56,True
9827,2012-02-19,1,1,2,9,0,0,0,2,0.24,0.2273,0.56,0.2537,20,73,93,93,True
9828,2012-02-19,1,1,2,10,0,0,0,2,0.26,0.2424,0.52,0.2537,49,142,191,191,True
9829,2012-02-19,1,1,2,11,0,0,0,2,0.26,0.2273,0.56,0.3284,82,144,226,226,True
9830,2012-02-19,1,1,2,12,0,0,0,2,0.28,0.2727,0.52,0.2537,71,184,255,255,True
9831,2012-02-19,1,1,2,13,0,0,0,1,0.3,0.303,0.49,0.1642,64,197,261,261,True
9832,2012-02-19,1,1,2,14,0,0,0,2,0.32,0.3182,0.45,0.194,48,189,237,237,True
9833,2012-02-19,1,1,2,15,0,0,0,2,0.3,0.2879,0.49,0.194,85,168,253,253,True
9834,2012-02-19,1,1,2,16,0,0,0,2,0.32,0.303,0.45,0.2836,62,150,212,212,True
9835,2012-02-19,1,1,2,17,0,0,0,2,0.3,0.2879,0.49,0.2537,22,135,157,157,True
9836,2012-02-19,1,1,2,18,0,0,0,2,0.3,0.2727,0.49,0.3284,23,144,167,167,True
9837,2012-02-19,1,1,2,19,0,0,0,2,0.3,0.2879,0.52,0.2537,18,101,119,119,True
9838,2012-02-19,1,1,2,20,0,0,0,2,0.3,0.2879,0.52,0.2836,22,81,103,103,True
9839,2012-02-19,1,1,2,21,0,0,0,3,0.26,0.2576,0.65,0.1642,3,33,36,36,True
9840,2012-02-19,1,1,2,22,0,0,0,3,0.24,0.2576,0.75,0.0896,8,47,55,55,True
9841,2012-02-19,1,1,2,23,0,0,0,2,0.22,0.2273,0.93,0.1642,5,30,35,35,True
9842,2012-02-20,1,1,2,0,1,1,0,2,0.24,0.2576,0.87,0.0896,5,36,41,41,True
9843,2012-02-20,1,1,2,1,1,1,0,2,0.24,0.2576,0.87,0.0896,3,12,15,15,True
9844,2012-02-20,1,1,2,2,1,1,0,2,0.24,0.2576,0.87,0.0896,1,19,20,20,True
9845,2012-02-20,1,1,2,3,1,1,0,2,0.24,0.2273,0.81,0.194,0,8,8,8,True
9846,2012-02-20,1,1,2,5,1,1,0,2,0.24,0.2121,0.6,0.3582,0,6,6,6,True
9847,2012-02-20,1,1,2,6,1,1,0,1,0.24,0.197,0.52,0.4179,1,9,10,10,True
9848,2012-02-20,1,1,2,7,1,1,0,2,0.22,0.197,0.55,0.3284,2,42,44,44,True
9849,2012-02-20,1,1,2,8,1,1,0,1,0.2,0.1818,0.59,0.3582,9,111,120,120,True
9850,2012-02-20,1,1,2,9,1,1,0,1,0.2,0.1818,0.59,0.3582,12,98,110,110,True
9851,2012-02-20,1,1,2,10,1,1,0,1,0.22,0.197,0.55,0.4478,30,113,143,143,True
9852,2012-02-20,1,1,2,11,1,1,0,1,0.26,0.2273,0.48,0.3582,45,163,208,208,True
9853,2012-02-20,1,1,2,12,1,1,0,1,0.28,0.2727,0.45,0.2239,65,216,281,281,True
9854,2012-02-20,1,1,2,13,1,1,0,1,0.3,0.2879,0.42,0.2836,66,246,312,312,True
9855,2012-02-20,1,1,2,14,1,1,0,1,0.32,0.3182,0.36,0.194,57,206,263,263,True
9856,2012-02-20,1,1,2,15,1,1,0,1,0.34,0.3182,0.34,0.2239,54,235,289,289,True
9857,2012-02-20,1,1,2,16,1,1,0,1,0.36,0.3788,0.29,0.1045,64,216,280,280,True
9858,2012-02-20,1,1,2,17,1,1,0,1,0.38,0.3939,0.27,0.2537,27,226,253,253,True
9859,2012-02-20,1,1,2,18,1,1,0,1,0.34,0.3182,0.34,0.2239,27,215,242,242,True
9860,2012-02-20,1,1,2,19,1,1,0,1,0.34,0.3182,0.34,0.2239,8,164,172,172,True
9861,2012-02-20,1,1,2,20,1,1,0,1,0.34,0.3333,0.34,0.194,9,117,126,126,True
9862,2012-02-20,1,1,2,21,1,1,0,1,0.3,0.303,0.39,0.1642,8,90,98,98,True
9863,2012-02-20,1,1,2,22,1,1,0,1,0.3,0.3182,0.45,0.0896,9,53,62,62,True
9864,2012-02-20,1,1,2,23,1,1,0,1,0.3,0.3333,0.39,0.0,0,26,26,26,True
9865,2012-02-21,1,1,2,0,0,2,1,1,0.26,0.303,0.65,0.0,1,11,12,12,True
9866,2012-02-21,1,1,2,1,0,2,1,1,0.26,0.303,0.56,0.0,0,7,7,7,True
9867,2012-02-21,1,1,2,2,0,2,1,1,0.24,0.2879,0.6,0.0,0,3,3,3,True
9868,2012-02-21,1,1,2,4,0,2,1,1,0.22,0.2727,0.64,0.0,0,2,2,2,True
9869,2012-02-21,1,1,2,5,0,2,1,1,0.2,0.2576,0.69,0.0,0,15,15,15,True
9870,2012-02-21,1,1,2,6,0,2,1,1,0.2,0.2576,0.75,0.0,3,83,86,86,True
9871,2012-02-21,1,1,2,7,0,2,1,1,0.22,0.2727,0.64,0.0,6,273,279,279,True
9872,2012-02-21,1,1,2,8,0,2,1,1,0.2,0.2273,0.69,0.0896,5,459,464,464,True
9873,2012-02-21,1,1,2,9,0,2,1,1,0.2,0.2273,0.75,0.1045,6,211,217,217,True
9874,2012-02-21,1,1,2,10,0,2,1,1,0.24,0.2273,0.7,0.194,8,77,85,85,True
9875,2012-02-21,1,1,2,11,0,2,1,2,0.26,0.2424,0.7,0.2836,5,81,86,86,True
9876,2012-02-21,1,1,2,12,0,2,1,2,0.3,0.2727,0.56,0.3881,16,147,163,163,True
9877,2012-02-21,1,1,2,13,0,2,1,1,0.34,0.303,0.49,0.4179,8,123,131,131,True
9878,2012-02-21,1,1,2,14,0,2,1,2,0.32,0.2879,0.53,0.3881,16,108,124,124,True
9879,2012-02-21,1,1,2,15,0,2,1,1,0.34,0.303,0.49,0.4179,23,137,160,160,True
9880,2012-02-21,1,1,2,16,0,2,1,1,0.36,0.3333,0.46,0.4179,14,240,254,254,True
9881,2012-02-21,1,1,2,17,0,2,1,1,0.38,0.3939,0.4,0.4478,21,411,432,432,True
9882,2012-02-21,1,1,2,18,0,2,1,1,0.38,0.3939,0.4,0.4478,11,414,425,425,True
9883,2012-02-21,1,1,2,19,0,2,1,1,0.36,0.3333,0.46,0.2985,5,299,304,304,True
9884,2012-02-21,1,1,2,20,0,2,1,1,0.34,0.3182,0.53,0.2537,4,223,227,227,True
9885,2012-02-21,1,1,2,21,0,2,1,1,0.34,0.3333,0.61,0.1642,7,147,154,154,True
9886,2012-02-21,1,1,2,22,0,2,1,2,0.34,0.3333,0.71,0.194,3,97,100,100,True
9887,2012-02-21,1,1,2,23,0,2,1,1,0.32,0.303,0.66,0.2239,1,46,47,47,True
9888,2012-02-22,1,1,2,0,0,3,1,1,0.32,0.303,0.66,0.2239,5,19,24,24,True
9889,2012-02-22,1,1,2,1,0,3,1,1,0.32,0.3333,0.7,0.1343,3,4,7,7,True
9890,2012-02-22,1,1,2,2,0,3,1,1,0.34,0.3182,0.66,0.2836,1,5,6,6,True
9891,2012-02-22,1,1,2,3,0,3,1,2,0.34,0.3182,0.71,0.2239,1,3,4,4,True
9892,2012-02-22,1,1,2,4,0,3,1,1,0.34,0.3333,0.71,0.1642,0,2,2,2,True
9893,2012-02-22,1,1,2,5,0,3,1,1,0.32,0.3333,0.7,0.1045,1,29,30,30,True
9894,2012-02-22,1,1,2,6,0,3,1,1,0.32,0.3182,0.76,0.1642,5,85,90,90,True
9895,2012-02-22,1,1,2,7,0,3,1,1,0.32,0.3333,0.76,0.0896,10,292,302,302,True
9896,2012-02-22,1,1,2,8,0,3,1,1,0.3,0.3182,0.75,0.0896,9,499,508,508,True
9897,2012-02-22,1,1,2,9,0,3,1,1,0.32,0.3333,0.7,0.0896,11,241,252,252,True
9898,2012-02-22,1,1,2,10,0,3,1,1,0.34,0.3485,0.71,0.0896,17,122,139,139,True
9899,2012-02-22,1,1,2,11,0,3,1,1,0.36,0.3485,0.66,0.1642,22,149,171,171,True
9900,2012-02-22,1,1,2,12,0,3,1,1,0.4,0.4091,0.62,0.2836,21,186,207,207,True
9901,2012-02-22,1,1,2,13,0,3,1,1,0.42,0.4242,0.54,0.2985,15,175,190,190,True
9902,2012-02-22,1,1,2,14,0,3,1,1,0.44,0.4394,0.54,0.3284,35,142,177,177,True
9903,2012-02-22,1,1,2,15,0,3,1,1,0.5,0.4848,0.31,0.4179,34,161,195,195,True
9904,2012-02-22,1,1,2,16,0,3,1,1,0.52,0.5,0.29,0.4627,30,268,298,298,True
9905,2012-02-22,1,1,2,17,0,3,1,1,0.52,0.5,0.32,0.3881,43,486,529,529,True
9906,2012-02-22,1,1,2,18,0,3,1,2,0.48,0.4697,0.41,0.3284,42,483,525,525,True
9907,2012-02-22,1,1,2,19,0,3,1,2,0.46,0.4545,0.44,0.2836,22,305,327,327,True
9908,2012-02-22,1,1,2,20,0,3,1,2,0.44,0.4394,0.47,0.194,25,249,274,274,True
9909,2012-02-22,1,1,2,21,0,3,1,2,0.48,0.4697,0.33,0.2836,19,220,239,239,True
9910,2012-02-22,1,1,2,22,0,3,1,2,0.44,0.4394,0.47,0.2537,18,129,147,147,True
9911,2012-02-22,1,1,2,23,0,3,1,2,0.46,0.4545,0.41,0.2836,5,57,62,62,True
9912,2012-02-23,1,1,2,0,0,4,1,2,0.44,0.4394,0.47,0.2537,12,30,42,42,True
9913,2012-02-23,1,1,2,1,0,4,1,2,0.44,0.4394,0.58,0.2836,3,12,15,15,True
9914,2012-02-23,1,1,2,2,0,4,1,2,0.44,0.4394,0.62,0.2239,5,4,9,9,True
9915,2012-02-23,1,1,2,3,0,4,1,3,0.44,0.4394,0.67,0.194,2,4,6,6,True
9916,2012-02-23,1,1,2,4,0,4,1,1,0.4,0.4091,0.76,0.2239,0,1,1,1,True
9917,2012-02-23,1,1,2,5,0,4,1,1,0.4,0.4091,0.76,0.2239,2,30,32,32,True
9918,2012-02-23,1,1,2,6,0,4,1,1,0.36,0.3485,0.87,0.194,3,88,91,91,True
9919,2012-02-23,1,1,2,7,0,4,1,1,0.36,0.3485,0.81,0.2239,9,317,326,326,True
9920,2012-02-23,1,1,2,8,0,4,1,1,0.34,0.3333,0.87,0.194,11,499,510,510,True
9921,2012-02-23,1,1,2,9,0,4,1,1,0.36,0.3333,0.81,0.2537,14,228,242,242,True
9922,2012-02-23,1,1,2,10,0,4,1,1,0.42,0.4242,0.67,0.194,41,107,148,148,True
9923,2012-02-23,1,1,2,11,0,4,1,1,0.48,0.4697,0.48,0.2836,54,128,182,182,True
9924,2012-02-23,1,1,2,12,0,4,1,1,0.5,0.4848,0.42,0.2537,25,199,224,224,True
9925,2012-02-23,1,1,2,13,0,4,1,1,0.52,0.5,0.39,0.194,30,188,218,218,True
9926,2012-02-23,1,1,2,14,0,4,1,1,0.54,0.5152,0.37,0.2537,36,156,192,192,True
9927,2012-02-23,1,1,2,15,0,4,1,1,0.54,0.5152,0.33,0.1343,46,171,217,217,True
9928,2012-02-23,1,1,2,16,0,4,1,1,0.56,0.5303,0.32,0.0,45,298,343,343,True
9929,2012-02-23,1,1,2,17,0,4,1,1,0.54,0.5152,0.32,0.1642,49,499,548,548,True
9930,2012-02-23,1,1,2,18,0,4,1,1,0.54,0.5152,0.37,0.1343,36,486,522,522,True
9931,2012-02-23,1,1,2,19,0,4,1,1,0.5,0.4848,0.39,0.0896,20,349,369,369,True
9932,2012-02-23,1,1,2,20,0,4,1,1,0.46,0.4545,0.44,0.1343,23,246,269,269,True
9933,2012-02-23,1,1,2,21,0,4,1,1,0.44,0.4394,0.51,0.2239,17,205,222,222,True
9934,2012-02-23,1,1,2,22,0,4,1,1,0.44,0.4394,0.54,0.2537,19,118,137,137,True
9935,2012-02-23,1,1,2,23,0,4,1,1,0.44,0.4394,0.54,0.0,14,71,85,85,True
9936,2012-02-24,1,1,2,0,0,5,1,2,0.44,0.4394,0.58,0.0896,12,34,46,46,True
9937,2012-02-24,1,1,2,1,0,5,1,1,0.44,0.4394,0.62,0.194,3,15,18,18,True
9938,2012-02-24,1,1,2,2,0,5,1,3,0.42,0.4242,0.77,0.2836,1,4,5,5,True
9939,2012-02-24,1,1,2,3,0,5,1,1,0.42,0.4242,0.82,0.1343,0,5,5,5,True
9940,2012-02-24,1,1,2,4,0,5,1,1,0.4,0.4091,0.87,0.1343,0,2,2,2,True
9941,2012-02-24,1,1,2,5,0,5,1,2,0.4,0.4091,0.87,0.194,1,25,26,26,True
9942,2012-02-24,1,1,2,6,0,5,1,2,0.4,0.4091,0.87,0.1642,2,80,82,82,True
9943,2012-02-24,1,1,2,7,0,5,1,2,0.4,0.4091,0.76,0.2239,7,265,272,272,True
9944,2012-02-24,1,1,2,8,0,5,1,2,0.38,0.3939,0.76,0.3284,17,452,469,469,True
9945,2012-02-24,1,1,2,9,0,5,1,3,0.36,0.3333,0.81,0.2537,15,229,244,244,True
9946,2012-02-24,1,1,2,10,0,5,1,3,0.36,0.3485,0.81,0.1642,22,119,141,141,True
9947,2012-02-24,1,1,2,11,0,5,1,2,0.36,0.3636,0.81,0.1045,27,136,163,163,True
9948,2012-02-24,1,1,2,12,0,5,1,2,0.4,0.4091,0.76,0.1343,27,201,228,228,True
9949,2012-02-24,1,1,2,13,0,5,1,2,0.42,0.4242,0.71,0.1045,30,153,183,183,True
9950,2012-02-24,1,1,2,14,0,5,1,2,0.46,0.4545,0.67,0.1045,5,26,31,31,True
9951,2012-02-24,1,1,2,15,0,5,1,3,0.4,0.4091,0.87,0.194,11,83,94,94,True
9952,2012-02-24,1,1,2,16,0,5,1,3,0.4,0.4091,0.87,0.194,12,166,178,178,True
9953,2012-02-24,1,1,2,17,0,5,1,3,0.42,0.4242,0.94,0.1045,14,242,256,256,True
9954,2012-02-24,1,1,2,18,0,5,1,2,0.42,0.4242,0.94,0.0,11,289,300,300,True
9955,2012-02-24,1,1,2,19,0,5,1,2,0.44,0.4394,0.88,0.1045,6,227,233,233,True
9956,2012-02-24,1,1,2,20,0,5,1,1,0.44,0.4394,0.62,0.4179,8,159,167,167,True
9957,2012-02-24,1,1,2,21,0,5,1,1,0.42,0.4242,0.35,0.4775,1,151,152,152,True
9958,2012-02-24,1,1,2,22,0,5,1,1,0.4,0.4091,0.37,0.4775,4,102,106,106,True
9959,2012-02-24,1,1,2,23,0,5,1,1,0.38,0.3939,0.37,0.4775,10,76,86,86,True
9960,2012-02-25,1,1,2,0,0,6,0,1,0.36,0.3333,0.43,0.3881,5,56,61,61,True
9961,2012-02-25,1,1,2,1,0,6,0,1,0.34,0.303,0.42,0.3582,4,42,46,46,True
9962,2012-02-25,1,1,2,2,0,6,0,1,0.32,0.303,0.45,0.2537,1,37,38,38,True
9963,2012-02-25,1,1,2,3,0,6,0,1,0.3,0.2727,0.45,0.2985,0,7,7,7,True
9964,2012-02-25,1,1,2,4,0,6,0,1,0.3,0.2727,0.42,0.3284,0,2,2,2,True
9965,2012-02-25,1,1,2,5,0,6,0,2,0.3,0.2727,0.42,0.2985,0,3,3,3,True
9966,2012-02-25,1,1,2,6,0,6,0,2,0.3,0.2727,0.42,0.2985,1,12,13,13,True
9967,2012-02-25,1,1,2,7,0,6,0,1,0.28,0.2424,0.45,0.4478,3,20,23,23,True
9968,2012-02-25,1,1,2,8,0,6,0,1,0.26,0.2273,0.48,0.2985,3,90,93,93,True
9969,2012-02-25,1,1,2,9,0,6,0,3,0.22,0.197,0.75,0.3284,15,107,122,122,True
9970,2012-02-25,1,1,2,10,0,6,0,1,0.26,0.2273,0.6,0.3582,24,159,183,183,True
9971,2012-02-25,1,1,2,11,0,6,0,1,0.3,0.2576,0.39,0.4775,23,187,210,210,True
9972,2012-02-25,1,1,2,12,0,6,0,1,0.32,0.2727,0.29,0.4775,41,217,258,258,True
9973,2012-02-25,1,1,2,13,0,6,0,1,0.32,0.2879,0.31,0.4775,48,178,226,226,True
9974,2012-02-25,1,1,2,14,0,6,0,1,0.32,0.2727,0.29,0.4775,35,181,216,216,True
9975,2012-02-25,1,1,2,15,0,6,0,1,0.32,0.2879,0.29,0.4179,21,211,232,232,True
9976,2012-02-25,1,1,2,16,0,6,0,1,0.32,0.2727,0.26,0.4775,32,163,195,195,True
9977,2012-02-25,1,1,2,17,0,6,0,1,0.3,0.2727,0.33,0.3582,16,143,159,159,True
9978,2012-02-25,1,1,2,18,0,6,0,1,0.3,0.2576,0.28,0.4775,7,126,133,133,True
9979,2012-02-25,1,1,2,19,0,6,0,1,0.26,0.2121,0.33,0.4478,12,137,149,149,True
9980,2012-02-25,1,1,2,20,0,6,0,1,0.26,0.2121,0.3,0.4775,10,95,105,105,True
9981,2012-02-25,1,1,2,21,0,6,0,1,0.24,0.2121,0.35,0.3284,5,80,85,85,True
9982,2012-02-25,1,1,2,22,0,6,0,1,0.24,0.197,0.38,0.4627,4,78,82,82,True
9983,2012-02-25,1,1,2,23,0,6,0,1,0.24,0.197,0.41,0.4179,7,84,91,91,True
9984,2012-02-26,1,1,2,0,0,0,0,1,0.24,0.2121,0.41,0.3582,7,63,70,70,True
9985,2012-02-26,1,1,2,1,0,0,0,1,0.24,0.2121,0.44,0.3284,5,50,55,55,True
9986,2012-02-26,1,1,2,2,0,0,0,1,0.24,0.2121,0.44,0.3284,5,37,42,42,True
9987,2012-02-26,1,1,2,3,0,0,0,1,0.24,0.2273,0.41,0.194,0,21,21,21,True
9988,2012-02-26,1,1,2,4,0,0,0,1,0.24,0.2273,0.41,0.194,1,5,6,6,True
9989,2012-02-26,1,1,2,5,0,0,0,1,0.22,0.2121,0.44,0.2239,0,5,5,5,True
9990,2012-02-26,1,1,2,6,0,0,0,1,0.22,0.197,0.44,0.3284,0,2,2,2,True
9991,2012-02-26,1,1,2,7,0,0,0,1,0.2,0.1818,0.51,0.2985,2,20,22,22,True
9992,2012-02-26,1,1,2,8,0,0,0,1,0.2,0.197,0.51,0.2537,2,57,59,59,True
9993,2012-02-26,1,1,2,9,0,0,0,1,0.22,0.2121,0.47,0.2239,11,76,87,87,True
9994,2012-02-26,1,1,2,10,0,0,0,1,0.26,0.2576,0.41,0.1642,27,161,188,188,True
9995,2012-02-26,1,1,2,11,0,0,0,1,0.28,0.2576,0.41,0.2836,43,184,227,227,True
9996,2012-02-26,1,1,2,12,0,0,0,1,0.3,0.303,0.39,0.1343,49,256,305,305,True
9997,2012-02-26,1,1,2,13,0,0,0,1,0.32,0.3333,0.36,0.0,58,267,325,325,True
9998,2012-02-26,1,1,2,14,0,0,0,1,0.34,0.3485,0.31,0.0,68,263,331,331,True
9999,2012-02-26,1,1,2,15,0,0,0,1,0.36,0.3485,0.29,0.0,72,281,353,353,True
10000,2012-02-26,1,1,2,16,0,0,0,1,0.36,0.3333,0.32,0.2537,64,275,339,339,True
10001,2012-02-26,1,1,2,17,0,0,0,1,0.36,0.3485,0.32,0.2239,46,241,287,287,True
10002,2012-02-26,1,1,2,18,0,0,0,1,0.34,0.3182,0.36,0.2836,17,199,216,216,True
10003,2012-02-26,1,1,2,19,0,0,0,1,0.34,0.3333,0.34,0.1642,13,130,143,143,True
10004,2012-02-26,1,1,2,20,0,0,0,1,0.32,0.3182,0.42,0.1642,9,79,88,88,True
10005,2012-02-26,1,1,2,21,0,0,0,1,0.3,0.303,0.45,0.1343,8,75,83,83,True
10006,2012-02-26,1,1,2,22,0,0,0,1,0.3,0.2879,0.42,0.2239,3,68,71,71,True
10007,2012-02-26,1,1,2,23,0,0,0,1,0.26,0.2576,0.56,0.1642,5,59,64,64,True
10008,2012-02-27,1,1,2,0,0,1,1,1,0.26,0.2424,0.6,0.2537,2,27,29,29,True
10009,2012-02-27,1,1,2,1,0,1,1,1,0.26,0.2576,0.65,0.2239,0,6,6,6,True
10010,2012-02-27,1,1,2,2,0,1,1,1,0.26,0.2273,0.7,0.2985,0,4,4,4,True
10011,2012-02-27,1,1,2,3,0,1,1,1,0.24,0.2424,0.75,0.1642,0,2,2,2,True
10012,2012-02-27,1,1,2,4,0,1,1,1,0.22,0.2273,0.8,0.1343,0,1,1,1,True
10013,2012-02-27,1,1,2,5,0,1,1,1,0.22,0.2273,0.8,0.1343,0,16,16,16,True
10014,2012-02-27,1,1,2,6,0,1,1,1,0.24,0.2273,0.7,0.2537,1,89,90,90,True
10015,2012-02-27,1,1,2,7,0,1,1,1,0.24,0.2273,0.6,0.2239,2,278,280,280,True
10016,2012-02-27,1,1,2,8,0,1,1,1,0.24,0.2424,0.6,0.0,14,499,513,513,True
10017,2012-02-27,1,1,2,9,0,1,1,1,0.26,0.2576,0.6,0.194,11,219,230,230,True
10018,2012-02-27,1,1,2,10,0,1,1,1,0.32,0.303,0.45,0.2537,16,88,104,104,True
10019,2012-02-27,1,1,2,11,0,1,1,1,0.36,0.3333,0.43,0.2537,11,92,103,103,True
10020,2012-02-27,1,1,2,12,0,1,1,1,0.4,0.4091,0.37,0.2985,13,164,177,177,True
10021,2012-02-27,1,1,2,13,0,1,1,1,0.4,0.4091,0.43,0.2836,23,159,182,182,True
10022,2012-02-27,1,1,2,14,0,1,1,1,0.46,0.4545,0.36,0.2836,24,134,158,158,True
10023,2012-02-27,1,1,2,15,0,1,1,1,0.52,0.5,0.25,0.4179,24,150,174,174,True
10024,2012-02-27,1,1,2,16,0,1,1,1,0.54,0.5152,0.26,0.4478,20,266,286,286,True
10025,2012-02-27,1,1,2,17,0,1,1,1,0.54,0.5152,0.24,0.4478,26,499,525,525,True
10026,2012-02-27,1,1,2,18,0,1,1,1,0.52,0.5,0.27,0.4179,10,499,509,509,True
10027,2012-02-27,1,1,2,19,0,1,1,1,0.5,0.4848,0.29,0.3881,16,318,334,334,True
10028,2012-02-27,1,1,2,20,0,1,1,1,0.48,0.4697,0.33,0.3582,11,208,219,219,True
10029,2012-02-27,1,1,2,21,0,1,1,1,0.46,0.4545,0.36,0.2836,14,181,195,195,True
10030,2012-02-27,1,1,2,22,0,1,1,1,0.44,0.4394,0.44,0.2537,9,83,92,92,True
10031,2012-02-27,1,1,2,23,0,1,1,1,0.42,0.4242,0.5,0.1642,6,50,56,56,True
10032,2012-02-28,1,1,2,0,0,2,1,1,0.42,0.4242,0.54,0.1343,0,10,10,10,True
10033,2012-02-28,1,1,2,1,0,2,1,1,0.38,0.3939,0.62,0.1642,0,6,6,6,True
10034,2012-02-28,1,1,2,2,0,2,1,1,0.4,0.4091,0.54,0.1045,1,2,3,3,True
10035,2012-02-28,1,1,2,3,0,2,1,1,0.4,0.4091,0.32,0.3582,0,6,6,6,True
10036,2012-02-28,1,1,2,4,0,2,1,1,0.32,0.2879,0.42,0.3582,0,2,2,2,True
10037,2012-02-28,1,1,2,5,0,2,1,1,0.32,0.2879,0.42,0.3582,1,20,21,21,True
10038,2012-02-28,1,1,2,6,0,2,1,1,0.3,0.2727,0.45,0.3284,1,100,101,101,True
10039,2012-02-28,1,1,2,7,0,2,1,1,0.28,0.2576,0.45,0.2985,12,313,325,325,True
10040,2012-02-28,1,1,2,8,0,2,1,1,0.26,0.2424,0.48,0.2836,16,499,515,515,True
10041,2012-02-28,1,1,2,9,0,2,1,1,0.28,0.2576,0.45,0.3582,7,225,232,232,True
10042,2012-02-28,1,1,2,10,0,2,1,1,0.3,0.2727,0.42,0.2985,14,118,132,132,True
10043,2012-02-28,1,1,2,11,0,2,1,1,0.34,0.3182,0.36,0.2537,8,155,163,163,True
10044,2012-02-28,1,1,2,12,0,2,1,1,0.36,0.3485,0.34,0.1343,19,164,183,183,True
10045,2012-02-28,1,1,2,13,0,2,1,1,0.36,0.3636,0.32,0.1045,16,174,190,190,True
10046,2012-02-28,1,1,2,14,0,2,1,1,0.4,0.4091,0.28,0.1045,13,121,134,134,True
10047,2012-02-28,1,1,2,15,0,2,1,1,0.42,0.4242,0.26,0.0896,17,149,166,166,True
10048,2012-02-28,1,1,2,16,0,2,1,1,0.42,0.4242,0.28,0.0896,17,270,287,287,True
10049,2012-02-28,1,1,2,17,0,2,1,1,0.42,0.4242,0.26,0.0896,33,497,530,530,True
10050,2012-02-28,1,1,2,18,0,2,1,1,0.42,0.4242,0.28,0.1642,17,432,449,449,True
10051,2012-02-28,1,1,2,19,0,2,1,1,0.42,0.4242,0.26,0.0,15,291,306,306,True
10052,2012-02-28,1,1,2,20,0,2,1,1,0.4,0.4091,0.3,0.1343,2,202,204,204,True
10053,2012-02-28,1,1,2,21,0,2,1,1,0.34,0.3485,0.46,0.1045,10,178,188,188,True
10054,2012-02-28,1,1,2,22,0,2,1,1,0.34,0.3485,0.46,0.1045,6,95,101,101,True
10055,2012-02-28,1,1,2,23,0,2,1,1,0.32,0.303,0.53,0.2239,4,61,65,65,True
10056,2012-02-29,1,1,2,0,0,3,1,1,0.32,0.3333,0.53,0.1045,2,30,32,32,True
10057,2012-02-29,1,1,2,1,0,3,1,1,0.32,0.3333,0.49,0.1045,0,6,6,6,True
10058,2012-02-29,1,1,2,2,0,3,1,1,0.3,0.2879,0.56,0.2239,0,4,4,4,True
10059,2012-02-29,1,1,2,3,0,3,1,1,0.28,0.303,0.7,0.0896,0,2,2,2,True
10060,2012-02-29,1,1,2,5,0,3,1,1,0.26,0.2879,0.75,0.0896,0,29,29,29,True
10061,2012-02-29,1,1,2,6,0,3,1,2,0.28,0.303,0.75,0.0896,4,100,104,104,True
10062,2012-02-29,1,1,2,7,0,3,1,2,0.26,0.2727,0.81,0.1343,11,242,253,253,True
10063,2012-02-29,1,1,2,8,0,3,1,2,0.28,0.2879,0.75,0.1045,2,114,116,116,True
10064,2012-02-29,1,1,2,9,0,3,1,3,0.3,0.303,0.81,0.1642,5,33,38,38,True
10065,2012-02-29,1,1,2,10,0,3,1,3,0.3,0.303,0.81,0.1642,0,10,10,10,True
10066,2012-02-29,1,1,2,11,0,3,1,3,0.3,0.2879,0.87,0.194,1,9,10,10,True
10067,2012-02-29,1,1,2,12,0,3,1,3,0.32,0.303,0.93,0.3284,1,69,70,70,True
10068,2012-02-29,1,1,2,13,0,3,1,2,0.36,0.3333,0.93,0.3582,4,72,76,76,True
10069,2012-02-29,1,1,2,14,0,3,1,2,0.36,0.3333,0.93,0.3582,2,54,56,56,True
10070,2012-02-29,1,1,2,15,0,3,1,2,0.4,0.4091,0.82,0.2836,3,87,90,90,True
10071,2012-02-29,1,1,2,16,0,3,1,3,0.4,0.4091,0.82,0.2239,5,162,167,167,True
10072,2012-02-29,1,1,2,17,0,3,1,2,0.4,0.4091,0.87,0.1642,7,246,253,253,True
10073,2012-02-29,1,1,2,18,0,3,1,3,0.4,0.4091,0.87,0.0,11,181,192,192,True
10074,2012-02-29,1,1,2,19,0,3,1,2,0.4,0.4091,0.87,0.1045,0,102,102,102,True
10075,2012-02-29,1,1,2,20,0,3,1,3,0.42,0.4242,0.88,0.1642,2,95,97,97,True
10076,2012-02-29,1,1,2,21,0,3,1,3,0.42,0.4242,0.88,0.1642,0,39,39,39,True
10077,2012-02-29,1,1,2,22,0,3,1,3,0.42,0.4242,0.94,0.2537,2,53,55,55,True
10078,2012-02-29,1,1,2,23,0,3,1,3,0.42,0.4242,0.94,0.2537,3,30,33,33,True
10079,2012-03-01,1,1,3,0,0,4,1,2,0.42,0.4242,0.94,0.0,1,10,11,11,True
10080,2012-03-01,1,1,3,1,0,4,1,3,0.46,0.4545,0.94,0.1045,0,12,12,12,True
10081,2012-03-01,1,1,3,2,0,4,1,2,0.46,0.4545,0.94,0.2836,0,6,6,6,True
10082,2012-03-01,1,1,3,3,0,4,1,1,0.46,0.4545,0.94,0.2239,0,3,3,3,True
10083,2012-03-01,1,1,3,4,0,4,1,1,0.48,0.4697,0.88,0.194,0,5,5,5,True
10084,2012-03-01,1,1,3,5,0,4,1,1,0.48,0.4697,0.88,0.1642,0,18,18,18,True
10085,2012-03-01,1,1,3,6,0,4,1,2,0.42,0.4242,0.94,0.0,2,107,109,109,True
10086,2012-03-01,1,1,3,7,0,4,1,2,0.44,0.4394,0.94,0.1343,8,296,304,304,True
10087,2012-03-01,1,1,3,8,0,4,1,1,0.42,0.4242,0.94,0.1343,15,499,514,514,True
10088,2012-03-01,1,1,3,9,0,4,1,1,0.46,0.4545,0.77,0.2537,5,281,286,286,True
10089,2012-03-01,1,1,3,10,0,4,1,1,0.52,0.5,0.55,0.1642,11,122,133,133,True
10090,2012-03-01,1,1,3,11,0,4,1,1,0.56,0.5303,0.43,0.194,19,149,168,168,True
10091,2012-03-01,1,1,3,12,0,4,1,1,0.56,0.5303,0.37,0.2239,16,204,220,220,True
10092,2012-03-01,1,1,3,13,0,4,1,1,0.58,0.5455,0.32,0.2537,24,187,211,211,True
10093,2012-03-01,1,1,3,14,0,4,1,1,0.58,0.5455,0.35,0.2239,37,174,211,211,True
10094,2012-03-01,1,1,3,15,0,4,1,1,0.6,0.6212,0.31,0.2537,31,192,223,223,True
10095,2012-03-01,1,1,3,16,0,4,1,1,0.58,0.5455,0.32,0.2985,38,323,361,361,True
10096,2012-03-01,1,1,3,17,0,4,1,1,0.56,0.5303,0.35,0.2985,49,499,548,548,True
10097,2012-03-01,1,1,3,18,0,4,1,1,0.54,0.5152,0.34,0.3582,27,498,525,525,True
10098,2012-03-01,1,1,3,19,0,4,1,1,0.48,0.4697,0.41,0.3284,11,317,328,328,True
10099,2012-03-01,1,1,3,20,0,4,1,1,0.44,0.4394,0.44,0.4179,12,242,254,254,True
10100,2012-03-01,1,1,3,21,0,4,1,1,0.42,0.4242,0.47,0.4627,7,190,197,197,True
10101,2012-03-01,1,1,3,22,0,4,1,1,0.38,0.3939,0.5,0.2537,3,123,126,126,True
10102,2012-03-01,1,1,3,23,0,4,1,1,0.36,0.3485,0.5,0.2239,9,76,85,85,True
10103,2012-03-02,1,1,3,0,0,5,1,1,0.34,0.3333,0.53,0.1642,1,45,46,46,True
10104,2012-03-02,1,1,3,1,0,5,1,1,0.34,0.3182,0.49,0.2239,2,18,20,20,True
10105,2012-03-02,1,1,3,2,0,5,1,1,0.34,0.3182,0.53,0.2836,2,4,6,6,True
10106,2012-03-02,1,1,3,3,0,5,1,1,0.32,0.3182,0.57,0.194,0,3,3,3,True
10107,2012-03-02,1,1,3,4,0,5,1,1,0.32,0.3485,0.61,0.0,0,2,2,2,True
10108,2012-03-02,1,1,3,5,0,5,1,1,0.3,0.3333,0.7,0.0,0,24,24,24,True
10109,2012-03-02,1,1,3,6,0,5,1,1,0.3,0.3333,0.7,0.0,4,88,92,92,True
10110,2012-03-02,1,1,3,7,0,5,1,1,0.3,0.3333,0.7,0.0,4,258,262,262,True
10111,2012-03-02,1,1,3,8,0,5,1,1,0.28,0.303,0.75,0.0896,16,499,515,515,True
10112,2012-03-02,1,1,3,9,0,5,1,1,0.3,0.3333,0.81,0.0,15,299,314,314,True
10113,2012-03-02,1,1,3,10,0,5,1,1,0.36,0.3485,0.5,0.1642,14,118,132,132,True
10114,2012-03-02,1,1,3,11,0,5,1,1,0.38,0.3939,0.46,0.194,40,154,194,194,True
10115,2012-03-02,1,1,3,12,0,5,1,1,0.4,0.4091,0.43,0.1642,40,194,234,234,True
10116,2012-03-02,1,1,3,13,0,5,1,1,0.42,0.4242,0.44,0.2239,31,191,222,222,True
10117,2012-03-02,1,1,3,14,0,5,1,2,0.44,0.4394,0.44,0.2836,29,176,205,205,True
10118,2012-03-02,1,1,3,15,0,5,1,2,0.42,0.4242,0.5,0.2985,5,73,78,78,True
10119,2012-03-02,1,1,3,16,0,5,1,3,0.4,0.4091,0.58,0.2985,1,49,50,50,True
10120,2012-03-02,1,1,3,17,0,5,1,3,0.36,0.3485,0.81,0.2239,5,123,128,128,True
10121,2012-03-02,1,1,3,18,0,5,1,3,0.36,0.3485,0.87,0.194,6,154,160,160,True
10122,2012-03-02,1,1,3,19,0,5,1,3,0.36,0.3485,0.87,0.194,12,162,174,174,True
10123,2012-03-02,1,1,3,20,0,5,1,2,0.36,0.3485,0.87,0.194,7,93,100,100,True
10124,2012-03-02,1,1,3,21,0,5,1,3,0.36,0.3636,0.87,0.0896,2,99,101,101,True
10125,2012-03-02,1,1,3,22,0,5,1,2,0.36,0.3788,0.87,0.0,6,69,75,75,True
10126,2012-03-02,1,1,3,23,0,5,1,2,0.36,0.3788,0.87,0.0,4,19,23,23,True
10127,2012-03-03,1,1,3,0,0,6,0,3,0.36,0.3636,0.93,0.0896,1,21,22,22,True
10128,2012-03-03,1,1,3,1,0,6,0,3,0.36,0.3788,0.93,0.0,0,44,44,44,True
10129,2012-03-03,1,1,3,2,0,6,0,3,0.36,0.3636,0.93,0.0896,4,34,38,38,True
10130,2012-03-03,1,1,3,3,0,6,0,2,0.36,0.3485,0.93,0.1642,1,20,21,21,True
10131,2012-03-03,1,1,3,4,0,6,0,2,0.36,0.3485,0.93,0.194,0,2,2,2,True
10132,2012-03-03,1,1,3,5,0,6,0,2,0.36,0.3636,0.93,0.0896,1,1,2,2,True
10133,2012-03-03,1,1,3,6,0,6,0,2,0.36,0.3636,0.93,0.0896,1,6,7,7,True
10134,2012-03-03,1,1,3,7,0,6,0,2,0.36,0.3485,0.93,0.1343,2,14,16,16,True
10135,2012-03-03,1,1,3,8,0,6,0,3,0.36,0.3788,0.93,0.0,2,46,48,48,True
10136,2012-03-03,1,1,3,9,0,6,0,3,0.38,0.3939,0.87,0.0896,7,87,94,94,True
10137,2012-03-03,1,1,3,10,0,6,0,2,0.4,0.4091,0.87,0.0,31,137,168,168,True
10138,2012-03-03,1,1,3,11,0,6,0,2,0.4,0.4091,0.87,0.0896,33,181,214,214,True
10139,2012-03-03,1,1,3,12,0,6,0,2,0.42,0.4242,0.67,0.2537,47,252,299,299,True
10140,2012-03-03,1,1,3,13,0,6,0,1,0.44,0.4394,0.51,0.2836,87,252,339,339,True
10141,2012-03-03,1,1,3,14,0,6,0,2,0.46,0.4545,0.44,0.3582,114,279,393,393,True
10142,2012-03-03,1,1,3,15,0,6,0,1,0.48,0.4697,0.29,0.2985,114,254,368,368,True
10143,2012-03-03,1,1,3,16,0,6,0,1,0.5,0.4848,0.27,0.2985,114,300,414,414,True
10144,2012-03-03,1,1,3,17,0,6,0,1,0.5,0.4848,0.23,0.3284,106,279,385,385,True
10145,2012-03-03,1,1,3,18,0,6,0,1,0.5,0.4848,0.25,0.2537,53,250,303,303,True
10146,2012-03-03,1,1,3,19,0,6,0,1,0.46,0.4545,0.33,0.1642,34,191,225,225,True
10147,2012-03-03,1,1,3,20,0,6,0,1,0.44,0.4394,0.3,0.1343,28,121,149,149,True
10148,2012-03-03,1,1,3,21,0,6,0,1,0.46,0.4545,0.19,0.3284,24,130,154,154,True
10149,2012-03-03,1,1,3,22,0,6,0,1,0.44,0.4394,0.21,0.1343,19,115,134,134,True
10150,2012-03-03,1,1,3,23,0,6,0,1,0.42,0.4242,0.24,0.0,12,94,106,106,True
10151,2012-03-04,1,1,3,0,0,0,0,2,0.4,0.4091,0.3,0.3582,5,67,72,72,True
10152,2012-03-04,1,1,3,1,0,0,0,2,0.38,0.3939,0.34,0.194,16,60,76,76,True
10153,2012-03-04,1,1,3,2,0,0,0,2,0.36,0.3485,0.4,0.1642,14,66,80,80,True
10154,2012-03-04,1,1,3,3,0,0,0,2,0.36,0.3485,0.43,0.1343,5,21,26,26,True
10155,2012-03-04,1,1,3,4,0,0,0,2,0.34,0.3333,0.46,0.194,3,11,14,14,True
10156,2012-03-04,1,1,3,5,0,0,0,2,0.34,0.3182,0.46,0.2239,0,5,5,5,True
10157,2012-03-04,1,1,3,6,0,0,0,2,0.3,0.2727,0.52,0.2985,0,5,5,5,True
10158,2012-03-04,1,1,3,7,0,0,0,2,0.3,0.2727,0.52,0.2985,2,21,23,23,True
10159,2012-03-04,1,1,3,8,0,0,0,1,0.3,0.2727,0.52,0.3284,12,54,66,66,True
10160,2012-03-04,1,1,3,9,0,0,0,1,0.3,0.2727,0.49,0.4478,14,104,118,118,True
10161,2012-03-04,1,1,3,10,0,0,0,1,0.3,0.2727,0.49,0.3284,31,161,192,192,True
10162,2012-03-04,1,1,3,11,0,0,0,1,0.32,0.2879,0.45,0.3881,64,192,256,256,True
10163,2012-03-04,1,1,3,12,0,0,0,1,0.34,0.303,0.42,0.3582,71,256,327,327,True
10164,2012-03-04,1,1,3,13,0,0,0,1,0.36,0.3333,0.37,0.3582,108,256,364,364,True
10165,2012-03-04,1,1,3,14,0,0,0,1,0.36,0.3333,0.34,0.3582,106,226,332,332,True
10166,2012-03-04,1,1,3,15,0,0,0,1,0.36,0.3182,0.32,0.4775,82,252,334,334,True
10167,2012-03-04,1,1,3,16,0,0,0,1,0.36,0.3182,0.29,0.4775,68,231,299,299,True
10168,2012-03-04,1,1,3,17,0,0,0,1,0.34,0.2879,0.31,0.4775,49,214,263,263,True
10169,2012-03-04,1,1,3,18,0,0,0,1,0.32,0.2727,0.33,0.4775,20,164,184,184,True
10170,2012-03-04,1,1,3,19,0,0,0,1,0.3,0.2576,0.36,0.4775,12,120,132,132,True
10171,2012-03-04,1,1,3,20,0,0,0,1,0.28,0.2727,0.38,0.2537,8,80,88,88,True
10172,2012-03-04,1,1,3,21,0,0,0,1,0.28,0.2727,0.36,0.2239,9,70,79,79,True
10173,2012-03-04,1,1,3,22,0,0,0,1,0.26,0.2424,0.41,0.2537,9,53,62,62,True
10174,2012-03-04,1,1,3,23,0,0,0,1,0.26,0.2576,0.41,0.194,2,24,26,26,True
10175,2012-03-05,1,1,3,0,0,1,1,1,0.24,0.2273,0.44,0.194,2,15,17,17,True
10176,2012-03-05,1,1,3,1,0,1,1,1,0.24,0.2424,0.48,0.1343,3,3,6,6,True
10177,2012-03-05,1,1,3,2,0,1,1,1,0.24,0.2424,0.48,0.1343,1,3,4,4,True
10178,2012-03-05,1,1,3,3,0,1,1,1,0.22,0.2273,0.51,0.1642,0,1,1,1,True
10179,2012-03-05,1,1,3,4,0,1,1,1,0.2,0.2273,0.55,0.0896,0,1,1,1,True
10180,2012-03-05,1,1,3,5,0,1,1,1,0.2,0.2273,0.55,0.0896,1,17,18,18,True
10181,2012-03-05,1,1,3,6,0,1,1,1,0.18,0.197,0.59,0.1343,2,89,91,91,True
10182,2012-03-05,1,1,3,7,0,1,1,1,0.18,0.197,0.59,0.1343,7,253,260,260,True
10183,2012-03-05,1,1,3,8,0,1,1,1,0.2,0.2273,0.59,0.1045,13,415,428,428,True
10184,2012-03-05,1,1,3,9,0,1,1,2,0.22,0.2576,0.6,0.0896,11,186,197,197,True
10185,2012-03-05,1,1,3,10,0,1,1,2,0.24,0.2576,0.6,0.0,12,74,86,86,True
10186,2012-03-05,1,1,3,11,0,1,1,2,0.26,0.2727,0.56,0.1343,17,86,103,103,True
10187,2012-03-05,1,1,3,12,0,1,1,2,0.26,0.303,0.52,0.0,15,122,137,137,True
10188,2012-03-05,1,1,3,13,0,1,1,2,0.26,0.2576,0.55,0.2985,11,109,120,120,True
10189,2012-03-05,1,1,3,14,0,1,1,2,0.28,0.2576,0.57,0.3582,13,115,128,128,True
10190,2012-03-05,1,1,3,15,0,1,1,2,0.3,0.2879,0.53,0.194,20,110,130,130,True
10191,2012-03-05,1,1,3,16,0,1,1,1,0.3,0.2727,0.45,0.2985,30,180,210,210,True
10192,2012-03-05,1,1,3,17,0,1,1,3,0.3,0.2727,0.45,0.2985,11,376,387,387,True
10193,2012-03-05,1,1,3,18,0,1,1,3,0.28,0.2273,0.55,0.4775,12,363,375,375,True
10194,2012-03-05,1,1,3,19,0,1,1,1,0.26,0.2576,0.53,0.2239,6,220,226,226,True
10195,2012-03-05,1,1,3,20,0,1,1,1,0.26,0.2273,0.37,0.4627,8,171,179,179,True
10196,2012-03-05,1,1,3,21,0,1,1,1,0.26,0.2273,0.37,0.3881,4,116,120,120,True
10197,2012-03-05,1,1,3,22,0,1,1,1,0.24,0.2121,0.35,0.3284,2,76,78,78,True
10198,2012-03-05,1,1,3,23,0,1,1,1,0.22,0.1818,0.37,0.4775,2,29,31,31,True
10199,2012-03-06,1,1,3,0,0,2,1,1,0.22,0.2121,0.37,0.2985,0,8,8,8,True
10200,2012-03-06,1,1,3,1,0,2,1,1,0.2,0.197,0.44,0.2537,0,6,6,6,True
10201,2012-03-06,1,1,3,2,0,2,1,1,0.2,0.197,0.44,0.2239,0,4,4,4,True
10202,2012-03-06,1,1,3,3,0,2,1,1,0.18,0.1667,0.51,0.2836,0,1,1,1,True
10203,2012-03-06,1,1,3,4,0,2,1,1,0.18,0.1667,0.51,0.2985,0,3,3,3,True
10204,2012-03-06,1,1,3,5,0,2,1,1,0.18,0.1818,0.51,0.2239,0,25,25,25,True
10205,2012-03-06,1,1,3,6,0,2,1,1,0.18,0.2121,0.51,0.1045,3,99,102,102,True
10206,2012-03-06,1,1,3,7,0,2,1,1,0.16,0.1818,0.55,0.1343,5,270,275,275,True
10207,2012-03-06,1,1,3,8,0,2,1,1,0.16,0.1818,0.59,0.1045,14,487,501,501,True
10208,2012-03-06,1,1,3,9,0,2,1,1,0.22,0.2727,0.47,0.0,11,222,233,233,True
10209,2012-03-06,1,1,3,10,0,2,1,1,0.24,0.2576,0.44,0.0,16,113,129,129,True
10210,2012-03-06,1,1,3,11,0,2,1,1,0.26,0.2576,0.41,0.1642,20,110,130,130,True
10211,2012-03-06,1,1,3,12,0,2,1,1,0.26,0.2727,0.41,0.1045,9,129,138,138,True
10212,2012-03-06,1,1,3,13,0,2,1,1,0.3,0.303,0.39,0.1343,16,148,164,164,True
10213,2012-03-06,1,1,3,14,0,2,1,1,0.32,0.303,0.36,0.2239,20,116,136,136,True
10214,2012-03-06,1,1,3,15,0,2,1,1,0.34,0.303,0.36,0.2985,24,142,166,166,True
10215,2012-03-06,1,1,3,16,0,2,1,1,0.36,0.3333,0.32,0.2836,22,228,250,250,True
10216,2012-03-06,1,1,3,17,0,2,1,1,0.36,0.3333,0.34,0.2836,21,425,446,446,True
10217,2012-03-06,1,1,3,18,0,2,1,1,0.34,0.303,0.42,0.3284,15,442,457,457,True
10218,2012-03-06,1,1,3,19,0,2,1,1,0.34,0.303,0.46,0.2985,9,278,287,287,True
10219,2012-03-06,1,1,3,20,0,2,1,1,0.32,0.3182,0.49,0.194,3,184,187,187,True
10220,2012-03-06,1,1,3,21,0,2,1,1,0.32,0.3182,0.49,0.194,5,143,148,148,True
10221,2012-03-06,1,1,3,22,0,2,1,1,0.28,0.2727,0.56,0.1642,5,101,106,106,True
10222,2012-03-06,1,1,3,23,0,2,1,1,0.28,0.2727,0.61,0.2239,3,51,54,54,True
10223,2012-03-07,1,1,3,0,0,3,1,1,0.28,0.2576,0.65,0.2836,3,12,15,15,True
10224,2012-03-07,1,1,3,1,0,3,1,1,0.3,0.2727,0.61,0.2985,1,4,5,5,True
10225,2012-03-07,1,1,3,2,0,3,1,1,0.3,0.2879,0.56,0.2836,0,4,4,4,True
10226,2012-03-07,1,1,3,3,0,3,1,1,0.3,0.2727,0.56,0.3582,1,2,3,3,True
10227,2012-03-07,1,1,3,4,0,3,1,1,0.28,0.2576,0.61,0.3284,0,3,3,3,True
10228,2012-03-07,1,1,3,5,0,3,1,1,0.28,0.2576,0.56,0.2985,0,18,18,18,True
10229,2012-03-07,1,1,3,6,0,3,1,1,0.28,0.2576,0.61,0.3881,4,104,108,108,True
10230,2012-03-07,1,1,3,7,0,3,1,1,0.26,0.2273,0.65,0.3881,12,332,344,344,True
10231,2012-03-07,1,1,3,8,0,3,1,1,0.28,0.2576,0.61,0.2985,12,499,511,511,True
10232,2012-03-07,1,1,3,9,0,3,1,1,0.3,0.2727,0.61,0.3284,12,252,264,264,True
10233,2012-03-07,1,1,3,10,0,3,1,1,0.36,0.3333,0.5,0.2985,20,127,147,147,True
10234,2012-03-07,1,1,3,11,0,3,1,1,0.42,0.4242,0.38,0.2985,33,128,161,161,True
10235,2012-03-07,1,1,3,12,0,3,1,1,0.44,0.4394,0.38,0.3881,40,175,215,215,True
10236,2012-03-07,1,1,3,13,0,3,1,1,0.5,0.4848,0.34,0.4179,26,179,205,205,True
10237,2012-03-07,1,1,3,14,0,3,1,1,0.52,0.5,0.36,0.3284,38,137,175,175,True
10238,2012-03-07,1,1,3,15,0,3,1,1,0.54,0.5152,0.37,0.4478,44,165,209,209,True
10239,2012-03-07,1,1,3,16,0,3,1,1,0.56,0.5303,0.37,0.4179,34,254,288,288,True
10240,2012-03-07,1,1,3,17,0,3,1,1,0.56,0.5303,0.43,0.4775,58,499,557,557,True
10241,2012-03-07,1,1,3,18,0,3,1,1,0.56,0.5303,0.4,0.4627,35,499,534,534,True
10242,2012-03-07,1,1,3,19,0,3,1,1,0.54,0.5152,0.42,0.3582,16,345,361,361,True
10243,2012-03-07,1,1,3,20,0,3,1,1,0.5,0.4848,0.51,0.2537,18,242,260,260,True
10244,2012-03-07,1,1,3,21,0,3,1,1,0.44,0.4394,0.62,0.2537,11,177,188,188,True
10245,2012-03-07,1,1,3,22,0,3,1,1,0.46,0.4545,0.59,0.2985,10,149,159,159,True
10246,2012-03-07,1,1,3,23,0,3,1,1,0.44,0.4394,0.62,0.3284,4,58,62,62,True
10247,2012-03-08,1,1,3,0,0,4,1,1,0.44,0.4394,0.62,0.3284,11,35,46,46,True
10248,2012-03-08,1,1,3,1,0,4,1,1,0.46,0.4545,0.63,0.3284,4,17,21,21,True
10249,2012-03-08,1,1,3,2,0,4,1,1,0.46,0.4545,0.63,0.3881,6,5,11,11,True
10250,2012-03-08,1,1,3,3,0,4,1,1,0.46,0.4545,0.63,0.3881,0,3,3,3,True
10251,2012-03-08,1,1,3,4,0,4,1,1,0.44,0.4394,0.72,0.2836,0,2,2,2,True
10252,2012-03-08,1,1,3,5,0,4,1,1,0.42,0.4242,0.77,0.2239,1,28,29,29,True
10253,2012-03-08,1,1,3,6,0,4,1,1,0.42,0.4242,0.77,0.2537,4,105,109,109,True
10254,2012-03-08,1,1,3,7,0,4,1,1,0.42,0.4242,0.77,0.3582,8,326,334,334,True
10255,2012-03-08,1,1,3,8,0,4,1,1,0.44,0.4394,0.77,0.3881,12,499,511,511,True
10256,2012-03-08,1,1,3,9,0,4,1,1,0.46,0.4545,0.72,0.4627,19,282,301,301,True
10257,2012-03-08,1,1,3,10,0,4,1,1,0.5,0.4848,0.68,0.4627,19,119,138,138,True
10258,2012-03-08,1,1,3,11,0,4,1,2,0.54,0.5152,0.6,0.4627,48,156,204,204,True
10259,2012-03-08,1,1,3,12,0,4,1,2,0.56,0.5303,0.6,0.4478,27,224,251,251,True
10260,2012-03-08,1,1,3,13,0,4,1,2,0.6,0.6212,0.49,0.4775,35,198,233,233,True
10261,2012-03-08,1,1,3,14,0,4,1,2,0.62,0.6212,0.43,0.4775,48,155,203,203,True
10262,2012-03-08,1,1,3,15,0,4,1,1,0.64,0.6212,0.38,0.4775,24,161,185,185,True
10263,2012-03-08,1,1,3,16,0,4,1,2,0.62,0.6212,0.41,0.4775,37,305,342,342,True
10264,2012-03-08,1,1,3,17,0,4,1,1,0.62,0.6212,0.38,0.4775,52,499,551,551,True
10265,2012-03-08,1,1,3,18,0,4,1,2,0.62,0.6212,0.38,0.4775,45,499,544,544,True
10266,2012-03-08,1,1,3,19,0,4,1,2,0.6,0.6212,0.4,0.4478,21,395,416,416,True
10267,2012-03-08,1,1,3,20,0,4,1,2,0.6,0.6212,0.43,0.3881,20,282,302,302,True
10268,2012-03-08,1,1,3,21,0,4,1,1,0.6,0.6212,0.43,0.3881,27,206,233,233,True
10269,2012-03-08,1,1,3,22,0,4,1,1,0.56,0.5303,0.49,0.3284,12,141,153,153,True
10270,2012-03-08,1,1,3,23,0,4,1,2,0.56,0.5303,0.49,0.4478,6,88,94,94,True
10271,2012-03-09,1,1,3,0,0,5,1,2,0.58,0.5455,0.49,0.4627,3,51,54,54,True
10272,2012-03-09,1,1,3,1,0,5,1,3,0.56,0.5303,0.52,0.4775,4,22,26,26,True
10273,2012-03-09,1,1,3,2,0,5,1,3,0.48,0.4697,0.77,0.4179,2,9,11,11,True
10274,2012-03-09,1,1,3,3,0,5,1,1,0.46,0.4545,0.77,0.4775,0,7,7,7,True
10275,2012-03-09,1,1,3,4,0,5,1,3,0.4,0.4091,0.66,0.2836,0,1,1,1,True
10276,2012-03-09,1,1,3,5,0,5,1,3,0.4,0.4091,0.66,0.2836,2,27,29,29,True
10277,2012-03-09,1,1,3,6,0,5,1,2,0.4,0.4091,0.5,0.3582,2,83,85,85,True
10278,2012-03-09,1,1,3,7,0,5,1,2,0.38,0.3939,0.4,0.2985,6,262,268,268,True
10279,2012-03-09,1,1,3,8,0,5,1,2,0.34,0.2879,0.42,0.4775,17,484,501,501,True
10280,2012-03-09,1,1,3,9,0,5,1,2,0.34,0.2879,0.42,0.4775,17,267,284,284,True
10281,2012-03-09,1,1,3,10,0,5,1,2,0.34,0.2879,0.36,0.4775,14,145,159,159,True
10282,2012-03-09,1,1,3,11,0,5,1,2,0.36,0.3333,0.34,0.3582,17,170,187,187,True
10283,2012-03-09,1,1,3,12,0,5,1,1,0.36,0.3333,0.34,0.4179,27,174,201,201,True
10284,2012-03-09,1,1,3,13,0,5,1,2,0.38,0.3939,0.29,0.3881,49,175,224,224,True
10285,2012-03-09,1,1,3,14,0,5,1,1,0.42,0.4242,0.28,0.4627,49,129,178,178,True
10286,2012-03-09,1,1,3,15,0,5,1,1,0.46,0.4545,0.24,0.2537,50,188,238,238,True
10287,2012-03-09,1,1,3,16,0,5,1,1,0.48,0.4697,0.23,0.4179,51,292,343,343,True
10288,2012-03-09,1,1,3,17,0,5,1,1,0.46,0.4545,0.24,0.3881,68,498,566,566,True
10289,2012-03-09,1,1,3,18,0,5,1,1,0.44,0.4394,0.26,0.4775,30,440,470,470,True
10290,2012-03-09,1,1,3,19,0,5,1,1,0.42,0.4242,0.28,0.4775,12,232,244,244,True
10291,2012-03-09,1,1,3,20,0,5,1,1,0.38,0.3939,0.32,0.3582,3,156,159,159,True
10292,2012-03-09,1,1,3,21,0,5,1,1,0.36,0.3333,0.34,0.3284,8,133,141,141,True
10293,2012-03-09,1,1,3,22,0,5,1,1,0.34,0.2879,0.31,0.4775,7,100,107,107,True
10294,2012-03-09,1,1,3,23,0,5,1,1,0.32,0.303,0.33,0.2985,9,77,86,86,True
10295,2012-03-10,1,1,3,0,0,6,0,1,0.3,0.2727,0.36,0.3582,9,68,77,77,True
10296,2012-03-10,1,1,3,1,0,6,0,1,0.3,0.2879,0.36,0.2537,1,50,51,51,True
10297,2012-03-10,1,1,3,2,0,6,0,1,0.26,0.2424,0.41,0.2537,12,30,42,42,True
10298,2012-03-10,1,1,3,3,0,6,0,1,0.26,0.2273,0.41,0.2985,0,16,16,16,True
10299,2012-03-10,1,1,3,4,0,6,0,1,0.24,0.2121,0.41,0.3582,1,3,4,4,True
10300,2012-03-10,1,1,3,5,0,6,0,1,0.22,0.2121,0.42,0.2836,3,7,10,10,True
10301,2012-03-10,1,1,3,6,0,6,0,1,0.22,0.2121,0.44,0.2836,1,11,12,12,True
10302,2012-03-10,1,1,3,7,0,6,0,1,0.22,0.2121,0.44,0.2537,4,36,40,40,True
10303,2012-03-10,1,1,3,8,0,6,0,1,0.22,0.2121,0.44,0.2985,15,96,111,111,True
10304,2012-03-10,1,1,3,9,0,6,0,1,0.24,0.2121,0.41,0.3284,21,127,148,148,True
10305,2012-03-10,1,1,3,10,0,6,0,1,0.26,0.2273,0.35,0.4179,47,176,223,223,True
10306,2012-03-10,1,1,3,11,0,6,0,1,0.3,0.2727,0.33,0.3284,56,218,274,274,True
10307,2012-03-10,1,1,3,12,0,6,0,1,0.3,0.2727,0.33,0.3284,88,241,329,329,True
10308,2012-03-10,1,1,3,13,0,6,0,1,0.32,0.303,0.29,0.2836,89,268,357,357,True
10309,2012-03-10,1,1,3,14,0,6,0,1,0.34,0.3182,0.27,0.2836,114,262,376,376,True
10310,2012-03-10,1,1,3,15,0,6,0,1,0.34,0.3636,0.25,0.0,114,274,388,388,True
10311,2012-03-10,1,1,3,16,0,6,0,1,0.36,0.3636,0.23,0.0,114,275,389,389,True
10312,2012-03-10,1,1,3,17,0,6,0,1,0.36,0.3788,0.23,0.0,104,250,354,354,True
10313,2012-03-10,1,1,3,18,0,6,0,1,0.36,0.3636,0.21,0.0896,67,230,297,297,True
10314,2012-03-10,1,1,3,19,0,6,0,1,0.34,0.3636,0.25,0.0,25,159,184,184,True
10315,2012-03-10,1,1,3,20,0,6,0,1,0.32,0.3333,0.33,0.1343,20,101,121,121,True
10316,2012-03-10,1,1,3,21,0,6,0,1,0.3,0.2879,0.39,0.2239,16,94,110,110,True
10317,2012-03-10,1,1,3,22,0,6,0,1,0.26,0.2576,0.44,0.1642,19,81,100,100,True
10318,2012-03-10,1,1,3,23,0,6,0,1,0.26,0.2576,0.41,0.194,6,77,83,83,True
10319,2012-03-11,1,1,3,0,0,0,0,1,0.26,0.2879,0.44,0.0896,7,62,69,69,True
10320,2012-03-11,1,1,3,1,0,0,0,1,0.24,0.2424,0.52,0.1642,4,57,61,61,True
10321,2012-03-11,1,1,3,3,0,0,0,1,0.24,0.2424,0.6,0.1343,15,51,66,66,True
10322,2012-03-11,1,1,3,4,0,0,0,1,0.24,0.2424,0.6,0.1343,7,15,22,22,True
10323,2012-03-11,1,1,3,5,0,0,0,1,0.24,0.2424,0.6,0.1642,2,5,7,7,True
10324,2012-03-11,1,1,3,6,0,0,0,1,0.24,0.2424,0.7,0.1642,2,8,10,10,True
10325,2012-03-11,1,1,3,7,0,0,0,1,0.22,0.2273,0.69,0.1343,2,15,17,17,True
10326,2012-03-11,1,1,3,8,0,0,0,1,0.22,0.2273,0.69,0.1343,4,68,72,72,True
10327,2012-03-11,1,1,3,9,0,0,0,1,0.26,0.2576,0.6,0.2239,20,70,90,90,True
10328,2012-03-11,1,1,3,10,0,0,0,1,0.32,0.303,0.49,0.2836,71,147,218,218,True
10329,2012-03-11,1,1,3,11,0,0,0,1,0.36,0.3333,0.43,0.2836,90,209,299,299,True
10330,2012-03-11,1,1,3,12,0,0,0,1,0.4,0.4091,0.37,0.2985,114,264,378,378,True
10331,2012-03-11,1,1,3,13,0,0,0,1,0.42,0.4242,0.41,0.2985,114,288,402,402,True
10332,2012-03-11,1,1,3,14,0,0,0,1,0.46,0.4545,0.31,0.2836,114,289,403,403,True
10333,2012-03-11,1,1,3,15,0,0,0,1,0.5,0.4848,0.29,0.2985,114,286,400,400,True
10334,2012-03-11,1,1,3,16,0,0,0,1,0.5,0.4848,0.31,0.3582,114,301,415,415,True
10335,2012-03-11,1,1,3,17,0,0,0,1,0.52,0.5,0.27,0.2985,114,299,413,413,True
10336,2012-03-11,1,1,3,18,0,0,0,1,0.52,0.5,0.29,0.2836,114,256,370,370,True
10337,2012-03-11,1,1,3,19,0,0,0,1,0.5,0.4848,0.31,0.2836,55,203,258,258,True
10338,2012-03-11,1,1,3,20,0,0,0,1,0.44,0.4394,0.47,0.2239,42,129,171,171,True
10339,2012-03-11,1,1,3,21,0,0,0,1,0.42,0.4242,0.54,0.2239,37,110,147,147,True
10340,2012-03-11,1,1,3,22,0,0,0,1,0.4,0.4091,0.54,0.194,13,81,94,94,True
10341,2012-03-11,1,1,3,23,0,0,0,1,0.4,0.4091,0.5,0.1642,12,40,52,52,True
10342,2012-03-12,1,1,3,0,0,1,1,1,0.38,0.3939,0.54,0.194,4,20,24,24,True
10343,2012-03-12,1,1,3,1,0,1,1,1,0.38,0.3939,0.5,0.1343,1,9,10,10,True
10344,2012-03-12,1,1,3,2,0,1,1,1,0.38,0.3939,0.54,0.1045,4,5,9,9,True
10345,2012-03-12,1,1,3,3,0,1,1,1,0.36,0.3485,0.5,0.1343,0,2,2,2,True
10346,2012-03-12,1,1,3,4,0,1,1,1,0.34,0.3333,0.61,0.194,0,3,3,3,True
10347,2012-03-12,1,1,3,5,0,1,1,1,0.34,0.3333,0.61,0.194,1,15,16,16,True
10348,2012-03-12,1,1,3,6,0,1,1,1,0.34,0.3485,0.57,0.1045,2,86,88,88,True
10349,2012-03-12,1,1,3,7,0,1,1,1,0.34,0.3485,0.53,0.1045,9,259,268,268,True
10350,2012-03-12,1,1,3,8,0,1,1,1,0.34,0.3333,0.61,0.1343,17,499,516,516,True
10351,2012-03-12,1,1,3,9,0,1,1,1,0.38,0.3939,0.54,0.1642,21,260,281,281,True
10352,2012-03-12,1,1,3,10,0,1,1,1,0.4,0.4091,0.5,0.2239,39,98,137,137,True
10353,2012-03-12,1,1,3,11,0,1,1,1,0.44,0.4394,0.44,0.2239,39,111,150,150,True
10354,2012-03-12,1,1,3,12,0,1,1,1,0.48,0.4697,0.39,0.2239,59,162,221,221,True
10355,2012-03-12,1,1,3,13,0,1,1,2,0.54,0.5152,0.32,0.2537,74,176,250,250,True
10356,2012-03-12,1,1,3,14,0,1,1,2,0.58,0.5455,0.32,0.2836,76,145,221,221,True
10357,2012-03-12,1,1,3,15,0,1,1,1,0.56,0.5303,0.4,0.1343,74,159,233,233,True
10358,2012-03-12,1,1,3,16,0,1,1,1,0.62,0.6212,0.35,0.4478,77,255,332,332,True
10359,2012-03-12,1,1,3,17,0,1,1,2,0.62,0.6212,0.38,0.4179,87,499,586,586,True
10360,2012-03-12,1,1,3,18,0,1,1,2,0.6,0.6212,0.43,0.194,89,499,588,588,True
10361,2012-03-12,1,1,3,19,0,1,1,2,0.56,0.5303,0.49,0.2239,67,379,446,446,True
10362,2012-03-12,1,1,3,20,0,1,1,2,0.56,0.5303,0.49,0.2239,49,237,286,286,True
10363,2012-03-12,1,1,3,21,0,1,1,2,0.54,0.5152,0.56,0.2239,22,183,205,205,True
10364,2012-03-12,1,1,3,22,0,1,1,2,0.56,0.5303,0.56,0.2239,17,116,133,133,True
10365,2012-03-12,1,1,3,23,0,1,1,1,0.56,0.5303,0.56,0.2239,10,53,63,63,True
10366,2012-03-13,1,1,3,0,0,2,1,2,0.56,0.5303,0.52,0.194,5,21,26,26,True
10367,2012-03-13,1,1,3,1,0,2,1,2,0.52,0.5,0.59,0.2239,2,14,16,16,True
10368,2012-03-13,1,1,3,2,0,2,1,3,0.52,0.5,0.72,0.2985,0,1,1,1,True
10369,2012-03-13,1,1,3,3,0,2,1,3,0.52,0.5,0.72,0.2985,0,2,2,2,True
10370,2012-03-13,1,1,3,4,0,2,1,2,0.46,0.4545,0.82,0.194,0,1,1,1,True
10371,2012-03-13,1,1,3,5,0,2,1,2,0.46,0.4545,0.82,0.194,0,24,24,24,True
10372,2012-03-13,1,1,3,6,0,2,1,3,0.46,0.4545,0.82,0.194,5,108,113,113,True
10373,2012-03-13,1,1,3,7,0,2,1,2,0.46,0.4545,0.82,0.2836,16,292,308,308,True
10374,2012-03-13,1,1,3,8,0,2,1,1,0.46,0.4545,0.82,0.2836,22,499,521,521,True
10375,2012-03-13,1,1,3,9,0,2,1,1,0.48,0.4697,0.82,0.2836,18,324,342,342,True
10376,2012-03-13,1,1,3,10,0,2,1,1,0.52,0.5,0.77,0.2239,28,115,143,143,True
10377,2012-03-13,1,1,3,11,0,2,1,1,0.54,0.5152,0.73,0.2836,64,155,219,219,True
10378,2012-03-13,1,1,3,12,0,2,1,1,0.6,0.6061,0.6,0.2836,47,197,244,244,True
10379,2012-03-13,1,1,3,13,0,2,1,1,0.6,0.6061,0.6,0.3881,53,180,233,233,True
10380,2012-03-13,1,1,3,14,0,2,1,1,0.64,0.6212,0.53,0.3284,52,160,212,212,True
10381,2012-03-13,1,1,3,15,0,2,1,1,0.7,0.6364,0.39,0.2239,68,196,264,264,True
10382,2012-03-13,1,1,3,16,0,2,1,1,0.72,0.6515,0.34,0.3881,53,312,365,365,True
10383,2012-03-13,1,1,3,17,0,2,1,1,0.7,0.6364,0.37,0.1045,62,499,561,561,True
10384,2012-03-13,1,1,3,18,0,2,1,1,0.7,0.6364,0.34,0.2985,96,499,595,595,True
10385,2012-03-13,1,1,3,19,0,2,1,1,0.64,0.6212,0.47,0.2239,50,429,479,479,True
10386,2012-03-13,1,1,3,20,0,2,1,1,0.6,0.6212,0.49,0.1642,45,306,351,351,True
10387,2012-03-13,1,1,3,21,0,2,1,1,0.58,0.5455,0.56,0.1045,44,200,244,244,True
10388,2012-03-13,1,1,3,22,0,2,1,1,0.56,0.5303,0.6,0.0896,24,146,170,170,True
10389,2012-03-13,1,1,3,23,0,2,1,1,0.56,0.5303,0.56,0.1343,8,79,87,87,True
10390,2012-03-14,1,1,3,0,0,3,1,1,0.54,0.5152,0.6,0.1045,5,34,39,39,True
10391,2012-03-14,1,1,3,1,0,3,1,1,0.52,0.5,0.63,0.0896,2,25,27,27,True
10392,2012-03-14,1,1,3,2,0,3,1,1,0.5,0.4848,0.68,0.194,0,2,2,2,True
10393,2012-03-14,1,1,3,3,0,3,1,1,0.48,0.4697,0.72,0.194,1,3,4,4,True
10394,2012-03-14,1,1,3,4,0,3,1,1,0.48,0.4697,0.67,0.0896,1,4,5,5,True
10395,2012-03-14,1,1,3,5,0,3,1,1,0.44,0.4394,0.82,0.1343,2,25,27,27,True
10396,2012-03-14,1,1,3,6,0,3,1,1,0.44,0.4394,0.82,0.0896,1,120,121,121,True
10397,2012-03-14,1,1,3,7,0,3,1,1,0.44,0.4394,0.82,0.1045,20,348,368,368,True
10398,2012-03-14,1,1,3,8,0,3,1,1,0.44,0.4394,0.82,0.0,34,499,533,533,True
10399,2012-03-14,1,1,3,9,0,3,1,1,0.52,0.5,0.68,0.0,26,325,351,351,True
10400,2012-03-14,1,1,3,10,0,3,1,1,0.56,0.5303,0.56,0.1045,38,150,188,188,True
10401,2012-03-14,1,1,3,11,0,3,1,2,0.62,0.6212,0.41,0.1642,65,155,220,220,True
10402,2012-03-14,1,1,3,12,0,3,1,2,0.64,0.6212,0.29,0.0,55,212,267,267,True
10403,2012-03-14,1,1,3,13,0,3,1,1,0.66,0.6212,0.27,0.2239,57,197,254,254,True
10404,2012-03-14,1,1,3,14,0,3,1,1,0.7,0.6364,0.23,0.3284,61,163,224,224,True
10405,2012-03-14,1,1,3,15,0,3,1,1,0.7,0.6364,0.24,0.0,86,197,283,283,True
10406,2012-03-14,1,1,3,16,0,3,1,1,0.72,0.6364,0.25,0.194,78,278,356,356,True
10407,2012-03-14,1,1,3,17,0,3,1,1,0.7,0.6364,0.28,0.0896,114,499,613,613,True
10408,2012-03-14,1,1,3,18,0,3,1,1,0.7,0.6364,0.32,0.0,102,499,601,601,True
10409,2012-03-14,1,1,3,19,0,3,1,1,0.64,0.6212,0.33,0.1642,70,402,472,472,True
10410,2012-03-14,1,1,3,20,0,3,1,1,0.62,0.6212,0.35,0.1045,44,286,330,330,True
10411,2012-03-14,1,1,3,21,0,3,1,1,0.6,0.6212,0.4,0.0896,47,241,288,288,True
10412,2012-03-14,1,1,3,22,0,3,1,1,0.52,0.5,0.55,0.1343,43,159,202,202,True
10413,2012-03-14,1,1,3,23,0,3,1,1,0.56,0.5303,0.43,0.1642,19,72,91,91,True
10414,2012-03-15,1,1,3,0,0,4,1,1,0.54,0.5152,0.49,0.1343,14,46,60,60,True
10415,2012-03-15,1,1,3,1,0,4,1,1,0.5,0.4848,0.59,0.1045,15,8,23,23,True
10416,2012-03-15,1,1,3,2,0,4,1,1,0.5,0.4848,0.59,0.0,14,5,19,19,True
10417,2012-03-15,1,1,3,3,0,4,1,1,0.5,0.4848,0.63,0.0,0,7,7,7,True
10418,2012-03-15,1,1,3,4,0,4,1,1,0.44,0.4394,0.77,0.1045,11,3,14,14,True
10419,2012-03-15,1,1,3,5,0,4,1,1,0.46,0.4545,0.67,0.0,2,24,26,26,True
10420,2012-03-15,1,1,3,6,0,4,1,1,0.44,0.4394,0.72,0.0896,4,113,117,117,True
10421,2012-03-15,1,1,3,7,0,4,1,1,0.44,0.4394,0.72,0.0896,14,367,381,381,True
10422,2012-03-15,1,1,3,8,0,4,1,1,0.44,0.4394,0.77,0.1045,21,499,520,520,True
10423,2012-03-15,1,1,3,9,0,4,1,1,0.48,0.4697,0.77,0.0896,30,285,315,315,True
10424,2012-03-15,1,1,3,10,0,4,1,1,0.52,0.5,0.68,0.1045,34,130,164,164,True
10425,2012-03-15,1,1,3,11,0,4,1,1,0.56,0.5303,0.6,0.1343,60,151,211,211,True
10426,2012-03-15,1,1,3,12,0,4,1,2,0.62,0.6212,0.5,0.1343,59,206,265,265,True
10427,2012-03-15,1,1,3,13,0,4,1,2,0.66,0.6212,0.41,0.0896,62,211,273,273,True
10428,2012-03-15,1,1,3,14,0,4,1,2,0.72,0.6515,0.3,0.1045,81,177,258,258,True
10429,2012-03-15,1,1,3,15,0,4,1,1,0.72,0.6515,0.32,0.2239,100,187,287,287,True
10430,2012-03-15,1,1,3,16,0,4,1,1,0.72,0.6515,0.37,0.3881,95,331,426,426,True
10431,2012-03-15,1,1,3,17,0,4,1,1,0.7,0.6364,0.39,0.2537,79,499,578,578,True
10432,2012-03-15,1,1,3,18,0,4,1,1,0.66,0.6212,0.44,0.2836,98,499,597,597,True
10433,2012-03-15,1,1,3,19,0,4,1,2,0.64,0.6212,0.5,0.194,72,353,425,425,True
10434,2012-03-15,1,1,3,20,0,4,1,2,0.58,0.5455,0.6,0.3582,60,270,330,330,True
10435,2012-03-15,1,1,3,21,0,4,1,1,0.54,0.5152,0.68,0.2836,36,207,243,243,True
10436,2012-03-15,1,1,3,22,0,4,1,1,0.52,0.5,0.68,0.1343,32,137,169,169,True
10437,2012-03-15,1,1,3,23,0,4,1,1,0.48,0.4697,0.72,0.194,12,85,97,97,True
10438,2012-03-16,1,1,3,0,0,5,1,1,0.44,0.4394,0.77,0.2537,8,49,57,57,True
10439,2012-03-16,1,1,3,1,0,5,1,2,0.42,0.4242,0.82,0.3284,4,22,26,26,True
10440,2012-03-16,1,1,3,2,0,5,1,2,0.42,0.4242,0.82,0.194,0,4,4,4,True
10441,2012-03-16,1,1,3,3,0,5,1,2,0.4,0.4091,0.87,0.2836,0,3,3,3,True
10442,2012-03-16,1,1,3,4,0,5,1,2,0.4,0.4091,0.87,0.2537,0,3,3,3,True
10443,2012-03-16,1,1,3,5,0,5,1,2,0.4,0.4091,0.87,0.2239,2,30,32,32,True
10444,2012-03-16,1,1,3,6,0,5,1,2,0.4,0.4091,0.87,0.1642,3,96,99,99,True
10445,2012-03-16,1,1,3,7,0,5,1,2,0.4,0.4091,0.87,0.194,13,265,278,278,True
10446,2012-03-16,1,1,3,8,0,5,1,2,0.4,0.4091,0.87,0.2239,28,499,527,527,True
10447,2012-03-16,1,1,3,9,0,5,1,2,0.42,0.4242,0.82,0.0,35,277,312,312,True
10448,2012-03-16,1,1,3,10,0,5,1,2,0.4,0.4091,0.87,0.0896,44,136,180,180,True
10449,2012-03-16,1,1,3,11,0,5,1,2,0.44,0.4394,0.77,0.0,40,167,207,207,True
10450,2012-03-16,1,1,3,12,0,5,1,2,0.44,0.4394,0.82,0.1343,72,222,294,294,True
10451,2012-03-16,1,1,3,13,0,5,1,2,0.46,0.4545,0.77,0.0896,52,208,260,260,True
10452,2012-03-16,1,1,3,14,0,5,1,2,0.48,0.4697,0.72,0.0,56,146,202,202,True
10453,2012-03-16,1,1,3,15,0,5,1,3,0.46,0.4545,0.82,0.1045,19,88,107,107,True
10454,2012-03-16,1,1,3,16,0,5,1,3,0.48,0.4697,0.77,0.0,18,111,129,129,True
10455,2012-03-16,1,1,3,17,0,5,1,3,0.48,0.4697,0.82,0.0896,23,235,258,258,True
10456,2012-03-16,1,1,3,18,0,5,1,3,0.48,0.4697,0.82,0.0896,31,377,408,408,True
10457,2012-03-16,1,1,3,19,0,5,1,2,0.46,0.4545,0.88,0.0,23,273,296,296,True
10458,2012-03-16,1,1,3,20,0,5,1,1,0.46,0.4545,0.88,0.0,31,204,235,235,True
10459,2012-03-16,1,1,3,21,0,5,1,2,0.44,0.4394,0.94,0.0,8,144,152,152,True
10460,2012-03-16,1,1,3,22,0,5,1,2,0.44,0.4394,0.94,0.0,16,132,148,148,True
10461,2012-03-16,1,1,3,23,0,5,1,2,0.44,0.4394,0.94,0.0,22,104,126,126,True
10462,2012-03-17,1,1,3,0,0,6,0,2,0.44,0.4394,0.94,0.0896,13,87,100,100,True
10463,2012-03-17,1,1,3,1,0,6,0,2,0.44,0.4394,0.94,0.0,12,57,69,69,True
10464,2012-03-17,1,1,3,2,0,6,0,2,0.44,0.4394,0.88,0.0,10,32,42,42,True
10465,2012-03-17,1,1,3,3,0,6,0,2,0.44,0.4394,0.88,0.0,2,24,26,26,True
10466,2012-03-17,1,1,3,4,0,6,0,2,0.42,0.4242,0.94,0.0,0,2,2,2,True
10467,2012-03-17,1,1,3,5,0,6,0,2,0.42,0.4242,0.94,0.0896,5,3,8,8,True
10468,2012-03-17,1,1,3,6,0,6,0,2,0.42,0.4242,0.94,0.194,1,29,30,30,True
10469,2012-03-17,1,1,3,7,0,6,0,2,0.4,0.4091,1.0,0.1343,29,57,86,86,True
10470,2012-03-17,1,1,3,8,0,6,0,2,0.42,0.4242,0.94,0.1045,63,155,218,218,True
10471,2012-03-17,1,1,3,9,0,6,0,2,0.44,0.4394,0.88,0.0896,104,217,321,321,True
10472,2012-03-17,1,1,3,10,0,6,0,2,0.5,0.4848,0.77,0.0896,114,303,417,417,True
10473,2012-03-17,1,1,3,11,0,6,0,2,0.52,0.5,0.77,0.1343,114,359,473,473,True
10474,2012-03-17,1,1,3,12,0,6,0,1,0.56,0.5303,0.68,0.1642,114,365,479,479,True
10475,2012-03-17,1,1,3,13,0,6,0,1,0.6,0.6061,0.6,0.1045,114,400,514,514,True
10476,2012-03-17,1,1,3,14,0,6,0,1,0.62,0.6212,0.53,0.0896,114,338,452,452,True
10477,2012-03-17,1,1,3,15,0,6,0,1,0.64,0.6212,0.53,0.1343,114,322,436,436,True
10478,2012-03-17,1,1,3,16,0,6,0,1,0.64,0.6212,0.5,0.0,114,318,432,432,True
10479,2012-03-17,1,1,3,17,0,6,0,1,0.64,0.6212,0.5,0.1343,114,357,471,471,True
10480,2012-03-17,1,1,3,18,0,6,0,1,0.62,0.6212,0.57,0.2985,114,339,453,453,True
10481,2012-03-17,1,1,3,19,0,6,0,1,0.58,0.5455,0.64,0.2836,114,262,376,376,True
10482,2012-03-17,1,1,3,20,0,6,0,1,0.56,0.5303,0.64,0.194,89,182,271,271,True
10483,2012-03-17,1,1,3,21,0,6,0,1,0.54,0.5152,0.68,0.1642,54,169,223,223,True
10484,2012-03-17,1,1,3,22,0,6,0,1,0.54,0.5152,0.68,0.0,58,153,211,211,True
10485,2012-03-17,1,1,3,23,0,6,0,1,0.5,0.4848,0.77,0.1642,34,151,185,185,True
10486,2012-03-18,1,1,3,0,0,0,0,1,0.46,0.4545,0.88,0.194,27,80,107,107,True
10487,2012-03-18,1,1,3,1,0,0,0,1,0.46,0.4545,0.82,0.1343,25,88,113,113,True
10488,2012-03-18,1,1,3,2,0,0,0,2,0.46,0.4545,0.82,0.1045,15,41,56,56,True
10489,2012-03-18,1,1,3,3,0,0,0,2,0.44,0.4394,0.88,0.1343,3,15,18,18,True
10490,2012-03-18,1,1,3,4,0,0,0,2,0.42,0.4242,0.94,0.1642,6,8,14,14,True
10491,2012-03-18,1,1,3,5,0,0,0,2,0.4,0.4091,0.94,0.1045,0,6,6,6,True
10492,2012-03-18,1,1,3,6,0,0,0,2,0.4,0.4091,0.94,0.1045,2,9,11,11,True
10493,2012-03-18,1,1,3,7,0,0,0,3,0.42,0.4242,0.88,0.1642,17,25,42,42,True
10494,2012-03-18,1,1,3,8,0,0,0,2,0.42,0.4242,0.88,0.1045,25,71,96,96,True
10495,2012-03-18,1,1,3,9,0,0,0,2,0.42,0.4242,0.88,0.0896,65,113,178,178,True
10496,2012-03-18,1,1,3,10,0,0,0,2,0.42,0.4242,0.88,0.1045,114,212,326,326,True
10497,2012-03-18,1,1,3,11,0,0,0,2,0.44,0.4394,0.82,0.1642,114,239,353,353,True
10498,2012-03-18,1,1,3,12,0,0,0,2,0.44,0.4394,0.88,0.1343,114,281,395,395,True
10499,2012-03-18,1,1,3,13,0,0,0,2,0.46,0.4545,0.82,0.1642,114,346,460,460,True
10500,2012-03-18,1,1,3,14,0,0,0,2,0.5,0.4848,0.77,0.0896,114,303,417,417,True
10501,2012-03-18,1,1,3,15,0,0,0,1,0.54,0.5152,0.68,0.0896,114,314,428,428,True
10502,2012-03-18,1,1,3,16,0,0,0,1,0.54,0.5152,0.73,0.0896,114,312,426,426,True
10503,2012-03-18,1,1,3,17,0,0,0,1,0.56,0.5303,0.64,0.0896,114,308,422,422,True
10504,2012-03-18,1,1,3,18,0,0,0,1,0.56,0.5303,0.64,0.1642,114,294,408,408,True
10505,2012-03-18,1,1,3,19,0,0,0,1,0.56,0.5303,0.64,0.1642,114,234,348,348,True
10506,2012-03-18,1,1,3,20,0,0,0,1,0.52,0.5,0.77,0.1343,59,139,198,198,True
10507,2012-03-18,1,1,3,21,0,0,0,1,0.52,0.5,0.72,0.0896,44,129,173,173,True
10508,2012-03-18,1,1,3,22,0,0,0,1,0.5,0.4848,0.77,0.1045,21,79,100,100,True
10509,2012-03-18,1,1,3,23,0,0,0,1,0.48,0.4697,0.82,0.1642,7,39,46,46,True
10510,2012-03-19,1,1,3,0,0,1,1,1,0.48,0.4697,0.82,0.1045,4,19,23,23,True
10511,2012-03-19,1,1,3,1,0,1,1,1,0.46,0.4545,0.88,0.1045,0,15,15,15,True
10512,2012-03-19,1,1,3,2,0,1,1,1,0.46,0.4545,0.88,0.1642,1,7,8,8,True
10513,2012-03-19,1,1,3,3,0,1,1,1,0.46,0.4545,0.88,0.0896,0,2,2,2,True
10514,2012-03-19,1,1,3,4,0,1,1,1,0.44,0.4394,0.94,0.0,0,3,3,3,True
10515,2012-03-19,1,1,3,5,0,1,1,1,0.44,0.4394,0.94,0.0,0,31,31,31,True
10516,2012-03-19,1,1,3,6,0,1,1,1,0.46,0.4545,0.88,0.1343,2,118,120,120,True
10517,2012-03-19,1,1,3,7,0,1,1,1,0.46,0.4545,0.88,0.194,25,329,354,354,True
10518,2012-03-19,1,1,3,8,0,1,1,1,0.46,0.4545,0.88,0.1045,16,499,515,515,True
10519,2012-03-19,1,1,3,9,0,1,1,1,0.5,0.4848,0.72,0.1642,55,276,331,331,True
10520,2012-03-19,1,1,3,10,0,1,1,1,0.52,0.5,0.72,0.1343,56,128,184,184,True
10521,2012-03-19,1,1,3,11,0,1,1,1,0.56,0.5303,0.68,0.1642,56,145,201,201,True
10522,2012-03-19,1,1,3,12,0,1,1,1,0.6,0.6061,0.64,0.2537,71,211,282,282,True
10523,2012-03-19,1,1,3,13,0,1,1,1,0.62,0.6061,0.61,0.2537,69,194,263,263,True
10524,2012-03-19,1,1,3,14,0,1,1,2,0.64,0.6212,0.57,0.194,60,200,260,260,True
10525,2012-03-19,1,1,3,15,0,1,1,1,0.64,0.6212,0.57,0.2239,97,189,286,286,True
10526,2012-03-19,1,1,3,16,0,1,1,1,0.66,0.6212,0.5,0.2239,65,320,385,385,True
10527,2012-03-19,1,1,3,17,0,1,1,1,0.64,0.6212,0.53,0.2239,106,499,605,605,True
10528,2012-03-19,1,1,3,18,0,1,1,1,0.64,0.6212,0.57,0.2537,114,499,613,613,True
10529,2012-03-19,1,1,3,19,0,1,1,1,0.62,0.6061,0.61,0.2239,86,463,549,549,True
10530,2012-03-19,1,1,3,20,0,1,1,1,0.6,0.6061,0.64,0.2239,34,296,330,330,True
10531,2012-03-19,1,1,3,21,0,1,1,1,0.6,0.6061,0.64,0.1642,33,190,223,223,True
10532,2012-03-19,1,1,3,22,0,1,1,2,0.56,0.5303,0.73,0.1642,17,131,148,148,True
10533,2012-03-19,1,1,3,23,0,1,1,2,0.56,0.5303,0.78,0.1343,9,45,54,54,True
10534,2012-03-20,1,1,3,0,0,2,1,2,0.56,0.5303,0.78,0.0896,5,24,29,29,True
10535,2012-03-20,1,1,3,1,0,2,1,1,0.54,0.5152,0.88,0.0,6,9,15,15,True
10536,2012-03-20,1,1,3,2,0,2,1,1,0.54,0.5152,0.88,0.0896,2,8,10,10,True
10537,2012-03-20,1,1,3,3,0,2,1,2,0.54,0.5152,0.88,0.0,0,3,3,3,True
10538,2012-03-20,1,1,3,4,0,2,1,2,0.52,0.5,0.88,0.1343,0,6,6,6,True
10539,2012-03-20,1,1,3,5,0,2,1,2,0.52,0.5,0.94,0.0,0,20,20,20,True
10540,2012-03-20,1,1,3,6,0,2,1,2,0.52,0.5,0.94,0.1642,6,94,100,100,True
10541,2012-03-20,1,1,3,7,0,2,1,3,0.52,0.5,0.94,0.2239,3,167,170,170,True
10542,2012-03-20,1,1,3,8,0,2,1,2,0.52,0.5,0.88,0.1045,28,488,516,516,True
10543,2012-03-20,1,1,3,9,0,2,1,2,0.54,0.5152,0.88,0.1642,41,284,325,325,True
10544,2012-03-20,1,1,3,10,0,2,1,1,0.54,0.5152,0.88,0.194,44,119,163,163,True
10545,2012-03-20,1,1,3,11,0,2,1,1,0.58,0.5455,0.83,0.1343,74,156,230,230,True
10546,2012-03-20,1,1,3,12,0,2,1,1,0.6,0.5758,0.78,0.2537,56,205,261,261,True
10547,2012-03-20,1,1,3,13,0,2,1,1,0.6,0.5758,0.78,0.194,77,207,284,284,True
10548,2012-03-20,1,1,3,14,0,2,1,2,0.6,0.5909,0.73,0.1642,66,182,248,248,True
10549,2012-03-20,1,1,3,15,0,2,1,2,0.62,0.6061,0.69,0.1045,67,177,244,244,True
10550,2012-03-20,1,1,3,16,0,2,1,1,0.62,0.6061,0.66,0.2239,99,332,431,431,True
10551,2012-03-20,1,1,3,17,0,2,1,1,0.6,0.5909,0.73,0.194,108,499,607,607,True
10552,2012-03-20,1,1,3,18,0,2,1,1,0.6,0.5909,0.69,0.2537,114,499,613,613,True
10553,2012-03-20,1,1,3,19,0,2,1,1,0.58,0.5455,0.73,0.1343,75,480,555,555,True
10554,2012-03-20,1,1,3,20,0,2,1,1,0.58,0.5455,0.68,0.0896,78,299,377,377,True
10555,2012-03-20,1,1,3,21,0,2,1,1,0.56,0.5303,0.73,0.0,38,239,277,277,True
10556,2012-03-20,1,1,3,22,0,2,1,1,0.54,0.5152,0.77,0.0,32,156,188,188,True
10557,2012-03-20,1,1,3,23,0,2,1,1,0.52,0.5,0.83,0.0,10,80,90,90,True
10558,2012-03-21,2,1,3,0,0,3,1,1,0.52,0.5,0.88,0.0,4,29,33,33,True
10559,2012-03-21,2,1,3,1,0,3,1,1,0.52,0.5,0.83,0.0896,4,22,26,26,True
10560,2012-03-21,2,1,3,2,0,3,1,1,0.5,0.4848,0.88,0.1343,2,8,10,10,True
10561,2012-03-21,2,1,3,3,0,3,1,2,0.5,0.4848,0.88,0.194,1,7,8,8,True
10562,2012-03-21,2,1,3,4,0,3,1,2,0.5,0.4848,0.88,0.1343,0,4,4,4,True
10563,2012-03-21,2,1,3,5,0,3,1,2,0.5,0.4848,0.88,0.1343,4,35,39,39,True
10564,2012-03-21,2,1,3,6,0,3,1,2,0.48,0.4697,0.94,0.2239,10,139,149,149,True
10565,2012-03-21,2,1,3,7,0,3,1,3,0.48,0.4697,0.94,0.194,34,338,372,372,True
10566,2012-03-21,2,1,3,8,0,3,1,3,0.48,0.4697,0.94,0.1045,33,499,532,532,True
10567,2012-03-21,2,1,3,9,0,3,1,2,0.5,0.4848,0.88,0.1642,38,255,293,293,True
10568,2012-03-21,2,1,3,10,0,3,1,2,0.52,0.5,0.83,0.1642,30,124,154,154,True
10569,2012-03-21,2,1,3,11,0,3,1,2,0.52,0.5,0.83,0.1642,38,154,192,192,True
10570,2012-03-21,2,1,3,12,0,3,1,2,0.54,0.5152,0.77,0.0,58,171,229,229,True
10571,2012-03-21,2,1,3,13,0,3,1,2,0.54,0.5152,0.83,0.0,81,222,303,303,True
10572,2012-03-21,2,1,3,14,0,3,1,2,0.56,0.5303,0.78,0.0,74,151,225,225,True
10573,2012-03-21,2,1,3,15,0,3,1,2,0.56,0.5303,0.78,0.0,68,175,243,243,True
10574,2012-03-21,2,1,3,16,0,3,1,1,0.58,0.5455,0.73,0.0,91,287,378,378,True
10575,2012-03-21,2,1,3,17,0,3,1,1,0.6,0.5909,0.69,0.0896,113,499,612,612,True
10576,2012-03-21,2,1,3,18,0,3,1,1,0.6,0.5909,0.69,0.0,114,499,613,613,True
10577,2012-03-21,2,1,3,19,0,3,1,1,0.6,0.6061,0.64,0.0,86,496,582,582,True
10578,2012-03-21,2,1,3,20,0,3,1,1,0.56,0.5303,0.78,0.0896,76,298,374,374,True
10579,2012-03-21,2,1,3,21,0,3,1,1,0.54,0.5152,0.83,0.1045,47,204,251,251,True
10580,2012-03-21,2,1,3,22,0,3,1,1,0.52,0.5,0.83,0.1642,41,156,197,197,True
10581,2012-03-21,2,1,3,23,0,3,1,1,0.54,0.5152,0.77,0.0,37,88,125,125,True
10582,2012-03-22,2,1,3,0,0,4,1,1,0.52,0.5,0.83,0.0896,9,32,41,41,True
10583,2012-03-22,2,1,3,1,0,4,1,1,0.52,0.5,0.83,0.0896,14,16,30,30,True
10584,2012-03-22,2,1,3,2,0,4,1,1,0.52,0.5,0.83,0.0896,1,5,6,6,True
10585,2012-03-22,2,1,3,3,0,4,1,1,0.52,0.5,0.83,0.0896,0,7,7,7,True
10586,2012-03-22,2,1,3,4,0,4,1,2,0.48,0.4697,1.0,0.0896,0,6,6,6,True
10587,2012-03-22,2,1,3,5,0,4,1,2,0.48,0.4697,1.0,0.0896,2,32,34,34,True
10588,2012-03-22,2,1,3,6,0,4,1,2,0.48,0.4697,1.0,0.0896,10,126,136,136,True
10589,2012-03-22,2,1,3,7,0,4,1,2,0.48,0.4697,1.0,0.0896,29,332,361,361,True
10590,2012-03-22,2,1,3,8,0,4,1,2,0.5,0.4848,0.94,0.0896,51,499,550,550,True
10591,2012-03-22,2,1,3,9,0,4,1,2,0.5,0.4848,0.94,0.0896,41,277,318,318,True
10592,2012-03-22,2,1,3,10,0,4,1,2,0.5,0.4848,1.0,0.0896,32,110,142,142,True
10593,2012-03-22,2,1,3,11,0,4,1,2,0.52,0.5,0.94,0.0,53,166,219,219,True
10594,2012-03-22,2,1,3,12,0,4,1,2,0.54,0.5152,0.88,0.194,48,224,272,272,True
10595,2012-03-22,2,1,3,13,0,4,1,1,0.58,0.5455,0.78,0.0896,83,215,298,298,True
10596,2012-03-22,2,1,3,14,0,4,1,1,0.6,0.5909,0.73,0.1045,96,161,257,257,True
10597,2012-03-22,2,1,3,15,0,4,1,1,0.62,0.6061,0.69,0.194,102,202,304,304,True
10598,2012-03-22,2,1,3,16,0,4,1,1,0.64,0.6061,0.65,0.194,114,300,414,414,True
10599,2012-03-22,2,1,3,17,0,4,1,1,0.66,0.6212,0.65,0.1642,114,499,613,613,True
10600,2012-03-22,2,1,3,18,0,4,1,1,0.66,0.6212,0.65,0.1642,114,499,613,613,True
10601,2012-03-22,2,1,3,19,0,4,1,1,0.66,0.6212,0.61,0.0,114,469,583,583,True
10602,2012-03-22,2,1,3,20,0,4,1,1,0.62,0.5909,0.73,0.2836,64,360,424,424,True
10603,2012-03-22,2,1,3,21,0,4,1,1,0.58,0.5455,0.78,0.1642,66,308,374,374,True
10604,2012-03-22,2,1,3,22,0,4,1,1,0.56,0.5303,0.83,0.194,56,164,220,220,True
10605,2012-03-22,2,1,3,23,0,4,1,1,0.56,0.5303,0.83,0.0896,34,117,151,151,True
10606,2012-03-23,2,1,3,0,0,5,1,1,0.56,0.5303,0.83,0.0,30,65,95,95,True
10607,2012-03-23,2,1,3,1,0,5,1,1,0.54,0.5152,0.88,0.0,18,32,50,50,True
10608,2012-03-23,2,1,3,2,0,5,1,1,0.54,0.5152,0.88,0.0896,12,20,32,32,True
10609,2012-03-23,2,1,3,3,0,5,1,1,0.52,0.5,0.88,0.1045,4,6,10,10,True
10610,2012-03-23,2,1,3,4,0,5,1,2,0.5,0.4848,0.94,0.1045,0,3,3,3,True
10611,2012-03-23,2,1,3,5,0,5,1,2,0.5,0.4848,0.94,0.0,5,29,34,34,True
10612,2012-03-23,2,1,3,6,0,5,1,2,0.5,0.4848,0.88,0.0,6,110,116,116,True
10613,2012-03-23,2,1,3,7,0,5,1,2,0.5,0.4848,0.93,0.1343,28,318,346,346,True
10614,2012-03-23,2,1,3,8,0,5,1,2,0.5,0.4848,0.94,0.1343,47,499,546,546,True
10615,2012-03-23,2,1,3,9,0,5,1,2,0.52,0.5,0.9,0.0896,75,305,380,380,True
10616,2012-03-23,2,1,3,10,0,5,1,2,0.56,0.5303,0.88,0.1045,114,150,264,264,True
10617,2012-03-23,2,1,3,11,0,5,1,2,0.62,0.5909,0.73,0.1045,114,187,301,301,True
10618,2012-03-23,2,1,3,12,0,5,1,2,0.66,0.6212,0.61,0.2239,114,272,386,386,True
10619,2012-03-23,2,1,3,13,0,5,1,2,0.7,0.6515,0.48,0.0,114,256,370,370,True
10620,2012-03-23,2,1,3,14,0,5,1,2,0.72,0.6515,0.42,0.1045,114,224,338,338,True
10621,2012-03-23,2,1,3,15,0,5,1,2,0.72,0.6515,0.42,0.1343,114,281,395,395,True
10622,2012-03-23,2,1,3,16,0,5,1,2,0.72,0.6515,0.42,0.1642,114,370,484,484,True
10623,2012-03-23,2,1,3,17,0,5,1,2,0.72,0.6515,0.42,0.1642,114,499,613,613,True
10624,2012-03-23,2,1,3,18,0,5,1,1,0.7,0.6364,0.45,0.1642,114,499,613,613,True
10625,2012-03-23,2,1,3,19,0,5,1,1,0.66,0.6212,0.5,0.194,114,473,587,587,True
10626,2012-03-23,2,1,3,20,0,5,1,1,0.66,0.6212,0.47,0.1343,114,328,442,442,True
10627,2012-03-23,2,1,3,21,0,5,1,1,0.62,0.6212,0.53,0.1045,64,220,284,284,True
10628,2012-03-23,2,1,3,22,0,5,1,1,0.6,0.6061,0.64,0.2836,53,218,271,271,True
10629,2012-03-23,2,1,3,23,0,5,1,1,0.6,0.5909,0.69,0.2537,51,125,176,176,True
10630,2012-03-24,2,1,3,0,0,6,0,1,0.58,0.5455,0.68,0.0,45,111,156,156,True
10631,2012-03-24,2,1,3,1,0,6,0,1,0.56,0.5303,0.73,0.0896,20,108,128,128,True
10632,2012-03-24,2,1,3,2,0,6,0,1,0.54,0.5152,0.77,0.1045,14,55,69,69,True
10633,2012-03-24,2,1,3,3,0,6,0,1,0.54,0.5152,0.77,0.1045,10,22,32,32,True
10634,2012-03-24,2,1,3,4,0,6,0,1,0.52,0.5,0.83,0.0896,1,6,7,7,True
10635,2012-03-24,2,1,3,5,0,6,0,2,0.52,0.5,0.83,0.1642,0,4,4,4,True
10636,2012-03-24,2,1,3,6,0,6,0,2,0.52,0.5,0.83,0.1642,4,24,28,28,True
10637,2012-03-24,2,1,3,7,0,6,0,2,0.5,0.4848,0.88,0.1343,25,45,70,70,True
10638,2012-03-24,2,1,3,8,0,6,0,2,0.5,0.4848,0.94,0.194,41,113,154,154,True
10639,2012-03-24,2,1,3,9,0,6,0,2,0.52,0.5,0.83,0.1343,96,153,249,249,True
10640,2012-03-24,2,1,3,10,0,6,0,2,0.52,0.5,0.88,0.194,114,197,311,311,True
10641,2012-03-24,2,1,3,11,0,6,0,2,0.5,0.4848,0.94,0.194,98,175,273,273,True
10642,2012-03-24,2,1,3,12,0,6,0,3,0.52,0.5,0.94,0.2239,61,122,183,183,True
10643,2012-03-24,2,1,3,13,0,6,0,3,0.52,0.5,0.94,0.2537,62,134,196,196,True
10644,2012-03-24,2,1,3,14,0,6,0,3,0.52,0.5,0.88,0.3582,63,160,223,223,True
10645,2012-03-24,2,1,3,15,0,6,0,3,0.5,0.4848,0.94,0.4179,114,172,286,286,True
10646,2012-03-24,2,1,3,16,0,6,0,3,0.5,0.4848,0.94,0.2985,49,128,177,177,True
10647,2012-03-24,2,1,3,17,0,6,0,3,0.5,0.4848,0.88,0.2239,47,68,115,115,True
10648,2012-03-24,2,1,3,18,0,6,0,3,0.46,0.4545,0.94,0.2239,27,110,137,137,True
10649,2012-03-24,2,1,3,19,0,6,0,3,0.46,0.4545,0.94,0.1343,28,105,133,133,True
10650,2012-03-24,2,1,3,20,0,6,0,3,0.44,0.4394,1.0,0.194,31,80,111,111,True
10651,2012-03-24,2,1,3,21,0,6,0,3,0.44,0.4394,1.0,0.194,16,88,104,104,True
10652,2012-03-24,2,1,3,22,0,6,0,3,0.44,0.4394,1.0,0.2537,12,71,83,83,True
10653,2012-03-24,2,1,3,23,0,6,0,2,0.44,0.4394,0.94,0.2836,17,88,105,105,True
10654,2012-03-25,2,1,3,0,0,0,0,2,0.44,0.4394,0.94,0.2836,18,62,80,80,True
10655,2012-03-25,2,1,3,1,0,0,0,2,0.42,0.4242,1.0,0.2537,24,65,89,89,True
10656,2012-03-25,2,1,3,2,0,0,0,3,0.42,0.4242,1.0,0.2985,6,29,35,35,True
10657,2012-03-25,2,1,3,3,0,0,0,3,0.42,0.4242,0.94,0.2985,8,10,18,18,True
10658,2012-03-25,2,1,3,4,0,0,0,2,0.42,0.4242,0.94,0.3284,1,7,8,8,True
10659,2012-03-25,2,1,3,5,0,0,0,2,0.4,0.4091,1.0,0.2537,0,6,6,6,True
10660,2012-03-25,2,1,3,6,0,0,0,2,0.4,0.4091,1.0,0.2537,5,13,18,18,True
10661,2012-03-25,2,1,3,7,0,0,0,2,0.4,0.4091,0.94,0.3284,14,25,39,39,True
10662,2012-03-25,2,1,3,8,0,0,0,2,0.4,0.4091,0.94,0.3284,21,68,89,89,True
10663,2012-03-25,2,1,3,9,0,0,0,2,0.4,0.4091,0.94,0.2537,26,92,118,118,True
10664,2012-03-25,2,1,3,10,0,0,0,2,0.4,0.4091,0.87,0.3284,78,172,250,250,True
10665,2012-03-25,2,1,3,11,0,0,0,2,0.4,0.4091,0.94,0.2537,106,217,323,323,True
10666,2012-03-25,2,1,3,12,0,0,0,2,0.4,0.4091,0.94,0.2239,114,238,352,352,True
10667,2012-03-25,2,1,3,13,0,0,0,2,0.42,0.4242,0.88,0.1642,110,257,367,367,True
10668,2012-03-25,2,1,3,14,0,0,0,2,0.44,0.4394,0.88,0.1642,114,291,405,405,True
10669,2012-03-25,2,1,3,15,0,0,0,2,0.44,0.4394,0.88,0.194,114,282,396,396,True
10670,2012-03-25,2,1,3,16,0,0,0,1,0.48,0.4697,0.77,0.0,114,339,453,453,True
10671,2012-03-25,2,1,3,17,0,0,0,1,0.5,0.4848,0.72,0.0896,114,273,387,387,True
10672,2012-03-25,2,1,3,18,0,0,0,1,0.5,0.4848,0.72,0.0896,114,289,403,403,True
10673,2012-03-25,2,1,3,19,0,0,0,1,0.5,0.4848,0.72,0.2537,114,261,375,375,True
10674,2012-03-25,2,1,3,20,0,0,0,1,0.48,0.4697,0.77,0.2239,63,196,259,259,True
10675,2012-03-25,2,1,3,21,0,0,0,1,0.48,0.4697,0.77,0.1642,25,124,149,149,True
10676,2012-03-25,2,1,3,22,0,0,0,1,0.46,0.4545,0.82,0.1343,19,92,111,111,True
10677,2012-03-25,2,1,3,23,0,0,0,1,0.48,0.4697,0.82,0.1343,9,56,65,65,True
10678,2012-03-26,2,1,3,0,0,1,1,2,0.48,0.4697,0.82,0.1642,10,23,33,33,True
10679,2012-03-26,2,1,3,1,0,1,1,1,0.48,0.4697,0.82,0.2537,18,10,28,28,True
10680,2012-03-26,2,1,3,2,0,1,1,1,0.46,0.4545,0.88,0.2239,14,6,20,20,True
10681,2012-03-26,2,1,3,3,0,1,1,1,0.46,0.4545,0.82,0.194,0,1,1,1,True
10682,2012-03-26,2,1,3,4,0,1,1,1,0.44,0.4394,0.82,0.1642,0,4,4,4,True
10683,2012-03-26,2,1,3,5,0,1,1,1,0.44,0.4394,0.77,0.1642,0,36,36,36,True
10684,2012-03-26,2,1,3,6,0,1,1,1,0.42,0.4242,0.82,0.194,7,110,117,117,True
10685,2012-03-26,2,1,3,7,0,1,1,1,0.44,0.4394,0.72,0.194,15,355,370,370,True
10686,2012-03-26,2,1,3,8,0,1,1,1,0.44,0.4394,0.62,0.2239,32,499,531,531,True
10687,2012-03-26,2,1,3,9,0,1,1,1,0.46,0.4545,0.47,0.2836,37,245,282,282,True
10688,2012-03-26,2,1,3,10,0,1,1,1,0.5,0.4848,0.36,0.4775,55,98,153,153,True
10689,2012-03-26,2,1,3,11,0,1,1,1,0.48,0.4697,0.31,0.4775,47,131,178,178,True
10690,2012-03-26,2,1,3,12,0,1,1,1,0.48,0.4697,0.33,0.4775,63,216,279,279,True
10691,2012-03-26,2,1,3,13,0,1,1,1,0.48,0.4697,0.29,0.4775,79,222,301,301,True
10692,2012-03-26,2,1,3,14,0,1,1,1,0.48,0.4697,0.33,0.4478,58,159,217,217,True
10693,2012-03-26,2,1,3,15,0,1,1,1,0.48,0.4697,0.29,0.4775,66,157,223,223,True
10694,2012-03-26,2,1,3,16,0,1,1,1,0.48,0.4697,0.25,0.4775,60,245,305,305,True
10695,2012-03-26,2,1,3,17,0,1,1,1,0.46,0.4545,0.24,0.4478,65,499,564,564,True
10696,2012-03-26,2,1,3,18,0,1,1,1,0.44,0.4394,0.26,0.4478,90,499,589,589,True
10697,2012-03-26,2,1,3,19,0,1,1,1,0.42,0.4242,0.24,0.3582,41,417,458,458,True
10698,2012-03-26,2,1,3,20,0,1,1,1,0.4,0.4091,0.26,0.4775,12,209,221,221,True
10699,2012-03-26,2,1,3,21,0,1,1,1,0.38,0.3939,0.25,0.4775,11,175,186,186,True
10700,2012-03-26,2,1,3,22,0,1,1,1,0.36,0.3333,0.25,0.3582,13,80,93,93,True
10701,2012-03-26,2,1,3,23,0,1,1,1,0.34,0.2879,0.25,0.4775,2,46,48,48,True
10702,2012-03-27,2,1,3,0,0,2,1,1,0.32,0.2879,0.26,0.4775,1,9,10,10,True
10703,2012-03-27,2,1,3,1,0,2,1,1,0.3,0.2727,0.26,0.4627,1,4,5,5,True
10704,2012-03-27,2,1,3,2,0,2,1,1,0.26,0.2273,0.3,0.2985,1,6,7,7,True
10705,2012-03-27,2,1,3,3,0,2,1,1,0.26,0.2273,0.3,0.3284,0,4,4,4,True
10706,2012-03-27,2,1,3,4,0,2,1,1,0.24,0.2121,0.32,0.3582,0,3,3,3,True
10707,2012-03-27,2,1,3,5,0,2,1,1,0.22,0.2121,0.37,0.2836,1,16,17,17,True
10708,2012-03-27,2,1,3,6,0,2,1,1,0.22,0.2273,0.37,0.194,5,96,101,101,True
10709,2012-03-27,2,1,3,7,0,2,1,1,0.22,0.2273,0.37,0.194,9,277,286,286,True
10710,2012-03-27,2,1,3,8,0,2,1,1,0.22,0.2121,0.37,0.2985,14,499,513,513,True
10711,2012-03-27,2,1,3,9,0,2,1,1,0.24,0.2273,0.38,0.194,8,259,267,267,True
10712,2012-03-27,2,1,3,10,0,2,1,1,0.26,0.2576,0.35,0.2239,20,118,138,138,True
10713,2012-03-27,2,1,3,11,0,2,1,1,0.3,0.303,0.31,0.1642,34,141,175,175,True
10714,2012-03-27,2,1,3,12,0,2,1,1,0.32,0.3182,0.31,0.1642,34,186,220,220,True
10715,2012-03-27,2,1,3,13,0,2,1,1,0.36,0.3485,0.27,0.0,46,165,211,211,True
10716,2012-03-27,2,1,3,14,0,2,1,1,0.4,0.4091,0.24,0.1343,37,147,184,184,True
10717,2012-03-27,2,1,3,15,0,2,1,1,0.42,0.4242,0.2,0.0,42,158,200,200,True
10718,2012-03-27,2,1,3,16,0,2,1,1,0.42,0.4242,0.2,0.0,38,267,305,305,True
10719,2012-03-27,2,1,3,17,0,2,1,1,0.44,0.4394,0.16,0.0,72,499,571,571,True
10720,2012-03-27,2,1,3,18,0,2,1,1,0.42,0.4242,0.17,0.0896,67,499,566,566,True
10721,2012-03-27,2,1,3,19,0,2,1,1,0.42,0.4242,0.17,0.0,40,377,417,417,True
10722,2012-03-27,2,1,3,20,0,2,1,1,0.42,0.4242,0.17,0.0896,28,266,294,294,True
10723,2012-03-27,2,1,3,21,0,2,1,1,0.36,0.3485,0.37,0.1642,21,200,221,221,True
10724,2012-03-27,2,1,3,22,0,2,1,1,0.36,0.3485,0.37,0.1343,7,127,134,134,True
10725,2012-03-27,2,1,3,23,0,2,1,1,0.36,0.3485,0.37,0.194,5,59,64,64,True
10726,2012-03-28,2,1,3,0,0,3,1,1,0.36,0.3333,0.4,0.2836,1,29,30,30,True
10727,2012-03-28,2,1,3,1,0,3,1,1,0.36,0.3333,0.46,0.2985,0,8,8,8,True
10728,2012-03-28,2,1,3,2,0,3,1,1,0.34,0.303,0.49,0.2985,0,3,3,3,True
10729,2012-03-28,2,1,3,3,0,3,1,1,0.34,0.303,0.42,0.3284,1,4,5,5,True
10730,2012-03-28,2,1,3,4,0,3,1,1,0.36,0.3333,0.43,0.2985,1,0,1,1,True
10731,2012-03-28,2,1,3,5,0,3,1,1,0.36,0.3333,0.43,0.2985,2,38,40,40,True
10732,2012-03-28,2,1,3,6,0,3,1,1,0.36,0.3333,0.46,0.3582,4,111,115,115,True
10733,2012-03-28,2,1,3,7,0,3,1,1,0.36,0.3333,0.46,0.3284,10,348,358,358,True
10734,2012-03-28,2,1,3,8,0,3,1,1,0.38,0.3939,0.46,0.3582,19,499,518,518,True
10735,2012-03-28,2,1,3,9,0,3,1,1,0.4,0.4091,0.43,0.4478,16,298,314,314,True
10736,2012-03-28,2,1,3,10,0,3,1,1,0.46,0.4545,0.41,0.4179,33,140,173,173,True
10737,2012-03-28,2,1,3,11,0,3,1,1,0.5,0.4848,0.42,0.3881,54,168,222,222,True
10738,2012-03-28,2,1,3,12,0,3,1,2,0.54,0.5152,0.39,0.3582,50,218,268,268,True
10739,2012-03-28,2,1,3,13,0,3,1,1,0.56,0.5303,0.43,0.3284,60,213,273,273,True
10740,2012-03-28,2,1,3,14,0,3,1,1,0.62,0.6212,0.38,0.3582,52,169,221,221,True
10741,2012-03-28,2,1,3,15,0,3,1,2,0.62,0.6212,0.41,0.2985,47,152,199,199,True
10742,2012-03-28,2,1,3,16,0,3,1,3,0.62,0.6212,0.43,0.0896,51,170,221,221,True
10743,2012-03-28,2,1,3,17,0,3,1,1,0.6,0.6061,0.6,0.2239,72,499,571,571,True
10744,2012-03-28,2,1,3,18,0,3,1,1,0.6,0.6061,0.6,0.2239,61,499,560,560,True
10745,2012-03-28,2,1,3,19,0,3,1,1,0.6,0.6212,0.56,0.194,41,415,456,456,True
10746,2012-03-28,2,1,3,20,0,3,1,1,0.6,0.6212,0.56,0.2985,38,324,362,362,True
10747,2012-03-28,2,1,3,21,0,3,1,1,0.58,0.5455,0.6,0.2537,28,233,261,261,True
10748,2012-03-28,2,1,3,22,0,3,1,1,0.56,0.5303,0.64,0.1343,21,151,172,172,True
10749,2012-03-28,2,1,3,23,0,3,1,1,0.54,0.5152,0.68,0.1343,12,81,93,93,True
10750,2012-03-29,2,1,3,0,0,4,1,1,0.54,0.5152,0.68,0.194,10,38,48,48,True
10751,2012-03-29,2,1,3,1,0,4,1,1,0.56,0.5303,0.6,0.1343,15,18,33,33,True
10752,2012-03-29,2,1,3,2,0,4,1,1,0.6,0.6061,0.28,0.2985,0,6,6,6,True
10753,2012-03-29,2,1,3,3,0,4,1,1,0.58,0.5455,0.28,0.2537,1,4,5,5,True
10754,2012-03-29,2,1,3,4,0,4,1,1,0.52,0.5,0.36,0.2537,1,8,9,9,True
10755,2012-03-29,2,1,3,5,0,4,1,1,0.5,0.4848,0.45,0.2239,2,30,32,32,True
10756,2012-03-29,2,1,3,6,0,4,1,1,0.46,0.4545,0.59,0.2537,3,114,117,117,True
10757,2012-03-29,2,1,3,7,0,4,1,1,0.46,0.4545,0.51,0.3582,14,353,367,367,True
10758,2012-03-29,2,1,3,8,0,4,1,1,0.46,0.4545,0.47,0.4179,26,499,525,525,True
10759,2012-03-29,2,1,3,9,0,4,1,1,0.48,0.4697,0.48,0.4179,22,299,321,321,True
10760,2012-03-29,2,1,3,10,0,4,1,1,0.46,0.4545,0.47,0.4478,42,124,166,166,True
10761,2012-03-29,2,1,3,11,0,4,1,1,0.5,0.4848,0.45,0.4179,54,166,220,220,True
10762,2012-03-29,2,1,3,12,0,4,1,1,0.5,0.4848,0.42,0.4775,64,228,292,292,True
10763,2012-03-29,2,1,3,13,0,4,1,1,0.46,0.4545,0.44,0.3284,50,223,273,273,True
10764,2012-03-29,2,1,3,14,0,4,1,1,0.5,0.4848,0.42,0.3582,63,175,238,238,True
10765,2012-03-29,2,1,3,15,0,4,1,1,0.52,0.5,0.39,0.3582,109,198,307,307,True
10766,2012-03-29,2,1,3,16,0,4,1,1,0.52,0.5,0.36,0.3284,67,321,388,388,True
10767,2012-03-29,2,1,3,17,0,4,1,1,0.52,0.5,0.38,0.3881,83,499,582,582,True
10768,2012-03-29,2,1,3,18,0,4,1,1,0.5,0.4848,0.39,0.2985,83,499,582,582,True
10769,2012-03-29,2,1,3,19,0,4,1,1,0.48,0.4697,0.39,0.2836,47,421,468,468,True
10770,2012-03-29,2,1,3,20,0,4,1,1,0.46,0.4545,0.38,0.2985,34,301,335,335,True
10771,2012-03-29,2,1,3,21,0,4,1,1,0.44,0.4394,0.44,0.2836,10,214,224,224,True
10772,2012-03-29,2,1,3,22,0,4,1,1,0.42,0.4242,0.44,0.2836,17,135,152,152,True
10773,2012-03-29,2,1,3,23,0,4,1,1,0.42,0.4242,0.47,0.2985,17,77,94,94,True
10774,2012-03-30,2,1,3,0,0,5,1,1,0.4,0.4091,0.47,0.2985,10,49,59,59,True
10775,2012-03-30,2,1,3,1,0,5,1,1,0.38,0.3939,0.5,0.2836,6,21,27,27,True
10776,2012-03-30,2,1,3,2,0,5,1,1,0.36,0.3333,0.53,0.2985,1,6,7,7,True
10777,2012-03-30,2,1,3,3,0,5,1,1,0.34,0.3333,0.61,0.1343,0,7,7,7,True
10778,2012-03-30,2,1,3,4,0,5,1,1,0.34,0.3485,0.53,0.0896,1,1,2,2,True
10779,2012-03-30,2,1,3,5,0,5,1,1,0.32,0.3333,0.61,0.0896,0,26,26,26,True
10780,2012-03-30,2,1,3,6,0,5,1,1,0.32,0.3333,0.57,0.1343,5,81,86,86,True
10781,2012-03-30,2,1,3,7,0,5,1,1,0.32,0.3182,0.57,0.1642,9,280,289,289,True
10782,2012-03-30,2,1,3,8,0,5,1,1,0.32,0.3182,0.66,0.1642,38,499,537,537,True
10783,2012-03-30,2,1,3,9,0,5,1,1,0.34,0.3333,0.57,0.1642,29,292,321,321,True
10784,2012-03-30,2,1,3,10,0,5,1,2,0.36,0.3636,0.57,0.1045,50,137,187,187,True
10785,2012-03-30,2,1,3,11,0,5,1,2,0.36,0.3788,0.53,0.0,48,153,201,201,True
10786,2012-03-30,2,1,3,12,0,5,1,2,0.38,0.3939,0.54,0.0,62,208,270,270,True
10787,2012-03-30,2,1,3,13,0,5,1,3,0.4,0.4091,0.5,0.0,44,198,242,242,True
10788,2012-03-30,2,1,3,14,0,5,1,3,0.4,0.4091,0.54,0.0,56,173,229,229,True
10789,2012-03-30,2,1,3,15,0,5,1,3,0.42,0.4242,0.54,0.0,73,207,280,280,True
10790,2012-03-30,2,1,3,16,0,5,1,3,0.4,0.4091,0.62,0.2836,75,292,367,367,True
10791,2012-03-30,2,1,3,17,0,5,1,2,0.4,0.4091,0.62,0.2239,93,499,592,592,True
10792,2012-03-30,2,1,3,18,0,5,1,1,0.42,0.4242,0.54,0.194,68,492,560,560,True
10793,2012-03-30,2,1,3,19,0,5,1,1,0.4,0.4091,0.62,0.2239,42,353,395,395,True
10794,2012-03-30,2,1,3,20,0,5,1,1,0.4,0.4091,0.62,0.1642,17,192,209,209,True
10795,2012-03-30,2,1,3,21,0,5,1,1,0.38,0.3939,0.66,0.1343,30,190,220,220,True
10796,2012-03-30,2,1,3,22,0,5,1,1,0.36,0.3485,0.71,0.1642,23,130,153,153,True
10797,2012-03-30,2,1,3,23,0,5,1,1,0.36,0.3788,0.71,0.0,16,107,123,123,True
10798,2012-03-31,2,1,3,0,0,6,0,1,0.38,0.3939,0.82,0.194,12,80,92,92,True
10799,2012-03-31,2,1,3,1,0,6,0,2,0.4,0.4091,0.76,0.194,17,65,82,82,True
10800,2012-03-31,2,1,3,2,0,6,0,2,0.42,0.4242,0.77,0.2537,14,55,69,69,True
10801,2012-03-31,2,1,3,3,0,6,0,1,0.4,0.4091,0.82,0.2537,10,21,31,31,True
10802,2012-03-31,2,1,3,4,0,6,0,1,0.42,0.4242,0.77,0.4179,4,4,8,8,True
10803,2012-03-31,2,1,3,5,0,6,0,1,0.4,0.4091,0.82,0.2239,0,5,5,5,True
10804,2012-03-31,2,1,3,6,0,6,0,2,0.36,0.3485,0.87,0.1642,7,16,23,23,True
10805,2012-03-31,2,1,3,7,0,6,0,2,0.36,0.3485,0.87,0.1642,5,39,44,44,True
10806,2012-03-31,2,1,3,8,0,6,0,2,0.36,0.3485,0.87,0.194,19,126,145,145,True
10807,2012-03-31,2,1,3,9,0,6,0,2,0.4,0.4091,0.76,0.194,62,161,223,223,True
10808,2012-03-31,2,1,3,10,0,6,0,2,0.4,0.4091,0.76,0.1343,108,205,313,313,True
10809,2012-03-31,2,1,3,11,0,6,0,1,0.46,0.4545,0.72,0.1343,114,279,393,393,True
10810,2012-03-31,2,1,3,12,0,6,0,1,0.48,0.4697,0.67,0.0,114,358,472,472,True
10811,2012-03-31,2,1,3,13,0,6,0,1,0.54,0.5152,0.6,0.1343,114,373,487,487,True
10812,2012-03-31,2,1,3,14,0,6,0,2,0.5,0.4848,0.63,0.2537,114,311,425,425,True
10813,2012-03-31,2,1,3,15,0,6,0,2,0.52,0.5,0.59,0.2836,114,330,444,444,True
10814,2012-03-31,2,1,3,16,0,6,0,2,0.5,0.4848,0.63,0.2985,114,292,406,406,True
10815,2012-03-31,2,1,3,17,0,6,0,1,0.48,0.4697,0.67,0.4179,114,305,419,419,True
10816,2012-03-31,2,1,3,18,0,6,0,2,0.44,0.4394,0.72,0.4627,102,239,341,341,True
10817,2012-03-31,2,1,3,19,0,6,0,1,0.42,0.4242,0.71,0.4478,93,191,284,284,True
10818,2012-03-31,2,1,3,20,0,6,0,2,0.4,0.4091,0.71,0.3284,52,156,208,208,True
10819,2012-03-31,2,1,3,21,0,6,0,2,0.4,0.4091,0.71,0.3284,36,107,143,143,True
10820,2012-03-31,2,1,3,22,0,6,0,2,0.38,0.3939,0.71,0.2537,40,116,156,156,True
10821,2012-03-31,2,1,3,23,0,6,0,2,0.36,0.3333,0.76,0.2836,12,100,112,112,True
10822,2012-04-01,2,1,4,0,0,0,0,2,0.36,0.3333,0.76,0.2537,8,59,67,67,True
10823,2012-04-01,2,1,4,1,0,0,0,2,0.36,0.3485,0.76,0.1642,13,49,62,62,True
10824,2012-04-01,2,1,4,2,0,0,0,2,0.36,0.3485,0.76,0.1642,20,61,81,81,True
10825,2012-04-01,2,1,4,3,0,0,0,2,0.34,0.3333,0.81,0.1343,4,21,25,25,True
10826,2012-04-01,2,1,4,4,0,0,0,2,0.34,0.3485,0.81,0.0896,3,9,12,12,True
10827,2012-04-01,2,1,4,5,0,0,0,2,0.34,0.3485,0.81,0.0896,8,10,18,18,True
10828,2012-04-01,2,1,4,6,0,0,0,2,0.36,0.3485,0.76,0.1343,9,88,97,97,True
10829,2012-04-01,2,1,4,7,0,0,0,2,0.36,0.3485,0.71,0.1343,29,55,84,84,True
10830,2012-04-01,2,1,4,8,0,0,0,2,0.36,0.3636,0.76,0.0896,37,88,125,125,True
10831,2012-04-01,2,1,4,9,0,0,0,2,0.36,0.3485,0.81,0.1343,102,173,275,275,True
10832,2012-04-01,2,1,4,10,0,0,0,2,0.4,0.4091,0.71,0.1045,114,228,342,342,True
10833,2012-04-01,2,1,4,11,0,0,0,2,0.4,0.4091,0.71,0.194,114,271,385,385,True
10834,2012-04-01,2,1,4,12,0,0,0,2,0.42,0.4242,0.67,0.2239,114,258,372,372,True
10835,2012-04-01,2,1,4,13,0,0,0,2,0.44,0.4394,0.62,0.194,114,274,388,388,True
10836,2012-04-01,2,1,4,14,0,0,0,2,0.48,0.4697,0.55,0.2239,114,278,392,392,True
10837,2012-04-01,2,1,4,15,0,0,0,1,0.5,0.4848,0.55,0.2537,114,278,392,392,True
10838,2012-04-01,2,1,4,16,0,0,0,1,0.52,0.5,0.52,0.2537,114,275,389,389,True
10839,2012-04-01,2,1,4,17,0,0,0,1,0.52,0.5,0.55,0.2836,114,323,437,437,True
10840,2012-04-01,2,1,4,18,0,0,0,1,0.52,0.5,0.52,0.2985,114,279,393,393,True
10841,2012-04-01,2,1,4,19,0,0,0,1,0.52,0.5,0.55,0.2239,110,236,346,346,True
10842,2012-04-01,2,1,4,20,0,0,0,2,0.5,0.4848,0.59,0.2239,66,166,232,232,True
10843,2012-04-01,2,1,4,21,0,0,0,2,0.5,0.4848,0.59,0.1642,33,101,134,134,True
10844,2012-04-01,2,1,4,22,0,0,0,3,0.5,0.4848,0.63,0.1045,7,61,68,68,True
10845,2012-04-01,2,1,4,23,0,0,0,3,0.46,0.4545,0.72,0.0,10,53,63,63,True
10846,2012-04-02,2,1,4,0,0,1,1,3,0.44,0.4394,0.82,0.1045,6,11,17,17,True
10847,2012-04-02,2,1,4,1,0,1,1,3,0.42,0.4242,0.88,0.0896,0,5,5,5,True
10848,2012-04-02,2,1,4,2,0,1,1,3,0.44,0.4394,0.94,0.1343,2,3,5,5,True
10849,2012-04-02,2,1,4,4,0,1,1,1,0.4,0.4091,0.76,0.4775,2,2,4,4,True
10850,2012-04-02,2,1,4,5,0,1,1,1,0.4,0.4091,0.76,0.4775,2,22,24,24,True
10851,2012-04-02,2,1,4,6,0,1,1,1,0.36,0.3182,0.71,0.4627,6,104,110,110,True
10852,2012-04-02,2,1,4,7,0,1,1,1,0.34,0.303,0.66,0.3881,12,294,306,306,True
10853,2012-04-02,2,1,4,8,0,1,1,1,0.36,0.3333,0.57,0.3284,36,499,535,535,True
10854,2012-04-02,2,1,4,9,0,1,1,1,0.38,0.3939,0.54,0.3582,52,265,317,317,True
10855,2012-04-02,2,1,4,10,0,1,1,1,0.4,0.4091,0.5,0.4775,85,119,204,204,True
10856,2012-04-02,2,1,4,11,0,1,1,1,0.42,0.4242,0.47,0.4478,81,128,209,209,True
10857,2012-04-02,2,1,4,12,0,1,1,1,0.44,0.4394,0.44,0.4478,100,181,281,281,True
10858,2012-04-02,2,1,4,13,0,1,1,1,0.46,0.4545,0.36,0.2985,97,184,281,281,True
10859,2012-04-02,2,1,4,14,0,1,1,1,0.46,0.4545,0.31,0.4179,114,141,255,255,True
10860,2012-04-02,2,1,4,15,0,1,1,1,0.48,0.4697,0.33,0.4179,114,192,306,306,True
10861,2012-04-02,2,1,4,16,0,1,1,1,0.5,0.4848,0.34,0.3284,104,291,395,395,True
10862,2012-04-02,2,1,4,17,0,1,1,1,0.5,0.4848,0.29,0.2836,114,499,613,613,True
10863,2012-04-02,2,1,4,18,0,1,1,1,0.5,0.4848,0.27,0.2537,75,499,574,574,True
10864,2012-04-02,2,1,4,19,0,1,1,1,0.5,0.4848,0.27,0.2537,66,428,494,494,True
10865,2012-04-02,2,1,4,20,0,1,1,1,0.46,0.4545,0.31,0.1642,48,281,329,329,True
10866,2012-04-02,2,1,4,21,0,1,1,1,0.46,0.4545,0.28,0.1343,24,214,238,238,True
10867,2012-04-02,2,1,4,22,0,1,1,1,0.42,0.4242,0.44,0.194,17,106,123,123,True
10868,2012-04-02,2,1,4,23,0,1,1,1,0.44,0.4394,0.35,0.1642,6,60,66,66,True
10869,2012-04-03,2,1,4,0,0,2,1,1,0.4,0.4091,0.43,0.1343,1,32,33,33,True
10870,2012-04-03,2,1,4,1,0,2,1,1,0.38,0.3939,0.46,0.2239,0,11,11,11,True
10871,2012-04-03,2,1,4,2,0,2,1,1,0.36,0.3485,0.53,0.1642,0,5,5,5,True
10872,2012-04-03,2,1,4,3,0,2,1,1,0.38,0.3939,0.46,0.0,0,3,3,3,True
10873,2012-04-03,2,1,4,4,0,2,1,1,0.32,0.3333,0.66,0.0896,0,1,1,1,True
10874,2012-04-03,2,1,4,5,0,2,1,1,0.32,0.3333,0.66,0.0896,2,25,27,27,True
10875,2012-04-03,2,1,4,6,0,2,1,1,0.3,0.3182,0.61,0.0896,2,98,100,100,True
10876,2012-04-03,2,1,4,7,0,2,1,1,0.32,0.3333,0.66,0.0896,14,327,341,341,True
10877,2012-04-03,2,1,4,8,0,2,1,1,0.34,0.3636,0.57,0.0,27,499,526,526,True
10878,2012-04-03,2,1,4,9,0,2,1,1,0.42,0.4242,0.38,0.0896,54,354,408,408,True
10879,2012-04-03,2,1,4,10,0,2,1,1,0.44,0.4394,0.33,0.0,77,142,219,219,True
10880,2012-04-03,2,1,4,11,0,2,1,1,0.48,0.4697,0.23,0.0,91,167,258,258,True
10881,2012-04-03,2,1,4,12,0,2,1,1,0.52,0.5,0.25,0.0,101,230,331,331,True
10882,2012-04-03,2,1,4,13,0,2,1,1,0.56,0.5303,0.19,0.2537,114,225,339,339,True
10883,2012-04-03,2,1,4,14,0,2,1,1,0.56,0.5303,0.21,0.2239,114,191,305,305,True
10884,2012-04-03,2,1,4,15,0,2,1,1,0.6,0.5909,0.2,0.194,109,207,316,316,True
10885,2012-04-03,2,1,4,16,0,2,1,1,0.62,0.6061,0.21,0.1642,114,340,454,454,True
10886,2012-04-03,2,1,4,17,0,2,1,1,0.62,0.6061,0.17,0.194,114,499,613,613,True
10887,2012-04-03,2,1,4,18,0,2,1,1,0.6,0.6061,0.26,0.1642,114,499,613,613,True
10888,2012-04-03,2,1,4,19,0,2,1,1,0.56,0.5303,0.26,0.1045,98,460,558,558,True
10889,2012-04-03,2,1,4,20,0,2,1,1,0.56,0.5303,0.24,0.1343,54,325,379,379,True
10890,2012-04-03,2,1,4,21,0,2,1,1,0.54,0.5152,0.45,0.0,33,210,243,243,True
10891,2012-04-03,2,1,4,22,0,2,1,1,0.5,0.4848,0.51,0.0,25,133,158,158,True
10892,2012-04-03,2,1,4,23,0,2,1,1,0.5,0.4848,0.59,0.0,13,66,79,79,True
10893,2012-04-04,2,1,4,0,0,3,1,1,0.48,0.4697,0.48,0.0,18,23,41,41,True
10894,2012-04-04,2,1,4,1,0,3,1,1,0.46,0.4545,0.59,0.0,0,11,11,11,True
10895,2012-04-04,2,1,4,2,0,3,1,1,0.46,0.4545,0.51,0.0,0,5,5,5,True
10896,2012-04-04,2,1,4,3,0,3,1,1,0.44,0.4394,0.58,0.0896,0,3,3,3,True
10897,2012-04-04,2,1,4,4,0,3,1,1,0.42,0.4242,0.67,0.0896,0,1,1,1,True
10898,2012-04-04,2,1,4,5,0,3,1,1,0.42,0.4242,0.67,0.0896,0,27,27,27,True
10899,2012-04-04,2,1,4,6,0,3,1,2,0.42,0.4242,0.58,0.0,6,120,126,126,True
10900,2012-04-04,2,1,4,7,0,3,1,2,0.44,0.4394,0.62,0.0,12,354,366,366,True
10901,2012-04-04,2,1,4,8,0,3,1,2,0.44,0.4394,0.72,0.1045,31,499,530,530,True
10902,2012-04-04,2,1,4,9,0,3,1,2,0.48,0.4697,0.55,0.1343,47,316,363,363,True
10903,2012-04-04,2,1,4,10,0,3,1,2,0.54,0.5152,0.45,0.1343,68,99,167,167,True
10904,2012-04-04,2,1,4,11,0,3,1,2,0.6,0.6212,0.43,0.3582,61,152,213,213,True
10905,2012-04-04,2,1,4,12,0,3,1,2,0.6,0.6212,0.46,0.4179,73,210,283,283,True
10906,2012-04-04,2,1,4,13,0,3,1,2,0.6,0.6212,0.46,0.2537,70,181,251,251,True
10907,2012-04-04,2,1,4,14,0,3,1,2,0.62,0.6212,0.46,0.194,82,176,258,258,True
10908,2012-04-04,2,1,4,15,0,3,1,2,0.64,0.6212,0.44,0.2836,86,182,268,268,True
10909,2012-04-04,2,1,4,16,0,3,1,2,0.64,0.6212,0.44,0.2836,86,304,390,390,True
10910,2012-04-04,2,1,4,17,0,3,1,1,0.66,0.6212,0.41,0.2985,99,499,598,598,True
10911,2012-04-04,2,1,4,18,0,3,1,1,0.66,0.6212,0.41,0.2537,113,499,612,612,True
10912,2012-04-04,2,1,4,19,0,3,1,1,0.66,0.6212,0.39,0.2239,75,419,494,494,True
10913,2012-04-04,2,1,4,20,0,3,1,1,0.64,0.6212,0.27,0.2239,39,333,372,372,True
10914,2012-04-04,2,1,4,21,0,3,1,1,0.6,0.6061,0.23,0.3284,43,255,298,298,True
10915,2012-04-04,2,1,4,22,0,3,1,1,0.56,0.5303,0.22,0.1642,30,151,181,181,True
10916,2012-04-04,2,1,4,23,0,3,1,1,0.52,0.5,0.23,0.4179,19,112,131,131,True
10917,2012-04-05,2,1,4,0,0,4,1,1,0.52,0.5,0.23,0.4179,12,33,45,45,True
10918,2012-04-05,2,1,4,1,0,4,1,1,0.48,0.4697,0.27,0.3284,4,9,13,13,True
10919,2012-04-05,2,1,4,2,0,4,1,1,0.46,0.4545,0.33,0.4478,7,11,18,18,True
10920,2012-04-05,2,1,4,3,0,4,1,1,0.42,0.4242,0.41,0.2985,0,5,5,5,True
10921,2012-04-05,2,1,4,4,0,4,1,1,0.38,0.3939,0.43,0.2836,0,1,1,1,True
10922,2012-04-05,2,1,4,5,0,4,1,1,0.38,0.3939,0.43,0.2836,1,28,29,29,True
10923,2012-04-05,2,1,4,6,0,4,1,1,0.36,0.3333,0.46,0.3284,8,118,126,126,True
10924,2012-04-05,2,1,4,7,0,4,1,1,0.34,0.3333,0.49,0.194,15,339,354,354,True
10925,2012-04-05,2,1,4,8,0,4,1,1,0.36,0.3485,0.46,0.2239,28,499,527,527,True
10926,2012-04-05,2,1,4,9,0,4,1,1,0.4,0.4091,0.37,0.2537,61,290,351,351,True
10927,2012-04-05,2,1,4,10,0,4,1,1,0.42,0.4242,0.35,0.2836,88,158,246,246,True
10928,2012-04-05,2,1,4,11,0,4,1,2,0.42,0.4242,0.38,0.2239,109,159,268,268,True
10929,2012-04-05,2,1,4,12,0,4,1,1,0.44,0.4394,0.33,0.0,66,210,276,276,True
10930,2012-04-05,2,1,4,13,0,4,1,1,0.46,0.4545,0.31,0.0,89,202,291,291,True
10931,2012-04-05,2,1,4,14,0,4,1,1,0.46,0.4545,0.33,0.1642,114,144,258,258,True
10932,2012-04-05,2,1,4,15,0,4,1,1,0.5,0.4848,0.31,0.1045,98,171,269,269,True
10933,2012-04-05,2,1,4,16,0,4,1,1,0.5,0.4848,0.31,0.194,84,318,402,402,True
10934,2012-04-05,2,1,4,17,0,4,1,1,0.5,0.4848,0.31,0.1642,114,499,613,613,True
10935,2012-04-05,2,1,4,18,0,4,1,1,0.5,0.4848,0.31,0.1045,80,499,579,579,True
10936,2012-04-05,2,1,4,19,0,4,1,1,0.48,0.4697,0.31,0.2537,64,423,487,487,True
10937,2012-04-05,2,1,4,20,0,4,1,1,0.44,0.4394,0.41,0.194,33,279,312,312,True
10938,2012-04-05,2,1,4,21,0,4,1,1,0.42,0.4242,0.47,0.194,25,209,234,234,True
10939,2012-04-05,2,1,4,22,0,4,1,1,0.4,0.4091,0.47,0.194,20,129,149,149,True
10940,2012-04-05,2,1,4,23,0,4,1,1,0.4,0.4091,0.5,0.1343,12,124,136,136,True
10941,2012-04-06,2,1,4,0,0,5,1,1,0.4,0.4091,0.43,0.0,12,49,61,61,True
10942,2012-04-06,2,1,4,1,0,5,1,1,0.36,0.3485,0.62,0.1343,10,28,38,38,True
10943,2012-04-06,2,1,4,2,0,5,1,1,0.36,0.3333,0.5,0.3881,6,5,11,11,True
10944,2012-04-06,2,1,4,3,0,5,1,1,0.34,0.303,0.53,0.3284,3,5,8,8,True
10945,2012-04-06,2,1,4,4,0,5,1,1,0.34,0.3182,0.49,0.2537,2,3,5,5,True
10946,2012-04-06,2,1,4,5,0,5,1,1,0.32,0.303,0.53,0.3284,0,23,23,23,True
10947,2012-04-06,2,1,4,6,0,5,1,1,0.3,0.2727,0.49,0.3881,0,80,80,80,True
10948,2012-04-06,2,1,4,7,0,5,1,1,0.3,0.2879,0.49,0.2836,15,231,246,246,True
10949,2012-04-06,2,1,4,8,0,5,1,1,0.3,0.2727,0.49,0.3284,19,489,508,508,True
10950,2012-04-06,2,1,4,9,0,5,1,1,0.34,0.303,0.42,0.3284,58,318,376,376,True
10951,2012-04-06,2,1,4,10,0,5,1,1,0.36,0.3333,0.4,0.3284,81,157,238,238,True
10952,2012-04-06,2,1,4,11,0,5,1,1,0.4,0.4091,0.37,0.2985,112,179,291,291,True
10953,2012-04-06,2,1,4,12,0,5,1,1,0.42,0.4242,0.35,0.2985,113,224,337,337,True
10954,2012-04-06,2,1,4,13,0,5,1,1,0.44,0.4394,0.33,0.3284,114,238,352,352,True
10955,2012-04-06,2,1,4,14,0,5,1,1,0.48,0.4697,0.29,0.3881,114,250,364,364,True
10956,2012-04-06,2,1,4,15,0,5,1,1,0.5,0.4848,0.27,0.2836,114,319,433,433,True
10957,2012-04-06,2,1,4,16,0,5,1,1,0.5,0.4848,0.22,0.4179,114,352,466,466,True
10958,2012-04-06,2,1,4,17,0,5,1,1,0.52,0.5,0.23,0.4179,114,483,597,597,True
10959,2012-04-06,2,1,4,18,0,5,1,1,0.5,0.4848,0.22,0.4627,104,380,484,484,True
10960,2012-04-06,2,1,4,19,0,5,1,1,0.48,0.4697,0.23,0.2985,114,297,411,411,True
10961,2012-04-06,2,1,4,20,0,5,1,1,0.46,0.4545,0.24,0.2836,61,191,252,252,True
10962,2012-04-06,2,1,4,21,0,5,1,1,0.44,0.4394,0.26,0.1343,54,136,190,190,True
10963,2012-04-06,2,1,4,22,0,5,1,1,0.4,0.4091,0.35,0.2239,34,124,158,158,True
10964,2012-04-06,2,1,4,23,0,5,1,1,0.42,0.4242,0.3,0.2836,21,92,113,113,True
10965,2012-04-07,2,1,4,0,0,6,0,1,0.42,0.4242,0.26,0.2985,9,85,94,94,True
10966,2012-04-07,2,1,4,1,0,6,0,1,0.4,0.4091,0.28,0.2537,9,60,69,69,True
10967,2012-04-07,2,1,4,2,0,6,0,1,0.36,0.3333,0.29,0.3582,11,25,36,36,True
10968,2012-04-07,2,1,4,3,0,6,0,1,0.36,0.3333,0.32,0.2537,7,21,28,28,True
10969,2012-04-07,2,1,4,4,0,6,0,1,0.32,0.3182,0.36,0.1642,3,4,7,7,True
10970,2012-04-07,2,1,4,5,0,6,0,1,0.32,0.3182,0.33,0.1642,0,2,2,2,True
10971,2012-04-07,2,1,4,6,0,6,0,1,0.32,0.3182,0.36,0.194,1,18,19,19,True
10972,2012-04-07,2,1,4,7,0,6,0,1,0.32,0.303,0.33,0.2836,14,40,54,54,True
10973,2012-04-07,2,1,4,8,0,6,0,1,0.34,0.3182,0.34,0.2537,29,94,123,123,True
10974,2012-04-07,2,1,4,9,0,6,0,1,0.4,0.4091,0.3,0.2537,103,173,276,276,True
10975,2012-04-07,2,1,4,10,0,6,0,1,0.42,0.4242,0.28,0.2537,114,176,290,290,True
10976,2012-04-07,2,1,4,11,0,6,0,1,0.44,0.4394,0.24,0.2985,114,244,358,358,True
10977,2012-04-07,2,1,4,12,0,6,0,1,0.46,0.4545,0.23,0.3881,114,270,384,384,True
10978,2012-04-07,2,1,4,13,0,6,0,1,0.5,0.4848,0.22,0.194,114,288,402,402,True
10979,2012-04-07,2,1,4,14,0,6,0,1,0.5,0.4848,0.22,0.2985,114,252,366,366,True
10980,2012-04-07,2,1,4,15,0,6,0,1,0.52,0.5,0.19,0.4179,114,305,419,419,True
10981,2012-04-07,2,1,4,16,0,6,0,1,0.54,0.5152,0.19,0.3881,114,261,375,375,True
10982,2012-04-07,2,1,4,17,0,6,0,1,0.54,0.5152,0.19,0.4179,114,268,382,382,True
10983,2012-04-07,2,1,4,18,0,6,0,1,0.54,0.5152,0.18,0.2985,114,290,404,404,True
10984,2012-04-07,2,1,4,19,0,6,0,1,0.54,0.5152,0.16,0.3284,114,243,357,357,True
10985,2012-04-07,2,1,4,20,0,6,0,1,0.5,0.4848,0.2,0.2239,73,135,208,208,True
10986,2012-04-07,2,1,4,21,0,6,0,1,0.5,0.4848,0.2,0.194,75,159,234,234,True
10987,2012-04-07,2,1,4,22,0,6,0,1,0.48,0.4697,0.2,0.194,76,106,182,182,True
10988,2012-04-07,2,1,4,23,0,6,0,1,0.46,0.4545,0.23,0.2239,32,86,118,118,True
10989,2012-04-08,2,1,4,0,0,0,0,1,0.44,0.4394,0.24,0.2239,21,64,85,85,True
10990,2012-04-08,2,1,4,1,0,0,0,1,0.44,0.4394,0.24,0.2239,14,50,64,64,True
10991,2012-04-08,2,1,4,2,0,0,0,1,0.44,0.4394,0.24,0.2239,7,25,32,32,True
10992,2012-04-08,2,1,4,3,0,0,0,1,0.42,0.4242,0.26,0.1343,8,18,26,26,True
10993,2012-04-08,2,1,4,4,0,0,0,1,0.4,0.4091,0.4,0.0,0,7,7,7,True
10994,2012-04-08,2,1,4,5,0,0,0,1,0.38,0.3939,0.46,0.0,4,8,12,12,True
10995,2012-04-08,2,1,4,6,0,0,0,1,0.36,0.3788,0.37,0.0,7,21,28,28,True
10996,2012-04-08,2,1,4,7,0,0,0,1,0.38,0.3939,0.27,0.1642,12,25,37,37,True
10997,2012-04-08,2,1,4,8,0,0,0,1,0.4,0.4091,0.3,0.194,19,65,84,84,True
10998,2012-04-08,2,1,4,9,0,0,0,1,0.44,0.4394,0.26,0.2239,71,108,179,179,True
10999,2012-04-08,2,1,4,10,0,0,0,1,0.5,0.4848,0.25,0.2239,113,186,299,299,True
11000,2012-04-08,2,1,4,11,0,0,0,1,0.5,0.4848,0.25,0.2836,114,209,323,323,True
11001,2012-04-08,2,1,4,12,0,0,0,1,0.54,0.5152,0.24,0.2537,114,259,373,373,True
11002,2012-04-08,2,1,4,13,0,0,0,1,0.58,0.5455,0.23,0.1642,114,254,368,368,True
11003,2012-04-08,2,1,4,14,0,0,0,1,0.6,0.5909,0.18,0.4478,114,249,363,363,True
11004,2012-04-08,2,1,4,15,0,0,0,1,0.62,0.6061,0.17,0.3582,114,226,340,340,True
11005,2012-04-08,2,1,4,16,0,0,0,1,0.64,0.6061,0.19,0.3284,114,244,358,358,True
11006,2012-04-08,2,1,4,17,0,0,0,1,0.62,0.6061,0.22,0.2985,114,226,340,340,True
11007,2012-04-08,2,1,4,18,0,0,0,1,0.62,0.6061,0.25,0.3284,114,159,273,273,True
11008,2012-04-08,2,1,4,19,0,0,0,1,0.6,0.6061,0.23,0.3881,89,187,276,276,True
11009,2012-04-08,2,1,4,20,0,0,0,1,0.56,0.5303,0.28,0.4179,65,146,211,211,True
11010,2012-04-08,2,1,4,21,0,0,0,1,0.52,0.5,0.34,0.2239,53,77,130,130,True
11011,2012-04-08,2,1,4,22,0,0,0,1,0.5,0.4848,0.36,0.2239,33,85,118,118,True
11012,2012-04-08,2,1,4,23,0,0,0,1,0.5,0.4848,0.39,0.2537,10,41,51,51,True
11013,2012-04-09,2,1,4,0,0,1,1,1,0.48,0.4697,0.39,0.2836,8,29,37,37,True
11014,2012-04-09,2,1,4,1,0,1,1,1,0.46,0.4545,0.41,0.1343,4,12,16,16,True
11015,2012-04-09,2,1,4,2,0,1,1,1,0.46,0.4545,0.31,0.194,2,4,6,6,True
11016,2012-04-09,2,1,4,3,0,1,1,1,0.44,0.4394,0.3,0.1642,0,3,3,3,True
11017,2012-04-09,2,1,4,4,0,1,1,1,0.44,0.4394,0.24,0.194,2,3,5,5,True
11018,2012-04-09,2,1,4,5,0,1,1,1,0.44,0.4394,0.24,0.194,2,30,32,32,True
11019,2012-04-09,2,1,4,6,0,1,1,1,0.42,0.4242,0.26,0.2239,3,108,111,111,True
11020,2012-04-09,2,1,4,7,0,1,1,1,0.42,0.4242,0.28,0.194,11,320,331,331,True
11021,2012-04-09,2,1,4,8,0,1,1,1,0.44,0.4394,0.3,0.194,22,499,521,521,True
11022,2012-04-09,2,1,4,9,0,1,1,1,0.46,0.4545,0.31,0.3582,50,236,286,286,True
11023,2012-04-09,2,1,4,10,0,1,1,1,0.5,0.4848,0.27,0.4775,65,113,178,178,True
11024,2012-04-09,2,1,4,11,0,1,1,1,0.52,0.5,0.27,0.4179,96,127,223,223,True
11025,2012-04-09,2,1,4,12,0,1,1,1,0.54,0.5152,0.28,0.4775,94,186,280,280,True
11026,2012-04-09,2,1,4,13,0,1,1,1,0.54,0.5152,0.28,0.4775,108,173,281,281,True
11027,2012-04-09,2,1,4,14,0,1,1,1,0.56,0.5303,0.28,0.4775,66,152,218,218,True
11028,2012-04-09,2,1,4,15,0,1,1,1,0.58,0.5455,0.28,0.4775,82,173,255,255,True
11029,2012-04-09,2,1,4,16,0,1,1,1,0.56,0.5303,0.3,0.4179,81,310,391,391,True
11030,2012-04-09,2,1,4,17,0,1,1,1,0.54,0.5152,0.32,0.4179,67,499,566,566,True
11031,2012-04-09,2,1,4,18,0,1,1,1,0.54,0.5152,0.34,0.2985,60,499,559,559,True
11032,2012-04-09,2,1,4,19,0,1,1,1,0.52,0.5,0.34,0.3582,35,386,421,421,True
11033,2012-04-09,2,1,4,20,0,1,1,1,0.5,0.4848,0.36,0.4478,21,255,276,276,True
11034,2012-04-09,2,1,4,21,0,1,1,3,0.48,0.4697,0.41,0.4179,14,151,165,165,True
11035,2012-04-09,2,1,4,22,0,1,1,2,0.46,0.4545,0.41,0.4775,6,102,108,108,True
11036,2012-04-09,2,1,4,23,0,1,1,1,0.44,0.4394,0.44,0.2985,6,61,67,67,True
11037,2012-04-10,2,1,4,0,0,2,1,2,0.44,0.4394,0.47,0.2836,3,23,26,26,True
11038,2012-04-10,2,1,4,1,0,2,1,1,0.42,0.4242,0.5,0.2239,0,9,9,9,True
11039,2012-04-10,2,1,4,2,0,2,1,1,0.36,0.3485,0.71,0.1343,0,2,2,2,True
11040,2012-04-10,2,1,4,3,0,2,1,1,0.36,0.3485,0.71,0.1343,0,2,2,2,True
11041,2012-04-10,2,1,4,4,0,2,1,1,0.34,0.3333,0.71,0.1343,0,2,2,2,True
11042,2012-04-10,2,1,4,5,0,2,1,1,0.34,0.3333,0.71,0.1343,0,24,24,24,True
11043,2012-04-10,2,1,4,6,0,2,1,1,0.34,0.3485,0.71,0.1045,3,100,103,103,True
11044,2012-04-10,2,1,4,7,0,2,1,1,0.34,0.3485,0.71,0.1045,16,368,384,384,True
11045,2012-04-10,2,1,4,8,0,2,1,1,0.38,0.3939,0.62,0.1343,22,499,521,521,True
11046,2012-04-10,2,1,4,9,0,2,1,1,0.42,0.4242,0.67,0.194,16,303,319,319,True
11047,2012-04-10,2,1,4,10,0,2,1,1,0.46,0.4545,0.47,0.1642,49,132,181,181,True
11048,2012-04-10,2,1,4,11,0,2,1,1,0.5,0.4848,0.36,0.0,78,161,239,239,True
11049,2012-04-10,2,1,4,12,0,2,1,1,0.54,0.5152,0.22,0.2836,75,184,259,259,True
11050,2012-04-10,2,1,4,13,0,2,1,1,0.52,0.5,0.23,0.1642,81,202,283,283,True
11051,2012-04-10,2,1,4,14,0,2,1,1,0.54,0.5152,0.24,0.194,75,149,224,224,True
11052,2012-04-10,2,1,4,15,0,2,1,1,0.56,0.5303,0.21,0.2985,46,157,203,203,True
11053,2012-04-10,2,1,4,16,0,2,1,1,0.58,0.5455,0.21,0.2537,66,296,362,362,True
11054,2012-04-10,2,1,4,17,0,2,1,1,0.56,0.5303,0.21,0.4775,88,499,587,587,True
11055,2012-04-10,2,1,4,18,0,2,1,1,0.54,0.5152,0.22,0.4179,78,499,577,577,True
11056,2012-04-10,2,1,4,19,0,2,1,1,0.52,0.5,0.2,0.3582,51,428,479,479,True
11057,2012-04-10,2,1,4,20,0,2,1,1,0.46,0.4545,0.28,0.3881,34,248,282,282,True
11058,2012-04-10,2,1,4,21,0,2,1,1,0.44,0.4394,0.3,0.4478,15,191,206,206,True
11059,2012-04-10,2,1,4,22,0,2,1,1,0.4,0.4091,0.37,0.4775,9,118,127,127,True
11060,2012-04-10,2,1,4,23,0,2,1,1,0.36,0.3333,0.4,0.4179,14,48,62,62,True
11061,2012-04-11,2,1,4,0,0,3,1,1,0.34,0.303,0.36,0.4179,8,22,30,30,True
11062,2012-04-11,2,1,4,1,0,3,1,1,0.34,0.3182,0.39,0.2836,3,9,12,12,True
11063,2012-04-11,2,1,4,2,0,3,1,1,0.32,0.303,0.45,0.2836,0,2,2,2,True
11064,2012-04-11,2,1,4,3,0,3,1,1,0.3,0.2879,0.49,0.2239,0,2,2,2,True
11065,2012-04-11,2,1,4,5,0,3,1,1,0.28,0.2727,0.56,0.194,1,26,27,27,True
11066,2012-04-11,2,1,4,6,0,3,1,1,0.28,0.2879,0.56,0.1045,3,103,106,106,True
11067,2012-04-11,2,1,4,7,0,3,1,1,0.28,0.2879,0.52,0.1343,18,303,321,321,True
11068,2012-04-11,2,1,4,8,0,3,1,1,0.3,0.2879,0.49,0.2239,14,499,513,513,True
11069,2012-04-11,2,1,4,9,0,3,1,2,0.32,0.303,0.49,0.2985,20,282,302,302,True
11070,2012-04-11,2,1,4,10,0,3,1,2,0.34,0.303,0.49,0.3284,26,127,153,153,True
11071,2012-04-11,2,1,4,11,0,3,1,2,0.38,0.3939,0.43,0.3284,38,142,180,180,True
11072,2012-04-11,2,1,4,12,0,3,1,2,0.36,0.3333,0.46,0.3881,35,147,182,182,True
11073,2012-04-11,2,1,4,13,0,3,1,2,0.4,0.4091,0.4,0.3582,16,147,163,163,True
11074,2012-04-11,2,1,4,14,0,3,1,1,0.36,0.3485,0.57,0.194,34,101,135,135,True
11075,2012-04-11,2,1,4,15,0,3,1,3,0.38,0.3939,0.46,0.2239,50,152,202,202,True
11076,2012-04-11,2,1,4,16,0,3,1,1,0.44,0.4394,0.33,0.2985,51,256,307,307,True
11077,2012-04-11,2,1,4,17,0,3,1,1,0.42,0.4242,0.35,0.3881,52,499,551,551,True
11078,2012-04-11,2,1,4,18,0,3,1,3,0.4,0.4091,0.43,0.4179,39,499,538,538,True
11079,2012-04-11,2,1,4,19,0,3,1,1,0.4,0.4091,0.4,0.3582,28,356,384,384,True
11080,2012-04-11,2,1,4,20,0,3,1,1,0.36,0.3333,0.46,0.3284,22,213,235,235,True
11081,2012-04-11,2,1,4,21,0,3,1,1,0.34,0.303,0.57,0.3881,11,154,165,165,True
11082,2012-04-11,2,1,4,22,0,3,1,1,0.34,0.303,0.57,0.3284,4,130,134,134,True
11083,2012-04-11,2,1,4,23,0,3,1,1,0.34,0.303,0.57,0.2985,9,52,61,61,True
11084,2012-04-12,2,1,4,0,0,4,1,1,0.32,0.303,0.66,0.2836,1,22,23,23,True
11085,2012-04-12,2,1,4,1,0,4,1,1,0.32,0.303,0.66,0.2239,2,7,9,9,True
11086,2012-04-12,2,1,4,2,0,4,1,1,0.32,0.303,0.61,0.2836,0,4,4,4,True
11087,2012-04-12,2,1,4,3,0,4,1,1,0.32,0.303,0.61,0.2537,2,3,5,5,True
11088,2012-04-12,2,1,4,4,0,4,1,1,0.3,0.2879,0.61,0.2239,0,1,1,1,True
11089,2012-04-12,2,1,4,5,0,4,1,1,0.3,0.2879,0.61,0.2239,0,21,21,21,True
11090,2012-04-12,2,1,4,6,0,4,1,1,0.3,0.2879,0.65,0.2537,2,94,96,96,True
11091,2012-04-12,2,1,4,7,0,4,1,1,0.3,0.2727,0.65,0.3284,12,294,306,306,True
11092,2012-04-12,2,1,4,8,0,4,1,1,0.32,0.303,0.66,0.3284,20,499,519,519,True
11093,2012-04-12,2,1,4,9,0,4,1,1,0.36,0.3333,0.57,0.3582,16,271,287,287,True
11094,2012-04-12,2,1,4,10,0,4,1,1,0.4,0.4091,0.5,0.2985,38,103,141,141,True
11095,2012-04-12,2,1,4,11,0,4,1,1,0.42,0.4242,0.47,0.2985,50,174,224,224,True
11096,2012-04-12,2,1,4,12,0,4,1,1,0.46,0.4545,0.41,0.4478,60,199,259,259,True
11097,2012-04-12,2,1,4,13,0,4,1,1,0.48,0.4697,0.36,0.4478,55,148,203,203,True
11098,2012-04-12,2,1,4,14,0,4,1,1,0.5,0.4848,0.31,0.3284,74,150,224,224,True
11099,2012-04-12,2,1,4,15,0,4,1,1,0.48,0.4697,0.31,0.2537,42,169,211,211,True
11100,2012-04-12,2,1,4,16,0,4,1,1,0.48,0.4697,0.31,0.2836,54,299,353,353,True
11101,2012-04-12,2,1,4,17,0,4,1,1,0.5,0.4848,0.27,0.3881,60,499,559,559,True
11102,2012-04-12,2,1,4,18,0,4,1,1,0.5,0.4848,0.27,0.3881,63,499,562,562,True
11103,2012-04-12,2,1,4,19,0,4,1,1,0.46,0.4545,0.31,0.2985,50,383,433,433,True
11104,2012-04-12,2,1,4,20,0,4,1,1,0.44,0.4394,0.33,0.2537,26,254,280,280,True
11105,2012-04-12,2,1,4,21,0,4,1,1,0.42,0.4242,0.35,0.1343,13,174,187,187,True
11106,2012-04-12,2,1,4,22,0,4,1,1,0.42,0.4242,0.35,0.194,15,143,158,158,True
11107,2012-04-12,2,1,4,23,0,4,1,1,0.42,0.4242,0.35,0.194,8,86,94,94,True
11108,2012-04-13,2,1,4,0,0,5,1,1,0.4,0.4091,0.37,0.2537,14,41,55,55,True
11109,2012-04-13,2,1,4,1,0,5,1,1,0.36,0.3485,0.46,0.194,2,28,30,30,True
11110,2012-04-13,2,1,4,2,0,5,1,1,0.34,0.3333,0.49,0.194,6,5,11,11,True
11111,2012-04-13,2,1,4,3,0,5,1,1,0.34,0.3333,0.61,0.1642,3,8,11,11,True
11112,2012-04-13,2,1,4,4,0,5,1,2,0.34,0.3333,0.53,0.1343,1,4,5,5,True
11113,2012-04-13,2,1,4,5,0,5,1,2,0.34,0.3333,0.53,0.1642,2,19,21,21,True
11114,2012-04-13,2,1,4,6,0,5,1,1,0.32,0.3182,0.57,0.1642,0,84,84,84,True
11115,2012-04-13,2,1,4,7,0,5,1,1,0.34,0.3182,0.61,0.2239,13,283,296,296,True
11116,2012-04-13,2,1,4,8,0,5,1,1,0.38,0.3939,0.46,0.1642,24,499,523,523,True
11117,2012-04-13,2,1,4,9,0,5,1,1,0.42,0.4242,0.41,0.1642,36,294,330,330,True
11118,2012-04-13,2,1,4,10,0,5,1,1,0.44,0.4394,0.38,0.194,59,133,192,192,True
11119,2012-04-13,2,1,4,11,0,5,1,1,0.46,0.4545,0.36,0.1343,75,158,233,233,True
11120,2012-04-13,2,1,4,12,0,5,1,1,0.5,0.4848,0.31,0.0,104,218,322,322,True
11121,2012-04-13,2,1,4,13,0,5,1,1,0.52,0.5,0.27,0.2836,112,246,358,358,True
11122,2012-04-13,2,1,4,14,0,5,1,1,0.52,0.5,0.27,0.0,114,223,337,337,True
11123,2012-04-13,2,1,4,15,0,5,1,1,0.54,0.5152,0.28,0.2537,114,237,351,351,True
11124,2012-04-13,2,1,4,16,0,5,1,1,0.56,0.5303,0.26,0.2537,113,350,463,463,True
11125,2012-04-13,2,1,4,17,0,5,1,1,0.56,0.5303,0.24,0.1642,114,499,613,613,True
11126,2012-04-13,2,1,4,18,0,5,1,1,0.54,0.5152,0.26,0.1343,107,499,606,606,True
11127,2012-04-13,2,1,4,19,0,5,1,1,0.54,0.5152,0.24,0.1642,75,352,427,427,True
11128,2012-04-13,2,1,4,20,0,5,1,1,0.5,0.4848,0.29,0.1343,44,242,286,286,True
11129,2012-04-13,2,1,4,21,0,5,1,1,0.5,0.4848,0.36,0.0,36,153,189,189,True
11130,2012-04-13,2,1,4,22,0,5,1,1,0.44,0.4394,0.62,0.1045,34,181,215,215,True
11131,2012-04-13,2,1,4,23,0,5,1,1,0.42,0.4242,0.62,0.0896,35,163,198,198,True
11132,2012-04-14,2,1,4,0,0,6,0,1,0.4,0.4091,0.58,0.1343,11,85,96,96,True
11133,2012-04-14,2,1,4,1,0,6,0,1,0.4,0.4091,0.58,0.1343,10,60,70,70,True
11134,2012-04-14,2,1,4,2,0,6,0,1,0.38,0.3939,0.66,0.1343,3,53,56,56,True
11135,2012-04-14,2,1,4,3,0,6,0,1,0.36,0.3636,0.66,0.0896,6,26,32,32,True
11136,2012-04-14,2,1,4,4,0,6,0,1,0.36,0.3636,0.71,0.1045,5,9,14,14,True
11137,2012-04-14,2,1,4,5,0,6,0,1,0.36,0.3636,0.66,0.1045,2,5,7,7,True
11138,2012-04-14,2,1,4,6,0,6,0,1,0.34,0.3333,0.76,0.1642,2,19,21,21,True
11139,2012-04-14,2,1,4,7,0,6,0,1,0.36,0.3636,0.71,0.1045,8,56,64,64,True
11140,2012-04-14,2,1,4,8,0,6,0,1,0.36,0.3485,0.71,0.1343,24,136,160,160,True
11141,2012-04-14,2,1,4,9,0,6,0,1,0.42,0.4242,0.54,0.1343,59,206,265,265,True
11142,2012-04-14,2,1,4,10,0,6,0,1,0.46,0.4545,0.51,0.1642,114,267,381,381,True
11143,2012-04-14,2,1,4,11,0,6,0,1,0.52,0.5,0.45,0.194,114,357,471,471,True
11144,2012-04-14,2,1,4,12,0,6,0,1,0.58,0.5455,0.35,0.2537,114,404,518,518,True
11145,2012-04-14,2,1,4,13,0,6,0,1,0.62,0.6212,0.33,0.2985,114,370,484,484,True
11146,2012-04-14,2,1,4,14,0,6,0,2,0.64,0.6212,0.27,0.4478,114,372,486,486,True
11147,2012-04-14,2,1,4,15,0,6,0,2,0.64,0.6212,0.27,0.3582,114,347,461,461,True
11148,2012-04-14,2,1,4,16,0,6,0,2,0.64,0.6212,0.27,0.3582,114,329,443,443,True
11149,2012-04-14,2,1,4,17,0,6,0,2,0.62,0.6212,0.33,0.2537,114,309,423,423,True
11150,2012-04-14,2,1,4,18,0,6,0,2,0.62,0.6212,0.35,0.2239,114,284,398,398,True
11151,2012-04-14,2,1,4,19,0,6,0,2,0.6,0.6212,0.4,0.1642,114,296,410,410,True
11152,2012-04-14,2,1,4,20,0,6,0,2,0.56,0.5303,0.46,0.1343,112,209,321,321,True
11153,2012-04-14,2,1,4,21,0,6,0,2,0.56,0.5303,0.43,0.1343,53,167,220,220,True
11154,2012-04-14,2,1,4,22,0,6,0,2,0.54,0.5152,0.52,0.1642,64,148,212,212,True
11155,2012-04-14,2,1,4,23,0,6,0,2,0.54,0.5152,0.56,0.194,45,151,196,196,True
11156,2012-04-15,2,1,4,0,0,0,0,2,0.54,0.5152,0.56,0.194,30,94,124,124,True
11157,2012-04-15,2,1,4,1,0,0,0,2,0.54,0.5152,0.56,0.1642,17,89,106,106,True
11158,2012-04-15,2,1,4,2,0,0,0,2,0.54,0.5152,0.56,0.1045,20,54,74,74,True
11159,2012-04-15,2,1,4,3,0,0,0,2,0.52,0.5,0.59,0.1343,18,27,45,45,True
11160,2012-04-15,2,1,4,4,0,0,0,2,0.54,0.5152,0.52,0.0,2,10,12,12,True
11161,2012-04-15,2,1,4,5,0,0,0,1,0.5,0.4848,0.68,0.1642,4,6,10,10,True
11162,2012-04-15,2,1,4,6,0,0,0,1,0.5,0.4848,0.63,0.1343,5,11,16,16,True
11163,2012-04-15,2,1,4,7,0,0,0,1,0.5,0.4848,0.63,0.1045,16,30,46,46,True
11164,2012-04-15,2,1,4,8,0,0,0,1,0.52,0.5,0.59,0.0,33,64,97,97,True
11165,2012-04-15,2,1,4,9,0,0,0,1,0.54,0.5152,0.56,0.2239,97,154,251,251,True
11166,2012-04-15,2,1,4,10,0,0,0,1,0.58,0.5455,0.53,0.2239,114,235,349,349,True
11167,2012-04-15,2,1,4,11,0,0,0,1,0.62,0.6212,0.46,0.2985,114,301,415,415,True
11168,2012-04-15,2,1,4,12,0,0,0,1,0.64,0.6212,0.44,0.2836,114,360,474,474,True
11169,2012-04-15,2,1,4,13,0,0,0,1,0.66,0.6212,0.44,0.2836,114,383,497,497,True
11170,2012-04-15,2,1,4,14,0,0,0,1,0.7,0.6364,0.39,0.2836,114,346,460,460,True
11171,2012-04-15,2,1,4,15,0,0,0,1,0.7,0.6364,0.39,0.3881,114,351,465,465,True
11172,2012-04-15,2,1,4,16,0,0,0,1,0.72,0.6515,0.39,0.3582,114,330,444,444,True
11173,2012-04-15,2,1,4,17,0,0,0,1,0.7,0.6364,0.42,0.3284,114,361,475,475,True
11174,2012-04-15,2,1,4,18,0,0,0,1,0.7,0.6364,0.42,0.2537,114,295,409,409,True
11175,2012-04-15,2,1,4,19,0,0,0,1,0.7,0.6364,0.42,0.2537,114,265,379,379,True
11176,2012-04-15,2,1,4,20,0,0,0,1,0.64,0.6212,0.5,0.2239,86,205,291,291,True
11177,2012-04-15,2,1,4,21,0,0,0,1,0.62,0.6212,0.57,0.2537,76,153,229,229,True
11178,2012-04-15,2,1,4,22,0,0,0,1,0.68,0.6364,0.44,0.3582,37,97,134,134,True
11179,2012-04-15,2,1,4,23,0,0,0,1,0.66,0.6212,0.5,0.3881,25,65,90,90,True
11180,2012-04-16,2,1,4,0,1,1,0,1,0.64,0.6212,0.53,0.3284,15,26,41,41,True
11181,2012-04-16,2,1,4,1,1,1,0,1,0.62,0.6061,0.61,0.3582,7,21,28,28,True
11182,2012-04-16,2,1,4,2,1,1,0,1,0.6,0.6061,0.64,0.2537,5,9,14,14,True
11183,2012-04-16,2,1,4,3,1,1,0,1,0.58,0.5455,0.68,0.194,3,5,8,8,True
11184,2012-04-16,2,1,4,4,1,1,0,1,0.54,0.5152,0.77,0.2239,0,6,6,6,True
11185,2012-04-16,2,1,4,5,1,1,0,1,0.54,0.5152,0.77,0.2239,4,34,38,38,True
11186,2012-04-16,2,1,4,6,1,1,0,1,0.52,0.5,0.83,0.1642,10,123,133,133,True
11187,2012-04-16,2,1,4,7,1,1,0,1,0.52,0.5,0.83,0.1343,20,367,387,387,True
11188,2012-04-16,2,1,4,8,1,1,0,2,0.56,0.5303,0.83,0.1642,48,499,547,547,True
11189,2012-04-16,2,1,4,9,1,1,0,1,0.62,0.6061,0.69,0.2239,59,238,297,297,True
11190,2012-04-16,2,1,4,10,1,1,0,1,0.62,0.6061,0.69,0.2537,75,149,224,224,True
11191,2012-04-16,2,1,4,11,1,1,0,1,0.64,0.6061,0.65,0.2537,114,136,250,250,True
11192,2012-04-16,2,1,4,12,1,1,0,1,0.68,0.6364,0.57,0.2537,75,196,271,271,True
11193,2012-04-16,2,1,4,13,1,1,0,1,0.74,0.6667,0.45,0.2985,79,184,263,263,True
11194,2012-04-16,2,1,4,14,1,1,0,1,0.76,0.6818,0.45,0.3284,105,183,288,288,True
11195,2012-04-16,2,1,4,15,1,1,0,1,0.8,0.697,0.33,0.4478,81,194,275,275,True
11196,2012-04-16,2,1,4,16,1,1,0,1,0.8,0.697,0.33,0.4627,92,266,358,358,True
11197,2012-04-16,2,1,4,17,1,1,0,1,0.8,0.697,0.33,0.3881,111,499,610,610,True
11198,2012-04-16,2,1,4,18,1,1,0,1,0.8,0.697,0.31,0.3881,87,499,586,586,True
11199,2012-04-16,2,1,4,19,1,1,0,1,0.76,0.6667,0.35,0.3881,61,461,522,522,True
11200,2012-04-16,2,1,4,20,1,1,0,1,0.74,0.6515,0.37,0.2985,48,327,375,375,True
11201,2012-04-16,2,1,4,21,1,1,0,1,0.68,0.6364,0.51,0.2537,39,232,271,271,True
11202,2012-04-16,2,1,4,22,1,1,0,1,0.68,0.6364,0.51,0.2537,35,179,214,214,True
11203,2012-04-16,2,1,4,23,1,1,0,1,0.7,0.6364,0.45,0.2985,24,97,121,121,True
11204,2012-04-17,2,1,4,0,0,2,1,1,0.66,0.6212,0.54,0.194,10,33,43,43,True
11205,2012-04-17,2,1,4,1,0,2,1,1,0.64,0.6212,0.57,0.1642,6,5,11,11,True
11206,2012-04-17,2,1,4,2,0,2,1,1,0.56,0.5303,0.83,0.1045,1,3,4,4,True
11207,2012-04-17,2,1,4,3,0,2,1,1,0.56,0.5303,0.83,0.0896,0,6,6,6,True
11208,2012-04-17,2,1,4,4,0,2,1,1,0.66,0.6212,0.44,0.2239,3,6,9,9,True
11209,2012-04-17,2,1,4,5,0,2,1,1,0.6,0.6212,0.53,0.2537,1,29,30,30,True
11210,2012-04-17,2,1,4,6,0,2,1,1,0.6,0.6212,0.46,0.2537,8,136,144,144,True
11211,2012-04-17,2,1,4,7,0,2,1,1,0.6,0.6212,0.43,0.2537,18,443,461,461,True
11212,2012-04-17,2,1,4,8,0,2,1,1,0.6,0.6212,0.43,0.2239,42,499,541,541,True
11213,2012-04-17,2,1,4,9,0,2,1,1,0.6,0.6212,0.38,0.4775,71,329,400,400,True
11214,2012-04-17,2,1,4,10,0,2,1,1,0.6,0.6212,0.38,0.4179,52,165,217,217,True
11215,2012-04-17,2,1,4,11,0,2,1,1,0.6,0.6212,0.33,0.4179,65,174,239,239,True
11216,2012-04-17,2,1,4,12,0,2,1,1,0.6,0.6212,0.33,0.3582,65,179,244,244,True
11217,2012-04-17,2,1,4,13,0,2,1,1,0.62,0.6212,0.29,0.2537,52,187,239,239,True
11218,2012-04-17,2,1,4,14,0,2,1,1,0.64,0.6212,0.27,0.2836,59,198,257,257,True
11219,2012-04-17,2,1,4,15,0,2,1,1,0.66,0.6212,0.24,0.3284,91,217,308,308,True
11220,2012-04-17,2,1,4,16,0,2,1,1,0.68,0.6212,0.22,0.3582,50,320,370,370,True
11221,2012-04-17,2,1,4,17,0,2,1,1,0.64,0.6061,0.25,0.2985,108,499,607,607,True
11222,2012-04-17,2,1,4,18,0,2,1,1,0.64,0.6061,0.25,0.2836,105,499,604,604,True
11223,2012-04-17,2,1,4,19,0,2,1,1,0.6,0.6061,0.26,0.2537,73,464,537,537,True
11224,2012-04-17,2,1,4,20,0,2,1,1,0.6,0.6061,0.23,0.2836,44,358,402,402,True
11225,2012-04-17,2,1,4,21,0,2,1,1,0.56,0.5303,0.26,0.2985,37,260,297,297,True
11226,2012-04-17,2,1,4,22,0,2,1,1,0.54,0.5152,0.3,0.2537,18,144,162,162,True
11227,2012-04-17,2,1,4,23,0,2,1,1,0.54,0.5152,0.32,0.2239,10,72,82,82,True
11228,2012-04-18,2,1,4,0,0,3,1,1,0.54,0.5152,0.32,0.1642,3,35,38,38,True
11229,2012-04-18,2,1,4,1,0,3,1,1,0.52,0.5,0.34,0.194,1,13,14,14,True
11230,2012-04-18,2,1,4,2,0,3,1,2,0.5,0.4848,0.42,0.194,1,8,9,9,True
11231,2012-04-18,2,1,4,3,0,3,1,2,0.5,0.4848,0.42,0.2239,0,6,6,6,True
11232,2012-04-18,2,1,4,4,0,3,1,2,0.5,0.4848,0.42,0.2836,0,7,7,7,True
11233,2012-04-18,2,1,4,5,0,3,1,2,0.5,0.4848,0.39,0.2836,0,34,34,34,True
11234,2012-04-18,2,1,4,6,0,3,1,2,0.5,0.4848,0.39,0.2836,6,128,134,134,True
11235,2012-04-18,2,1,4,7,0,3,1,2,0.5,0.4848,0.39,0.194,10,408,418,418,True
11236,2012-04-18,2,1,4,8,0,3,1,3,0.5,0.4848,0.39,0.194,25,499,524,524,True
11237,2012-04-18,2,1,4,9,0,3,1,3,0.48,0.4697,0.44,0.2985,20,245,265,265,True
11238,2012-04-18,2,1,4,10,0,3,1,3,0.48,0.4697,0.47,0.2239,31,116,147,147,True
11239,2012-04-18,2,1,4,11,0,3,1,3,0.46,0.4545,0.47,0.2537,14,105,119,119,True
11240,2012-04-18,2,1,4,12,0,3,1,3,0.46,0.4545,0.51,0.1045,15,95,110,110,True
11241,2012-04-18,2,1,4,13,0,3,1,3,0.46,0.4545,0.59,0.0,13,51,64,64,True
11242,2012-04-18,2,1,4,14,0,3,1,3,0.44,0.4394,0.72,0.1045,8,43,51,51,True
11243,2012-04-18,2,1,4,15,0,3,1,3,0.42,0.4242,0.77,0.194,10,88,98,98,True
11244,2012-04-18,2,1,4,16,0,3,1,2,0.42,0.4242,0.77,0.2239,36,199,235,235,True
11245,2012-04-18,2,1,4,17,0,3,1,2,0.42,0.4242,0.77,0.194,46,442,488,488,True
11246,2012-04-18,2,1,4,18,0,3,1,2,0.42,0.4242,0.77,0.0,27,478,505,505,True
11247,2012-04-18,2,1,4,19,0,3,1,2,0.42,0.4242,0.77,0.1343,26,342,368,368,True
11248,2012-04-18,2,1,4,20,0,3,1,2,0.42,0.4242,0.77,0.1045,8,252,260,260,True
11249,2012-04-18,2,1,4,21,0,3,1,2,0.42,0.4242,0.82,0.0896,24,165,189,189,True
11250,2012-04-18,2,1,4,22,0,3,1,2,0.42,0.4242,0.77,0.0896,9,153,162,162,True
11251,2012-04-18,2,1,4,23,0,3,1,2,0.42,0.4242,0.77,0.0,14,56,70,70,True
11252,2012-04-19,2,1,4,0,0,4,1,3,0.42,0.4242,0.77,0.0,5,20,25,25,True
11253,2012-04-19,2,1,4,1,0,4,1,3,0.42,0.4242,0.77,0.1045,2,11,13,13,True
11254,2012-04-19,2,1,4,2,0,4,1,2,0.42,0.4242,0.77,0.0,2,4,6,6,True
11255,2012-04-19,2,1,4,3,0,4,1,2,0.42,0.4242,0.77,0.0,1,3,4,4,True
11256,2012-04-19,2,1,4,4,0,4,1,2,0.42,0.4242,0.71,0.0,0,4,4,4,True
11257,2012-04-19,2,1,4,5,0,4,1,1,0.4,0.4091,0.82,0.0,0,30,30,30,True
11258,2012-04-19,2,1,4,6,0,4,1,2,0.4,0.4091,0.82,0.1045,4,116,120,120,True
11259,2012-04-19,2,1,4,7,0,4,1,2,0.4,0.4091,0.82,0.1343,15,391,406,406,True
11260,2012-04-19,2,1,4,8,0,4,1,2,0.42,0.4242,0.82,0.1045,26,499,525,525,True
11261,2012-04-19,2,1,4,9,0,4,1,2,0.46,0.4545,0.72,0.0,31,270,301,301,True
11262,2012-04-19,2,1,4,10,0,4,1,1,0.48,0.4697,0.63,0.0896,46,143,189,189,True
11263,2012-04-19,2,1,4,11,0,4,1,1,0.52,0.5,0.48,0.0,46,183,229,229,True
11264,2012-04-19,2,1,4,12,0,4,1,1,0.54,0.5152,0.49,0.0,51,213,264,264,True
11265,2012-04-19,2,1,4,13,0,4,1,1,0.56,0.5303,0.46,0.0,52,186,238,238,True
11266,2012-04-19,2,1,4,14,0,4,1,1,0.58,0.5455,0.43,0.0,54,183,237,237,True
11267,2012-04-19,2,1,4,15,0,4,1,1,0.6,0.6212,0.43,0.0,66,196,262,262,True
11268,2012-04-19,2,1,4,16,0,4,1,1,0.62,0.6212,0.41,0.1045,63,324,387,387,True
11269,2012-04-19,2,1,4,17,0,4,1,1,0.6,0.6212,0.43,0.0896,85,499,584,584,True
11270,2012-04-19,2,1,4,18,0,4,1,1,0.6,0.6212,0.43,0.0896,99,499,598,598,True
11271,2012-04-19,2,1,4,19,0,4,1,1,0.58,0.5455,0.46,0.1343,70,499,569,569,True
11272,2012-04-19,2,1,4,20,0,4,1,1,0.56,0.5303,0.49,0.2239,52,352,404,404,True
11273,2012-04-19,2,1,4,21,0,4,1,1,0.52,0.5,0.55,0.1045,27,240,267,267,True
11274,2012-04-19,2,1,4,22,0,4,1,1,0.52,0.5,0.59,0.194,29,219,248,248,True
11275,2012-04-19,2,1,4,23,0,4,1,1,0.5,0.4848,0.63,0.1045,20,124,144,144,True
11276,2012-04-20,2,1,4,0,0,5,1,1,0.48,0.4697,0.67,0.1045,5,59,64,64,True
11277,2012-04-20,2,1,4,1,0,5,1,1,0.46,0.4545,0.82,0.194,3,22,25,25,True
11278,2012-04-20,2,1,4,2,0,5,1,1,0.44,0.4394,0.88,0.194,3,18,21,21,True
11279,2012-04-20,2,1,4,3,0,5,1,1,0.44,0.4394,0.88,0.1045,1,9,10,10,True
11280,2012-04-20,2,1,4,4,0,5,1,1,0.42,0.4242,0.94,0.1045,0,3,3,3,True
11281,2012-04-20,2,1,4,5,0,5,1,1,0.42,0.4242,0.94,0.0,1,24,25,25,True
11282,2012-04-20,2,1,4,6,0,5,1,1,0.42,0.4242,0.88,0.0,8,105,113,113,True
11283,2012-04-20,2,1,4,7,0,5,1,1,0.42,0.4242,0.94,0.0,9,350,359,359,True
11284,2012-04-20,2,1,4,8,0,5,1,1,0.44,0.4394,0.94,0.0,32,499,531,531,True
11285,2012-04-20,2,1,4,9,0,5,1,1,0.46,0.4545,0.88,0.0896,30,329,359,359,True
11286,2012-04-20,2,1,4,10,0,5,1,1,0.5,0.4848,0.77,0.194,67,170,237,237,True
11287,2012-04-20,2,1,4,11,0,5,1,1,0.54,0.5152,0.68,0.1642,64,190,254,254,True
11288,2012-04-20,2,1,4,12,0,5,1,1,0.58,0.5455,0.53,0.194,102,260,362,362,True
11289,2012-04-20,2,1,4,13,0,5,1,1,0.62,0.6212,0.43,0.194,105,276,381,381,True
11290,2012-04-20,2,1,4,14,0,5,1,1,0.64,0.6212,0.44,0.2239,114,238,352,352,True
11291,2012-04-20,2,1,4,15,0,5,1,1,0.64,0.6212,0.47,0.194,114,262,376,376,True
11292,2012-04-20,2,1,4,16,0,5,1,1,0.66,0.6212,0.44,0.194,114,429,543,543,True
11293,2012-04-20,2,1,4,17,0,5,1,1,0.64,0.6212,0.47,0.2836,114,499,613,613,True
11294,2012-04-20,2,1,4,18,0,5,1,1,0.62,0.6212,0.5,0.2836,110,499,609,609,True
11295,2012-04-20,2,1,4,19,0,5,1,1,0.6,0.6212,0.53,0.194,82,410,492,492,True
11296,2012-04-20,2,1,4,20,0,5,1,1,0.58,0.5455,0.56,0.1642,52,289,341,341,True
11297,2012-04-20,2,1,4,21,0,5,1,1,0.56,0.5303,0.68,0.1343,35,252,287,287,True
11298,2012-04-20,2,1,4,22,0,5,1,1,0.54,0.5152,0.68,0.2537,26,176,202,202,True
11299,2012-04-20,2,1,4,23,0,5,1,1,0.52,0.5,0.72,0.1343,31,156,187,187,True
11300,2012-04-21,2,1,4,0,0,6,0,1,0.52,0.5,0.77,0.2239,31,111,142,142,True
11301,2012-04-21,2,1,4,1,0,6,0,1,0.52,0.5,0.77,0.2239,24,64,88,88,True
11302,2012-04-21,2,1,4,2,0,6,0,1,0.52,0.5,0.77,0.1343,12,69,81,81,True
11303,2012-04-21,2,1,4,3,0,6,0,1,0.5,0.4848,0.82,0.2239,4,25,29,29,True
11304,2012-04-21,2,1,4,4,0,6,0,1,0.5,0.4848,0.82,0.2537,0,9,9,9,True
11305,2012-04-21,2,1,4,5,0,6,0,1,0.5,0.4848,0.82,0.2537,0,1,1,1,True
11306,2012-04-21,2,1,4,6,0,6,0,1,0.5,0.4848,0.82,0.2239,10,21,31,31,True
11307,2012-04-21,2,1,4,7,0,6,0,1,0.5,0.4848,0.82,0.2836,21,55,76,76,True
11308,2012-04-21,2,1,4,8,0,6,0,1,0.52,0.5,0.81,0.2537,52,149,201,201,True
11309,2012-04-21,2,1,4,9,0,6,0,1,0.54,0.5152,0.77,0.1642,114,216,330,330,True
11310,2012-04-21,2,1,4,10,0,6,0,1,0.6,0.6061,0.64,0.2836,114,299,413,413,True
11311,2012-04-21,2,1,4,11,0,6,0,1,0.62,0.6061,0.61,0.3284,114,348,462,462,True
11312,2012-04-21,2,1,4,12,0,6,0,1,0.64,0.6212,0.57,0.2239,114,378,492,492,True
11313,2012-04-21,2,1,4,13,0,6,0,1,0.66,0.6212,0.54,0.2239,114,358,472,472,True
11314,2012-04-21,2,1,4,14,0,6,0,1,0.7,0.6364,0.45,0.2836,114,331,445,445,True
11315,2012-04-21,2,1,4,15,0,6,0,1,0.72,0.6515,0.39,0.2537,114,361,475,475,True
11316,2012-04-21,2,1,4,16,0,6,0,1,0.7,0.6364,0.42,0.3284,114,372,486,486,True
11317,2012-04-21,2,1,4,17,0,6,0,2,0.74,0.6515,0.3,0.3881,114,309,423,423,True
11318,2012-04-21,2,1,4,18,0,6,0,2,0.68,0.6364,0.47,0.4775,114,283,397,397,True
11319,2012-04-21,2,1,4,19,0,6,0,3,0.56,0.5303,0.73,0.4775,9,45,54,54,True
11320,2012-04-21,2,1,4,20,0,6,0,3,0.5,0.4848,0.82,0.2985,5,34,39,39,True
11321,2012-04-21,2,1,4,21,0,6,0,3,0.5,0.4848,0.82,0.3881,20,82,102,102,True
11322,2012-04-21,2,1,4,22,0,6,0,1,0.48,0.4697,0.82,0.2985,20,90,110,110,True
11323,2012-04-21,2,1,4,23,0,6,0,2,0.46,0.4545,0.82,0.2836,18,73,91,91,True
11324,2012-04-22,2,1,4,0,0,0,0,2,0.46,0.4545,0.82,0.194,32,85,117,117,True
11325,2012-04-22,2,1,4,1,0,0,0,2,0.46,0.4545,0.82,0.3284,10,63,73,73,True
11326,2012-04-22,2,1,4,2,0,0,0,1,0.46,0.4545,0.72,0.2836,7,49,56,56,True
11327,2012-04-22,2,1,4,3,0,0,0,2,0.44,0.4394,0.82,0.1642,7,33,40,40,True
11328,2012-04-22,2,1,4,4,0,0,0,2,0.44,0.4394,0.77,0.1642,0,7,7,7,True
11329,2012-04-22,2,1,4,5,0,0,0,2,0.44,0.4394,0.77,0.2239,0,6,6,6,True
11330,2012-04-22,2,1,4,6,0,0,0,2,0.44,0.4394,0.72,0.3284,6,6,12,12,True
11331,2012-04-22,2,1,4,7,0,0,0,3,0.42,0.4242,0.77,0.3881,2,22,24,24,True
11332,2012-04-22,2,1,4,8,0,0,0,3,0.4,0.4091,0.82,0.2537,8,43,51,51,True
11333,2012-04-22,2,1,4,9,0,0,0,3,0.4,0.4091,0.82,0.2537,8,71,79,79,True
11334,2012-04-22,2,1,4,10,0,0,0,3,0.38,0.3939,0.82,0.3284,11,57,68,68,True
11335,2012-04-22,2,1,4,11,0,0,0,3,0.38,0.3939,0.87,0.2985,7,70,77,77,True
11336,2012-04-22,2,1,4,12,0,0,0,3,0.38,0.3939,0.87,0.3284,5,56,61,61,True
11337,2012-04-22,2,1,4,13,0,0,0,3,0.38,0.3939,0.82,0.3582,5,47,52,52,True
11338,2012-04-22,2,1,4,14,0,0,0,3,0.38,0.3939,0.87,0.3284,3,50,53,53,True
11339,2012-04-22,2,1,4,15,0,0,0,3,0.38,0.3939,0.87,0.3881,0,38,38,38,True
11340,2012-04-22,2,1,4,16,0,0,0,3,0.38,0.3939,0.87,0.4478,4,32,36,36,True
11341,2012-04-22,2,1,4,17,0,0,0,3,0.36,0.3182,0.93,0.4478,2,25,27,27,True
11342,2012-04-22,2,1,4,18,0,0,0,3,0.36,0.3182,0.93,0.4478,1,38,39,39,True
11343,2012-04-22,2,1,4,19,0,0,0,3,0.36,0.3182,0.87,0.4775,1,34,35,35,True
11344,2012-04-22,2,1,4,20,0,0,0,3,0.36,0.3333,0.93,0.4179,1,34,35,35,True
11345,2012-04-22,2,1,4,21,0,0,0,3,0.36,0.3333,0.87,0.3881,0,11,11,11,True
11346,2012-04-22,2,1,4,22,0,0,0,3,0.34,0.2879,0.87,0.4775,0,13,13,13,True
11347,2012-04-22,2,1,4,23,0,0,0,3,0.36,0.3182,0.81,0.4627,0,17,17,17,True
11348,2012-04-23,2,1,4,0,0,1,1,3,0.36,0.3333,0.81,0.4179,0,6,6,6,True
11349,2012-04-23,2,1,4,1,0,1,1,3,0.34,0.303,0.87,0.3582,1,1,2,2,True
11350,2012-04-23,2,1,4,2,0,1,1,2,0.32,0.303,0.87,0.3284,1,3,4,4,True
11351,2012-04-23,2,1,4,3,0,1,1,2,0.32,0.303,0.81,0.2836,0,1,1,1,True
11352,2012-04-23,2,1,4,4,0,1,1,3,0.3,0.2879,0.81,0.2836,0,3,3,3,True
11353,2012-04-23,2,1,4,5,0,1,1,3,0.3,0.2879,0.81,0.2836,0,14,14,14,True
11354,2012-04-23,2,1,4,6,0,1,1,2,0.3,0.2727,0.81,0.2985,2,43,45,45,True
11355,2012-04-23,2,1,4,7,0,1,1,3,0.3,0.2879,0.81,0.2537,1,206,207,207,True
11356,2012-04-23,2,1,4,8,0,1,1,2,0.3,0.2727,0.75,0.3284,11,471,482,482,True
11357,2012-04-23,2,1,4,9,0,1,1,2,0.3,0.2727,0.75,0.3881,17,255,272,272,True
11358,2012-04-23,2,1,4,10,0,1,1,2,0.32,0.303,0.7,0.3284,12,88,100,100,True
11359,2012-04-23,2,1,4,11,0,1,1,2,0.32,0.2879,0.7,0.3582,10,91,101,101,True
11360,2012-04-23,2,1,4,12,0,1,1,3,0.34,0.303,0.71,0.3582,12,117,129,129,True
11361,2012-04-23,2,1,4,13,0,1,1,3,0.34,0.303,0.66,0.3881,9,98,107,107,True
11362,2012-04-23,2,1,4,14,0,1,1,3,0.36,0.3182,0.62,0.4478,12,102,114,114,True
11363,2012-04-23,2,1,4,15,0,1,1,2,0.36,0.3333,0.62,0.3881,11,101,112,112,True
11364,2012-04-23,2,1,4,16,0,1,1,3,0.3,0.2727,0.81,0.3582,10,93,103,103,True
11365,2012-04-23,2,1,4,17,0,1,1,3,0.3,0.2727,0.82,0.3284,13,219,232,232,True
11366,2012-04-23,2,1,4,18,0,1,1,3,0.32,0.3333,0.81,0.1343,10,369,379,379,True
11367,2012-04-23,2,1,4,19,0,1,1,2,0.34,0.3182,0.76,0.2239,11,287,298,298,True
11368,2012-04-23,2,1,4,20,0,1,1,2,0.32,0.3182,0.76,0.1642,17,186,203,203,True
11369,2012-04-23,2,1,4,21,0,1,1,2,0.32,0.303,0.81,0.2239,7,145,152,152,True
11370,2012-04-23,2,1,4,22,0,1,1,1,0.32,0.3182,0.76,0.194,18,71,89,89,True
11371,2012-04-23,2,1,4,23,0,1,1,1,0.32,0.3182,0.76,0.1642,10,49,59,59,True
11372,2012-04-24,2,1,4,0,0,2,1,2,0.32,0.3333,0.76,0.1343,0,13,13,13,True
11373,2012-04-24,2,1,4,1,0,2,1,2,0.32,0.3333,0.81,0.1343,1,6,7,7,True
11374,2012-04-24,2,1,4,2,0,2,1,1,0.32,0.3182,0.81,0.194,0,3,3,3,True
11375,2012-04-24,2,1,4,3,0,2,1,1,0.32,0.303,0.81,0.2239,0,2,2,2,True
11376,2012-04-24,2,1,4,4,0,2,1,1,0.3,0.2879,0.7,0.194,0,3,3,3,True
11377,2012-04-24,2,1,4,5,0,2,1,1,0.3,0.2879,0.7,0.194,0,22,22,22,True
11378,2012-04-24,2,1,4,6,0,2,1,1,0.3,0.2879,0.7,0.2239,3,117,120,120,True
11379,2012-04-24,2,1,4,7,0,2,1,1,0.32,0.303,0.66,0.2836,3,387,390,390,True
11380,2012-04-24,2,1,4,8,0,2,1,1,0.34,0.3182,0.61,0.2537,12,499,511,511,True
11381,2012-04-24,2,1,4,9,0,2,1,1,0.4,0.4091,0.47,0.3582,6,302,308,308,True
11382,2012-04-24,2,1,4,10,0,2,1,1,0.42,0.4242,0.47,0.2985,33,129,162,162,True
11383,2012-04-24,2,1,4,11,0,2,1,1,0.46,0.4545,0.31,0.3881,27,157,184,184,True
11384,2012-04-24,2,1,4,12,0,2,1,1,0.48,0.4697,0.29,0.3881,36,188,224,224,True
11385,2012-04-24,2,1,4,13,0,2,1,1,0.5,0.4848,0.29,0.3881,35,189,224,224,True
11386,2012-04-24,2,1,4,14,0,2,1,1,0.5,0.4848,0.25,0.3881,50,166,216,216,True
11387,2012-04-24,2,1,4,15,0,2,1,1,0.5,0.4848,0.23,0.4179,60,176,236,236,True
11388,2012-04-24,2,1,4,16,0,2,1,1,0.5,0.4848,0.23,0.194,54,308,362,362,True
11389,2012-04-24,2,1,4,17,0,2,1,1,0.52,0.5,0.22,0.3881,72,499,571,571,True
11390,2012-04-24,2,1,4,18,0,2,1,1,0.5,0.4848,0.18,0.0,52,499,551,551,True
11391,2012-04-24,2,1,4,19,0,2,1,1,0.5,0.4848,0.18,0.2537,33,449,482,482,True
11392,2012-04-24,2,1,4,20,0,2,1,1,0.48,0.4697,0.21,0.3284,16,269,285,285,True
11393,2012-04-24,2,1,4,21,0,2,1,2,0.46,0.4545,0.28,0.1642,13,213,226,226,True
11394,2012-04-24,2,1,4,22,0,2,1,1,0.44,0.4394,0.35,0.1045,8,149,157,157,True
11395,2012-04-24,2,1,4,23,0,2,1,1,0.42,0.4242,0.38,0.0896,4,69,73,73,True
11396,2012-04-25,2,1,4,0,0,3,1,1,0.44,0.4394,0.38,0.0,13,23,36,36,True
11397,2012-04-25,2,1,4,1,0,3,1,1,0.42,0.4242,0.41,0.0,8,17,25,25,True
11398,2012-04-25,2,1,4,2,0,3,1,1,0.36,0.3788,0.62,0.0,1,6,7,7,True
11399,2012-04-25,2,1,4,3,0,3,1,1,0.32,0.3333,0.7,0.0896,0,3,3,3,True
11400,2012-04-25,2,1,4,4,0,3,1,1,0.34,0.3485,0.66,0.0896,0,6,6,6,True
11401,2012-04-25,2,1,4,5,0,3,1,1,0.34,0.3636,0.66,0.0,0,24,24,24,True
11402,2012-04-25,2,1,4,6,0,3,1,1,0.34,0.3636,0.66,0.0,3,103,106,106,True
11403,2012-04-25,2,1,4,7,0,3,1,1,0.34,0.3636,0.71,0.0,13,376,389,389,True
11404,2012-04-25,2,1,4,8,0,3,1,1,0.36,0.3636,0.76,0.0896,20,499,519,519,True
11405,2012-04-25,2,1,4,9,0,3,1,1,0.42,0.4242,0.54,0.0,33,288,321,321,True
11406,2012-04-25,2,1,4,10,0,3,1,1,0.52,0.5,0.34,0.0,44,138,182,182,True
11407,2012-04-25,2,1,4,11,0,3,1,1,0.52,0.5,0.32,0.1343,42,177,219,219,True
11408,2012-04-25,2,1,4,12,0,3,1,1,0.54,0.5152,0.28,0.2836,49,220,269,269,True
11409,2012-04-25,2,1,4,13,0,3,1,1,0.56,0.5303,0.26,0.2239,35,193,228,228,True
11410,2012-04-25,2,1,4,14,0,3,1,1,0.56,0.5303,0.22,0.3582,47,176,223,223,True
11411,2012-04-25,2,1,4,15,0,3,1,1,0.58,0.5455,0.19,0.1642,47,182,229,229,True
11412,2012-04-25,2,1,4,16,0,3,1,1,0.6,0.5909,0.2,0.3284,49,327,376,376,True
11413,2012-04-25,2,1,4,17,0,3,1,1,0.6,0.5909,0.2,0.2985,68,499,567,567,True
11414,2012-04-25,2,1,4,18,0,3,1,1,0.6,0.5909,0.2,0.2836,60,499,559,559,True
11415,2012-04-25,2,1,4,19,0,3,1,1,0.6,0.5909,0.2,0.194,42,499,541,541,True
11416,2012-04-25,2,1,4,20,0,3,1,1,0.56,0.5303,0.22,0.0896,22,358,380,380,True
11417,2012-04-25,2,1,4,21,0,3,1,1,0.52,0.5,0.52,0.1343,27,212,239,239,True
11418,2012-04-25,2,1,4,22,0,3,1,1,0.5,0.4848,0.51,0.0,22,170,192,192,True
11419,2012-04-25,2,1,4,23,0,3,1,2,0.5,0.4848,0.51,0.0896,10,94,104,104,True
11420,2012-04-26,2,1,4,0,0,4,1,2,0.48,0.4697,0.63,0.0,1,42,43,43,True
11421,2012-04-26,2,1,4,1,0,4,1,2,0.48,0.4697,0.48,0.0896,1,22,23,23,True
11422,2012-04-26,2,1,4,2,0,4,1,2,0.48,0.4697,0.55,0.1045,3,10,13,13,True
11423,2012-04-26,2,1,4,3,0,4,1,2,0.48,0.4697,0.55,0.0896,1,5,6,6,True
11424,2012-04-26,2,1,4,4,0,4,1,2,0.48,0.4697,0.59,0.0896,1,2,3,3,True
11425,2012-04-26,2,1,4,5,0,4,1,2,0.48,0.4697,0.63,0.1343,0,17,17,17,True
11426,2012-04-26,2,1,4,6,0,4,1,2,0.48,0.4697,0.63,0.2537,5,122,127,127,True
11427,2012-04-26,2,1,4,7,0,4,1,3,0.46,0.4545,0.82,0.3582,3,222,225,225,True
11428,2012-04-26,2,1,4,8,0,4,1,3,0.46,0.4545,0.82,0.194,4,358,362,362,True
11429,2012-04-26,2,1,4,9,0,4,1,3,0.46,0.4545,0.88,0.1642,12,189,201,201,True
11430,2012-04-26,2,1,4,10,0,4,1,2,0.46,0.4545,0.94,0.1642,14,125,139,139,True
11431,2012-04-26,2,1,4,11,0,4,1,2,0.46,0.4545,0.94,0.2239,16,135,151,151,True
11432,2012-04-26,2,1,4,12,0,4,1,2,0.52,0.5,0.83,0.1343,24,180,204,204,True
11433,2012-04-26,2,1,4,13,0,4,1,2,0.5,0.4848,0.82,0.1642,19,178,197,197,True
11434,2012-04-26,2,1,4,14,0,4,1,2,0.54,0.5152,0.77,0.194,37,132,169,169,True
11435,2012-04-26,2,1,4,15,0,4,1,2,0.52,0.5,0.83,0.3284,39,165,204,204,True
11436,2012-04-26,2,1,4,16,0,4,1,2,0.52,0.5,0.83,0.2239,37,281,318,318,True
11437,2012-04-26,2,1,4,17,0,4,1,1,0.54,0.5152,0.77,0.1642,49,499,548,548,True
11438,2012-04-26,2,1,4,18,0,4,1,2,0.54,0.5152,0.77,0.194,75,499,574,574,True
11439,2012-04-26,2,1,4,19,0,4,1,2,0.54,0.5152,0.77,0.2239,57,407,464,464,True
11440,2012-04-26,2,1,4,20,0,4,1,1,0.54,0.5152,0.77,0.194,23,314,337,337,True
11441,2012-04-26,2,1,4,21,0,4,1,1,0.52,0.5,0.83,0.2239,28,222,250,250,True
11442,2012-04-26,2,1,4,22,0,4,1,1,0.52,0.5,0.83,0.1642,20,163,183,183,True
11443,2012-04-26,2,1,4,23,0,4,1,1,0.5,0.4848,0.88,0.1642,6,106,112,112,True
11444,2012-04-27,2,1,4,0,0,5,1,1,0.54,0.5152,0.68,0.4775,12,61,73,73,True
11445,2012-04-27,2,1,4,1,0,5,1,1,0.5,0.4848,0.59,0.4478,3,32,35,35,True
11446,2012-04-27,2,1,4,2,0,5,1,1,0.48,0.4697,0.59,0.4179,4,18,22,22,True
11447,2012-04-27,2,1,4,3,0,5,1,1,0.44,0.4394,0.47,0.4775,1,2,3,3,True
11448,2012-04-27,2,1,4,4,0,5,1,1,0.42,0.4242,0.44,0.2537,0,6,6,6,True
11449,2012-04-27,2,1,4,5,0,5,1,1,0.42,0.4242,0.44,0.3582,0,19,19,19,True
11450,2012-04-27,2,1,4,6,0,5,1,1,0.4,0.4091,0.43,0.2537,5,115,120,120,True
11451,2012-04-27,2,1,4,7,0,5,1,1,0.38,0.3939,0.5,0.2836,10,305,315,315,True
11452,2012-04-27,2,1,4,8,0,5,1,1,0.4,0.4091,0.5,0.0,17,499,516,516,True
11453,2012-04-27,2,1,4,9,0,5,1,1,0.42,0.4242,0.44,0.4775,42,292,334,334,True
11454,2012-04-27,2,1,4,10,0,5,1,1,0.44,0.4394,0.38,0.4179,64,172,236,236,True
11455,2012-04-27,2,1,4,11,0,5,1,1,0.44,0.4394,0.38,0.3284,47,186,233,233,True
11456,2012-04-27,2,1,4,12,0,5,1,1,0.46,0.4545,0.36,0.3582,63,244,307,307,True
11457,2012-04-27,2,1,4,13,0,5,1,1,0.46,0.4545,0.33,0.3881,94,212,306,306,True
11458,2012-04-27,2,1,4,14,0,5,1,1,0.46,0.4545,0.33,0.3284,94,206,300,300,True
11459,2012-04-27,2,1,4,15,0,5,1,1,0.52,0.5,0.29,0.4775,101,223,324,324,True
11460,2012-04-27,2,1,4,16,0,5,1,1,0.52,0.5,0.29,0.2537,105,335,440,440,True
11461,2012-04-27,2,1,4,17,0,5,1,1,0.54,0.5152,0.24,0.3881,89,499,588,588,True
11462,2012-04-27,2,1,4,18,0,5,1,1,0.52,0.5,0.25,0.3582,94,499,593,593,True
11463,2012-04-27,2,1,4,19,0,5,1,1,0.5,0.4848,0.27,0.3881,62,379,441,441,True
11464,2012-04-27,2,1,4,20,0,5,1,1,0.46,0.4545,0.31,0.2836,49,240,289,289,True
11465,2012-04-27,2,1,4,21,0,5,1,1,0.44,0.4394,0.33,0.2985,23,185,208,208,True
11466,2012-04-27,2,1,4,22,0,5,1,1,0.42,0.4242,0.38,0.2537,24,134,158,158,True
11467,2012-04-27,2,1,4,23,0,5,1,1,0.4,0.4091,0.4,0.2537,11,105,116,116,True
11468,2012-04-28,2,1,4,0,0,6,0,1,0.38,0.3939,0.43,0.1642,4,99,103,103,True
11469,2012-04-28,2,1,4,1,0,6,0,1,0.36,0.3333,0.5,0.2985,7,60,67,67,True
11470,2012-04-28,2,1,4,2,0,6,0,1,0.36,0.3485,0.43,0.1642,8,49,57,57,True
11471,2012-04-28,2,1,4,3,0,6,0,1,0.34,0.3182,0.49,0.2239,3,23,26,26,True
11472,2012-04-28,2,1,4,4,0,6,0,1,0.34,0.3333,0.49,0.1642,0,2,2,2,True
11473,2012-04-28,2,1,4,5,0,6,0,1,0.34,0.3333,0.46,0.1343,2,3,5,5,True
11474,2012-04-28,2,1,4,6,0,6,0,1,0.34,0.3333,0.49,0.194,10,18,28,28,True
11475,2012-04-28,2,1,4,7,0,6,0,1,0.34,0.3333,0.49,0.1642,10,45,55,55,True
11476,2012-04-28,2,1,4,8,0,6,0,1,0.38,0.3939,0.4,0.1343,24,134,158,158,True
11477,2012-04-28,2,1,4,9,0,6,0,2,0.38,0.3939,0.37,0.0,45,169,214,214,True
11478,2012-04-28,2,1,4,10,0,6,0,2,0.38,0.3939,0.4,0.1642,60,231,291,291,True
11479,2012-04-28,2,1,4,11,0,6,0,2,0.38,0.3939,0.4,0.1045,96,262,358,358,True
11480,2012-04-28,2,1,4,12,0,6,0,2,0.38,0.3939,0.43,0.0,105,276,381,381,True
11481,2012-04-28,2,1,4,13,0,6,0,2,0.4,0.4091,0.37,0.0,114,269,383,383,True
11482,2012-04-28,2,1,4,14,0,6,0,1,0.42,0.4242,0.38,0.1045,114,293,407,407,True
11483,2012-04-28,2,1,4,15,0,6,0,1,0.42,0.4242,0.41,0.2239,114,260,374,374,True
11484,2012-04-28,2,1,4,16,0,6,0,2,0.44,0.4394,0.38,0.194,114,244,358,358,True
11485,2012-04-28,2,1,4,17,0,6,0,2,0.42,0.4242,0.41,0.1343,98,224,322,322,True
11486,2012-04-28,2,1,4,18,0,6,0,3,0.4,0.4091,0.47,0.0,17,73,90,90,True
11487,2012-04-28,2,1,4,19,0,6,0,3,0.36,0.3485,0.71,0.1343,29,110,139,139,True
11488,2012-04-28,2,1,4,20,0,6,0,2,0.38,0.3939,0.66,0.0,21,81,102,102,True
11489,2012-04-28,2,1,4,21,0,6,0,3,0.36,0.3485,0.71,0.194,12,72,84,84,True
11490,2012-04-28,2,1,4,22,0,6,0,2,0.36,0.3485,0.71,0.1343,17,66,83,83,True
11491,2012-04-28,2,1,4,23,0,6,0,2,0.38,0.3939,0.76,0.0896,5,37,42,42,True
11492,2012-04-29,2,1,4,0,0,0,0,3,0.36,0.3485,0.81,0.1343,0,36,36,36,True
11493,2012-04-29,2,1,4,1,0,0,0,2,0.36,0.3485,0.81,0.1343,5,37,42,42,True
11494,2012-04-29,2,1,4,2,0,0,0,2,0.36,0.3636,0.87,0.1045,4,36,40,40,True
11495,2012-04-29,2,1,4,3,0,0,0,2,0.36,0.3485,0.87,0.194,2,14,16,16,True
11496,2012-04-29,2,1,4,4,0,0,0,2,0.36,0.3485,0.87,0.1343,0,4,4,4,True
11497,2012-04-29,2,1,4,5,0,0,0,1,0.34,0.3636,0.87,0.0,0,6,6,6,True
11498,2012-04-29,2,1,4,6,0,0,0,1,0.34,0.3333,0.87,0.1343,1,6,7,7,True
11499,2012-04-29,2,1,4,7,0,0,0,2,0.34,0.3333,0.87,0.1343,7,20,27,27,True
11500,2012-04-29,2,1,4,8,0,0,0,1,0.38,0.3939,0.76,0.1343,26,81,107,107,True
11501,2012-04-29,2,1,4,9,0,0,0,1,0.4,0.4091,0.71,0.1343,52,133,185,185,True
11502,2012-04-29,2,1,4,10,0,0,0,1,0.42,0.4242,0.67,0.0896,114,253,367,367,True
11503,2012-04-29,2,1,4,11,0,0,0,1,0.46,0.4545,0.51,0.0,114,283,397,397,True
11504,2012-04-29,2,1,4,12,0,0,0,1,0.48,0.4697,0.44,0.1045,114,361,475,475,True
11505,2012-04-29,2,1,4,13,0,0,0,1,0.5,0.4848,0.45,0.1045,114,369,483,483,True
11506,2012-04-29,2,1,4,14,0,0,0,1,0.54,0.5152,0.34,0.0,114,372,486,486,True
11507,2012-04-29,2,1,4,15,0,0,0,1,0.56,0.5303,0.37,0.1343,114,324,438,438,True
11508,2012-04-29,2,1,4,16,0,0,0,1,0.6,0.6061,0.28,0.194,114,347,461,461,True
11509,2012-04-29,2,1,4,17,0,0,0,1,0.62,0.6061,0.27,0.2985,114,334,448,448,True
11510,2012-04-29,2,1,4,18,0,0,0,1,0.6,0.6061,0.26,0.2836,114,323,437,437,True
11511,2012-04-29,2,1,4,19,0,0,0,1,0.56,0.5303,0.35,0.1343,114,247,361,361,True
11512,2012-04-29,2,1,4,20,0,0,0,1,0.56,0.5303,0.32,0.0896,45,198,243,243,True
11513,2012-04-29,2,1,4,21,0,0,0,1,0.52,0.5,0.48,0.1343,65,139,204,204,True
11514,2012-04-29,2,1,4,22,0,0,0,1,0.5,0.4848,0.45,0.0,23,85,108,108,True
11515,2012-04-29,2,1,4,23,0,0,0,1,0.48,0.4697,0.59,0.0,15,67,82,82,True
11516,2012-04-30,2,1,4,0,0,1,1,1,0.44,0.4394,0.72,0.1045,12,36,48,48,True
11517,2012-04-30,2,1,4,1,0,1,1,1,0.42,0.4242,0.77,0.0896,9,15,24,24,True
11518,2012-04-30,2,1,4,2,0,1,1,1,0.42,0.4242,0.71,0.1343,3,5,8,8,True
11519,2012-04-30,2,1,4,3,0,1,1,1,0.4,0.4091,0.76,0.1642,0,4,4,4,True
11520,2012-04-30,2,1,4,4,0,1,1,1,0.38,0.3939,0.62,0.2537,0,2,2,2,True
11521,2012-04-30,2,1,4,5,0,1,1,1,0.38,0.3939,0.62,0.2537,1,19,20,20,True
11522,2012-04-30,2,1,4,6,0,1,1,1,0.4,0.4091,0.47,0.194,2,121,123,123,True
11523,2012-04-30,2,1,4,7,0,1,1,1,0.4,0.4091,0.5,0.194,6,343,349,349,True
11524,2012-04-30,2,1,4,8,0,1,1,1,0.4,0.4091,0.43,0.194,17,499,516,516,True
11525,2012-04-30,2,1,4,9,0,1,1,2,0.4,0.4091,0.43,0.194,29,239,268,268,True
11526,2012-04-30,2,1,4,10,0,1,1,2,0.42,0.4242,0.41,0.1642,41,116,157,157,True
11527,2012-04-30,2,1,4,11,0,1,1,2,0.44,0.4394,0.44,0.1045,52,111,163,163,True
11528,2012-04-30,2,1,4,12,0,1,1,2,0.44,0.4394,0.47,0.1343,45,180,225,225,True
11529,2012-04-30,2,1,4,13,0,1,1,2,0.48,0.4697,0.51,0.0896,48,199,247,247,True
11530,2012-04-30,2,1,4,14,0,1,1,2,0.5,0.4848,0.55,0.1343,56,162,218,218,True
11531,2012-04-30,2,1,4,15,0,1,1,2,0.52,0.5,0.55,0.1045,55,176,231,231,True
11532,2012-04-30,2,1,4,16,0,1,1,1,0.56,0.5303,0.6,0.194,44,303,347,347,True
11533,2012-04-30,2,1,4,17,0,1,1,1,0.56,0.5303,0.6,0.1642,66,499,565,565,True
11534,2012-04-30,2,1,4,18,0,1,1,2,0.56,0.5303,0.6,0.2239,53,499,552,552,True
11535,2012-04-30,2,1,4,19,0,1,1,2,0.54,0.5152,0.64,0.2537,51,420,471,471,True
11536,2012-04-30,2,1,4,20,0,1,1,2,0.52,0.5,0.59,0.194,28,281,309,309,True
11537,2012-04-30,2,1,4,21,0,1,1,2,0.52,0.5,0.59,0.194,26,195,221,221,True
11538,2012-04-30,2,1,4,22,0,1,1,2,0.52,0.5,0.55,0.1642,11,123,134,134,True
11539,2012-04-30,2,1,4,23,0,1,1,2,0.52,0.5,0.55,0.2239,10,50,60,60,True
11540,2012-05-01,2,1,5,0,0,2,1,2,0.5,0.4848,0.59,0.194,7,28,35,35,True
11541,2012-05-01,2,1,5,1,0,2,1,2,0.5,0.4848,0.63,0.1343,0,21,21,21,True
11542,2012-05-01,2,1,5,2,0,2,1,2,0.5,0.4848,0.72,0.0896,1,7,8,8,True
11543,2012-05-01,2,1,5,3,0,2,1,2,0.5,0.4848,0.77,0.0,1,2,3,3,True
11544,2012-05-01,2,1,5,4,0,2,1,2,0.52,0.5,0.72,0.0896,1,7,8,8,True
11545,2012-05-01,2,1,5,5,0,2,1,2,0.52,0.5,0.72,0.0896,0,17,17,17,True
11546,2012-05-01,2,1,5,6,0,2,1,3,0.52,0.5,0.77,0.1045,2,24,26,26,True
11547,2012-05-01,2,1,5,7,0,2,1,2,0.5,0.4848,0.94,0.2537,8,161,169,169,True
11548,2012-05-01,2,1,5,8,0,2,1,2,0.52,0.5,0.94,0.2836,19,499,518,518,True
11549,2012-05-01,2,1,5,9,0,2,1,2,0.54,0.5152,0.88,0.194,18,331,349,349,True
11550,2012-05-01,2,1,5,10,0,2,1,1,0.62,0.5909,0.78,0.2537,30,144,174,174,True
11551,2012-05-01,2,1,5,11,0,2,1,2,0.66,0.6212,0.65,0.2836,50,179,229,229,True
11552,2012-05-01,2,1,5,12,0,2,1,2,0.7,0.6515,0.58,0.2239,41,228,269,269,True
11553,2012-05-01,2,1,5,13,0,2,1,2,0.72,0.6667,0.51,0.2239,41,208,249,249,True
11554,2012-05-01,2,1,5,14,0,2,1,2,0.74,0.6667,0.48,0.2537,37,167,204,204,True
11555,2012-05-01,2,1,5,15,0,2,1,2,0.74,0.6667,0.45,0.2239,48,186,234,234,True
11556,2012-05-01,2,1,5,16,0,2,1,1,0.74,0.6667,0.45,0.194,41,313,354,354,True
11557,2012-05-01,2,1,5,17,0,2,1,1,0.74,0.6667,0.48,0.0896,65,499,564,564,True
11558,2012-05-01,2,1,5,18,0,2,1,1,0.7,0.6515,0.54,0.1343,81,499,580,580,True
11559,2012-05-01,2,1,5,19,0,2,1,1,0.7,0.6515,0.54,0.1343,58,429,487,487,True
11560,2012-05-01,2,1,5,20,0,2,1,1,0.66,0.6212,0.61,0.1642,36,299,335,335,True
11561,2012-05-01,2,1,5,21,0,2,1,1,0.64,0.6061,0.65,0.1343,31,251,282,282,True
11562,2012-05-01,2,1,5,22,0,2,1,1,0.64,0.6061,0.65,0.0,21,190,211,211,True
11563,2012-05-01,2,1,5,23,0,2,1,1,0.6,0.5758,0.78,0.0,16,79,95,95,True
11564,2012-05-02,2,1,5,0,0,3,1,1,0.6,0.5758,0.78,0.1045,4,43,47,47,True
11565,2012-05-02,2,1,5,1,0,3,1,1,0.56,0.5303,0.83,0.0,8,7,15,15,True
11566,2012-05-02,2,1,5,2,0,3,1,1,0.56,0.5303,0.83,0.0,7,9,16,16,True
11567,2012-05-02,2,1,5,3,0,3,1,1,0.56,0.5303,0.83,0.0896,0,6,6,6,True
11568,2012-05-02,2,1,5,4,0,3,1,1,0.54,0.5152,0.88,0.0,2,2,4,4,True
11569,2012-05-02,2,1,5,5,0,3,1,1,0.54,0.5152,0.9,0.1343,2,31,33,33,True
11570,2012-05-02,2,1,5,6,0,3,1,3,0.56,0.5303,0.84,0.0,3,117,120,120,True
11571,2012-05-02,2,1,5,7,0,3,1,2,0.54,0.5152,0.88,0.194,14,344,358,358,True
11572,2012-05-02,2,1,5,8,0,3,1,2,0.56,0.5303,0.88,0.0,26,499,525,525,True
11573,2012-05-02,2,1,5,9,0,3,1,2,0.56,0.5303,0.88,0.0,26,289,315,315,True
11574,2012-05-02,2,1,5,10,0,3,1,2,0.58,0.5455,0.83,0.1045,28,147,175,175,True
11575,2012-05-02,2,1,5,11,0,3,1,2,0.58,0.5455,0.81,0.1343,39,145,184,184,True
11576,2012-05-02,2,1,5,12,0,3,1,2,0.58,0.5455,0.83,0.2239,35,210,245,245,True
11577,2012-05-02,2,1,5,13,0,3,1,2,0.58,0.5455,0.78,0.194,49,179,228,228,True
11578,2012-05-02,2,1,5,14,0,3,1,1,0.62,0.6061,0.69,0.0896,51,189,240,240,True
11579,2012-05-02,2,1,5,15,0,3,1,1,0.64,0.6061,0.65,0.194,52,204,256,256,True
11580,2012-05-02,2,1,5,16,0,3,1,1,0.64,0.6061,0.65,0.1642,54,313,367,367,True
11581,2012-05-02,2,1,5,17,0,3,1,1,0.6,0.5909,0.73,0.2537,70,499,569,569,True
11582,2012-05-02,2,1,5,18,0,3,1,1,0.56,0.5303,0.73,0.2239,43,499,542,542,True
11583,2012-05-02,2,1,5,19,0,3,1,1,0.54,0.5152,0.77,0.2537,43,461,504,504,True
11584,2012-05-02,2,1,5,20,0,3,1,1,0.52,0.5,0.77,0.2537,42,296,338,338,True
11585,2012-05-02,2,1,5,21,0,3,1,1,0.52,0.5,0.77,0.2239,21,218,239,239,True
11586,2012-05-02,2,1,5,22,0,3,1,1,0.5,0.4848,0.82,0.2239,27,146,173,173,True
11587,2012-05-02,2,1,5,23,0,3,1,2,0.5,0.4848,0.77,0.2537,21,77,98,98,True
11588,2012-05-03,2,1,5,0,0,4,1,2,0.48,0.4697,0.82,0.2239,15,75,90,90,True
11589,2012-05-03,2,1,5,1,0,4,1,2,0.46,0.4545,0.88,0.1045,9,15,24,24,True
11590,2012-05-03,2,1,5,2,0,4,1,2,0.46,0.4545,0.88,0.1343,4,13,17,17,True
11591,2012-05-03,2,1,5,3,0,4,1,2,0.46,0.4545,0.88,0.0,2,4,6,6,True
11592,2012-05-03,2,1,5,4,0,4,1,2,0.46,0.4545,0.88,0.2537,0,2,2,2,True
11593,2012-05-03,2,1,5,5,0,4,1,2,0.46,0.4545,0.88,0.2537,1,20,21,21,True
11594,2012-05-03,2,1,5,6,0,4,1,2,0.46,0.4545,0.88,0.1642,8,128,136,136,True
11595,2012-05-03,2,1,5,7,0,4,1,3,0.44,0.4394,0.94,0.1045,8,376,384,384,True
11596,2012-05-03,2,1,5,8,0,4,1,3,0.46,0.4545,0.88,0.194,19,499,518,518,True
11597,2012-05-03,2,1,5,9,0,4,1,2,0.48,0.4697,0.88,0.1045,25,279,304,304,True
11598,2012-05-03,2,1,5,10,0,4,1,2,0.52,0.5,0.77,0.0,36,132,168,168,True
11599,2012-05-03,2,1,5,11,0,4,1,1,0.54,0.5152,0.77,0.0,34,167,201,201,True
11600,2012-05-03,2,1,5,12,0,4,1,1,0.56,0.5303,0.73,0.1343,64,237,301,301,True
11601,2012-05-03,2,1,5,13,0,4,1,1,0.6,0.5909,0.69,0.194,48,217,265,265,True
11602,2012-05-03,2,1,5,14,0,4,1,1,0.64,0.6061,0.65,0.194,33,171,204,204,True
11603,2012-05-03,2,1,5,15,0,4,1,1,0.66,0.6212,0.61,0.194,63,220,283,283,True
11604,2012-05-03,2,1,5,16,0,4,1,1,0.68,0.6364,0.57,0.1642,45,325,370,370,True
11605,2012-05-03,2,1,5,17,0,4,1,1,0.72,0.6667,0.54,0.1343,87,499,586,586,True
11606,2012-05-03,2,1,5,18,0,4,1,1,0.72,0.6667,0.58,0.1343,64,499,563,563,True
11607,2012-05-03,2,1,5,19,0,4,1,1,0.7,0.6515,0.61,0.194,55,467,522,522,True
11608,2012-05-03,2,1,5,20,0,4,1,1,0.64,0.6061,0.73,0.194,52,368,420,420,True
11609,2012-05-03,2,1,5,21,0,4,1,1,0.62,0.5909,0.78,0.1343,42,257,299,299,True
11610,2012-05-03,2,1,5,22,0,4,1,1,0.62,0.5909,0.78,0.0,29,217,246,246,True
11611,2012-05-03,2,1,5,23,0,4,1,1,0.6,0.5606,0.83,0.0,21,100,121,121,True
11612,2012-05-04,2,1,5,0,0,5,1,1,0.6,0.5758,0.78,0.3284,19,70,89,89,True
11613,2012-05-04,2,1,5,1,0,5,1,1,0.6,0.5758,0.78,0.1045,15,33,48,48,True
11614,2012-05-04,2,1,5,2,0,5,1,1,0.58,0.5455,0.83,0.1343,0,11,11,11,True
11615,2012-05-04,2,1,5,3,0,5,1,1,0.56,0.5303,0.88,0.2239,0,14,14,14,True
11616,2012-05-04,2,1,5,4,0,5,1,1,0.56,0.5303,0.88,0.194,0,4,4,4,True
11617,2012-05-04,2,1,5,5,0,5,1,1,0.56,0.5303,0.88,0.194,0,24,24,24,True
11618,2012-05-04,2,1,5,6,0,5,1,1,0.54,0.5152,0.94,0.1045,8,127,135,135,True
11619,2012-05-04,2,1,5,7,0,5,1,1,0.56,0.5303,0.88,0.0,9,347,356,356,True
11620,2012-05-04,2,1,5,8,0,5,1,1,0.56,0.5303,0.88,0.0,34,499,533,533,True
11621,2012-05-04,2,1,5,9,0,5,1,1,0.6,0.5758,0.78,0.0,32,262,294,294,True
11622,2012-05-04,2,1,5,10,0,5,1,2,0.62,0.5909,0.73,0.1343,45,154,199,199,True
11623,2012-05-04,2,1,5,11,0,5,1,2,0.7,0.6515,0.61,0.0,77,181,258,258,True
11624,2012-05-04,2,1,5,12,0,5,1,3,0.62,0.5909,0.78,0.3582,46,125,171,171,True
11625,2012-05-04,2,1,5,13,0,5,1,2,0.64,0.6061,0.73,0.0,71,207,278,278,True
11626,2012-05-04,2,1,5,14,0,5,1,2,0.66,0.6212,0.74,0.2836,83,159,242,242,True
11627,2012-05-04,2,1,5,15,0,5,1,2,0.72,0.6818,0.62,0.1045,103,240,343,343,True
11628,2012-05-04,2,1,5,16,0,5,1,1,0.76,0.6818,0.48,0.1642,82,358,440,440,True
11629,2012-05-04,2,1,5,17,0,5,1,1,0.7,0.6515,0.54,0.4627,96,499,595,595,True
11630,2012-05-04,2,1,5,18,0,5,1,1,0.7,0.6515,0.54,0.4627,77,499,576,576,True
11631,2012-05-04,2,1,5,19,0,5,1,1,0.7,0.6515,0.51,0.1343,64,388,452,452,True
11632,2012-05-04,2,1,5,20,0,5,1,1,0.68,0.6364,0.51,0.1045,58,255,313,313,True
11633,2012-05-04,2,1,5,21,0,5,1,1,0.64,0.6061,0.69,0.194,49,186,235,235,True
11634,2012-05-04,2,1,5,22,0,5,1,1,0.6,0.5606,0.83,0.1343,50,182,232,232,True
11635,2012-05-04,2,1,5,23,0,5,1,1,0.6,0.5606,0.83,0.0896,51,205,256,256,True
11636,2012-05-05,2,1,5,0,0,6,0,1,0.6,0.5606,0.83,0.0,42,111,153,153,True
11637,2012-05-05,2,1,5,1,0,6,0,1,0.6,0.5606,0.83,0.0,28,79,107,107,True
11638,2012-05-05,2,1,5,2,0,6,0,1,0.58,0.5455,0.88,0.0,24,51,75,75,True
11639,2012-05-05,2,1,5,3,0,6,0,1,0.58,0.5455,0.83,0.0,11,21,32,32,True
11640,2012-05-05,2,1,5,4,0,6,0,1,0.56,0.5303,0.88,0.1045,0,9,9,9,True
11641,2012-05-05,2,1,5,5,0,6,0,1,0.56,0.5303,0.88,0.0896,8,14,22,22,True
11642,2012-05-05,2,1,5,6,0,6,0,2,0.54,0.5152,0.94,0.0,9,33,42,42,True
11643,2012-05-05,2,1,5,7,0,6,0,1,0.56,0.5303,0.88,0.0,8,79,87,87,True
11644,2012-05-05,2,1,5,8,0,6,0,1,0.58,0.5455,0.83,0.0896,42,155,197,197,True
11645,2012-05-05,2,1,5,9,0,6,0,1,0.62,0.5909,0.78,0.1045,61,223,284,284,True
11646,2012-05-05,2,1,5,10,0,6,0,1,0.66,0.6212,0.65,0.1343,114,284,398,398,True
11647,2012-05-05,2,1,5,11,0,6,0,1,0.7,0.6515,0.58,0.0896,114,354,468,468,True
11648,2012-05-05,2,1,5,12,0,6,0,1,0.72,0.6667,0.58,0.1045,114,330,444,444,True
11649,2012-05-05,2,1,5,13,0,6,0,1,0.74,0.6818,0.55,0.1343,114,307,421,421,True
11650,2012-05-05,2,1,5,14,0,6,0,3,0.7,0.6515,0.61,0.2985,114,241,355,355,True
11651,2012-05-05,2,1,5,15,0,6,0,3,0.66,0.6212,0.74,0.194,114,300,414,414,True
11652,2012-05-05,2,1,5,16,0,6,0,2,0.68,0.6364,0.65,0.3881,114,310,424,424,True
11653,2012-05-05,2,1,5,17,0,6,0,2,0.68,0.6364,0.65,0.2985,114,298,412,412,True
11654,2012-05-05,2,1,5,18,0,6,0,2,0.66,0.6212,0.69,0.3582,114,278,392,392,True
11655,2012-05-05,2,1,5,19,0,6,0,2,0.62,0.5909,0.73,0.3284,114,254,368,368,True
11656,2012-05-05,2,1,5,20,0,6,0,1,0.6,0.5758,0.78,0.2537,100,209,309,309,True
11657,2012-05-05,2,1,5,21,0,6,0,2,0.58,0.5455,0.78,0.2239,86,183,269,269,True
11658,2012-05-05,2,1,5,22,0,6,0,2,0.58,0.5455,0.78,0.194,67,150,217,217,True
11659,2012-05-05,2,1,5,23,0,6,0,2,0.56,0.5303,0.83,0.2836,35,114,149,149,True
11660,2012-05-06,2,1,5,0,0,0,0,2,0.56,0.5303,0.83,0.1343,23,111,134,134,True
11661,2012-05-06,2,1,5,1,0,0,0,2,0.54,0.5152,0.83,0.2239,37,84,121,121,True
11662,2012-05-06,2,1,5,2,0,0,0,2,0.54,0.5152,0.83,0.2836,29,64,93,93,True
11663,2012-05-06,2,1,5,3,0,0,0,2,0.54,0.5152,0.83,0.194,9,19,28,28,True
11664,2012-05-06,2,1,5,4,0,0,0,3,0.52,0.5,0.83,0.1642,9,7,16,16,True
11665,2012-05-06,2,1,5,5,0,0,0,3,0.52,0.5,0.83,0.1642,1,10,11,11,True
11666,2012-05-06,2,1,5,6,0,0,0,3,0.52,0.5,0.83,0.2239,3,14,17,17,True
11667,2012-05-06,2,1,5,7,0,0,0,3,0.52,0.5,0.83,0.1642,5,31,36,36,True
11668,2012-05-06,2,1,5,8,0,0,0,2,0.5,0.4848,0.88,0.1343,23,91,114,114,True
11669,2012-05-06,2,1,5,9,0,0,0,2,0.52,0.5,0.83,0.1642,63,128,191,191,True
11670,2012-05-06,2,1,5,10,0,0,0,2,0.54,0.5152,0.77,0.1045,112,221,333,333,True
11671,2012-05-06,2,1,5,11,0,0,0,1,0.56,0.5303,0.73,0.1045,114,270,384,384,True
11672,2012-05-06,2,1,5,12,0,0,0,2,0.6,0.6061,0.64,0.0896,114,351,465,465,True
11673,2012-05-06,2,1,5,13,0,0,0,2,0.6,0.6061,0.64,0.0,114,368,482,482,True
11674,2012-05-06,2,1,5,14,0,0,0,2,0.6,0.6061,0.64,0.1045,114,292,406,406,True
11675,2012-05-06,2,1,5,15,0,0,0,2,0.62,0.6061,0.61,0.1045,114,342,456,456,True
11676,2012-05-06,2,1,5,16,0,0,0,2,0.62,0.6061,0.61,0.0,114,363,477,477,True
11677,2012-05-06,2,1,5,17,0,0,0,2,0.62,0.6061,0.65,0.1343,114,316,430,430,True
11678,2012-05-06,2,1,5,18,0,0,0,2,0.62,0.6061,0.61,0.194,114,332,446,446,True
11679,2012-05-06,2,1,5,19,0,0,0,2,0.6,0.6061,0.64,0.1642,114,266,380,380,True
11680,2012-05-06,2,1,5,20,0,0,0,1,0.6,0.6061,0.64,0.194,73,203,276,276,True
11681,2012-05-06,2,1,5,21,0,0,0,1,0.56,0.5303,0.73,0.194,55,148,203,203,True
11682,2012-05-06,2,1,5,22,0,0,0,1,0.56,0.5303,0.73,0.1642,44,113,157,157,True
11683,2012-05-06,2,1,5,23,0,0,0,1,0.52,0.5,0.77,0.194,22,80,102,102,True
11684,2012-05-07,2,1,5,0,0,1,1,2,0.52,0.5,0.77,0.1343,13,21,34,34,True
11685,2012-05-07,2,1,5,1,0,1,1,2,0.52,0.5,0.77,0.194,1,8,9,9,True
11686,2012-05-07,2,1,5,2,0,1,1,1,0.5,0.4848,0.77,0.194,1,5,6,6,True
11687,2012-05-07,2,1,5,3,0,1,1,1,0.5,0.4848,0.77,0.194,2,3,5,5,True
11688,2012-05-07,2,1,5,4,0,1,1,2,0.46,0.4545,0.88,0.1343,0,2,2,2,True
11689,2012-05-07,2,1,5,5,0,1,1,1,0.46,0.4545,0.88,0.1045,2,21,23,23,True
11690,2012-05-07,2,1,5,6,0,1,1,1,0.46,0.4545,0.88,0.1045,8,134,142,142,True
11691,2012-05-07,2,1,5,7,0,1,1,2,0.48,0.4697,0.82,0.1045,18,367,385,385,True
11692,2012-05-07,2,1,5,8,0,1,1,2,0.5,0.4848,0.82,0.194,31,499,530,530,True
11693,2012-05-07,2,1,5,9,0,1,1,2,0.5,0.4848,0.82,0.2239,61,289,350,350,True
11694,2012-05-07,2,1,5,10,0,1,1,2,0.52,0.5,0.77,0.194,62,128,190,190,True
11695,2012-05-07,2,1,5,11,0,1,1,2,0.54,0.5152,0.73,0.194,64,149,213,213,True
11696,2012-05-07,2,1,5,12,0,1,1,2,0.56,0.5303,0.68,0.2239,74,189,263,263,True
11697,2012-05-07,2,1,5,13,0,1,1,2,0.6,0.6212,0.53,0.3284,75,197,272,272,True
11698,2012-05-07,2,1,5,14,0,1,1,2,0.62,0.6212,0.5,0.3582,59,180,239,239,True
11699,2012-05-07,2,1,5,15,0,1,1,2,0.62,0.6212,0.53,0.2985,76,186,262,262,True
11700,2012-05-07,2,1,5,16,0,1,1,2,0.6,0.6212,0.53,0.3881,68,320,388,388,True
11701,2012-05-07,2,1,5,17,0,1,1,2,0.6,0.6212,0.53,0.3284,102,499,601,601,True
11702,2012-05-07,2,1,5,18,0,1,1,2,0.6,0.6212,0.53,0.3582,78,499,577,577,True
11703,2012-05-07,2,1,5,19,0,1,1,1,0.58,0.5455,0.56,0.3284,83,463,546,546,True
11704,2012-05-07,2,1,5,20,0,1,1,1,0.54,0.5152,0.52,0.2836,46,277,323,323,True
11705,2012-05-07,2,1,5,21,0,1,1,2,0.54,0.5152,0.45,0.2239,37,210,247,247,True
11706,2012-05-07,2,1,5,22,0,1,1,2,0.54,0.5152,0.45,0.2537,26,147,173,173,True
11707,2012-05-07,2,1,5,23,0,1,1,2,0.54,0.5152,0.45,0.194,21,92,113,113,True
11708,2012-05-08,2,1,5,0,0,2,1,2,0.52,0.5,0.52,0.2537,10,28,38,38,True
11709,2012-05-08,2,1,5,1,0,2,1,2,0.52,0.5,0.59,0.2239,6,3,9,9,True
11710,2012-05-08,2,1,5,2,0,2,1,2,0.52,0.5,0.63,0.2985,9,7,16,16,True
11711,2012-05-08,2,1,5,3,0,2,1,2,0.52,0.5,0.68,0.2836,2,4,6,6,True
11712,2012-05-08,2,1,5,4,0,2,1,2,0.52,0.5,0.68,0.3284,0,5,5,5,True
11713,2012-05-08,2,1,5,5,0,2,1,2,0.52,0.5,0.72,0.2836,0,20,20,20,True
11714,2012-05-08,2,1,5,6,0,2,1,1,0.5,0.4848,0.77,0.2985,7,158,165,165,True
11715,2012-05-08,2,1,5,7,0,2,1,1,0.52,0.5,0.72,0.2836,21,442,463,463,True
11716,2012-05-08,2,1,5,8,0,2,1,2,0.54,0.5152,0.73,0.2985,36,499,535,535,True
11717,2012-05-08,2,1,5,9,0,2,1,2,0.56,0.5303,0.68,0.3582,37,258,295,295,True
11718,2012-05-08,2,1,5,10,0,2,1,2,0.58,0.5455,0.68,0.4179,46,111,157,157,True
11719,2012-05-08,2,1,5,11,0,2,1,2,0.6,0.6061,0.64,0.3881,60,157,217,217,True
11720,2012-05-08,2,1,5,12,0,2,1,2,0.62,0.6061,0.65,0.3284,60,203,263,263,True
11721,2012-05-08,2,1,5,13,0,2,1,3,0.64,0.6061,0.65,0.2537,53,166,219,219,True
11722,2012-05-08,2,1,5,14,0,2,1,3,0.62,0.6061,0.69,0.3284,8,63,71,71,True
11723,2012-05-08,2,1,5,15,0,2,1,3,0.62,0.5909,0.73,0.2537,40,94,134,134,True
11724,2012-05-08,2,1,5,16,0,2,1,3,0.64,0.6061,0.73,0.2239,54,335,389,389,True
11725,2012-05-08,2,1,5,17,0,2,1,2,0.64,0.6061,0.69,0.2836,77,499,576,576,True
11726,2012-05-08,2,1,5,18,0,2,1,2,0.64,0.6061,0.69,0.2836,69,499,568,568,True
11727,2012-05-08,2,1,5,19,0,2,1,2,0.64,0.6061,0.69,0.2836,59,399,458,458,True
11728,2012-05-08,2,1,5,20,0,2,1,2,0.64,0.6061,0.69,0.2836,40,262,302,302,True
11729,2012-05-08,2,1,5,21,0,2,1,2,0.64,0.6061,0.65,0.2836,21,202,223,223,True
11730,2012-05-08,2,1,5,22,0,2,1,3,0.6,0.5758,0.78,0.2537,13,134,147,147,True
11731,2012-05-08,2,1,5,23,0,2,1,3,0.6,0.5758,0.78,0.3284,10,53,63,63,True
11732,2012-05-09,2,1,5,0,0,3,1,2,0.58,0.5455,0.83,0.194,8,27,35,35,True
11733,2012-05-09,2,1,5,1,0,3,1,2,0.6,0.5758,0.78,0.2537,3,11,14,14,True
11734,2012-05-09,2,1,5,2,0,3,1,3,0.56,0.5303,0.88,0.4478,0,1,1,1,True
11735,2012-05-09,2,1,5,3,0,3,1,3,0.56,0.5303,0.88,0.1642,0,2,2,2,True
11736,2012-05-09,2,1,5,4,0,3,1,3,0.56,0.5303,0.88,0.2239,0,5,5,5,True
11737,2012-05-09,2,1,5,5,0,3,1,2,0.56,0.5303,0.88,0.1343,1,27,28,28,True
11738,2012-05-09,2,1,5,6,0,3,1,2,0.56,0.5303,0.88,0.1045,5,121,126,126,True
11739,2012-05-09,2,1,5,7,0,3,1,2,0.56,0.5303,0.94,0.194,17,401,418,418,True
11740,2012-05-09,2,1,5,8,0,3,1,2,0.6,0.5606,0.83,0.1343,28,499,527,527,True
11741,2012-05-09,2,1,5,9,0,3,1,2,0.6,0.5606,0.83,0.0,40,285,325,325,True
11742,2012-05-09,2,1,5,10,0,3,1,2,0.62,0.6061,0.65,0.2537,40,113,153,153,True
11743,2012-05-09,2,1,5,11,0,3,1,2,0.62,0.6212,0.59,0.2985,45,156,201,201,True
11744,2012-05-09,2,1,5,12,0,3,1,2,0.62,0.6212,0.57,0.2239,58,222,280,280,True
11745,2012-05-09,2,1,5,13,0,3,1,2,0.64,0.6212,0.53,0.2537,50,216,266,266,True
11746,2012-05-09,2,1,5,14,0,3,1,2,0.64,0.6212,0.53,0.2537,68,175,243,243,True
11747,2012-05-09,2,1,5,15,0,3,1,2,0.64,0.6212,0.53,0.1045,68,191,259,259,True
11748,2012-05-09,2,1,5,16,0,3,1,2,0.66,0.6212,0.5,0.194,68,289,357,357,True
11749,2012-05-09,2,1,5,17,0,3,1,2,0.64,0.6212,0.53,0.1343,76,499,575,575,True
11750,2012-05-09,2,1,5,18,0,3,1,3,0.52,0.5,0.77,0.4775,23,349,372,372,True
11751,2012-05-09,2,1,5,19,0,3,1,3,0.5,0.4848,0.77,0.3582,2,96,98,98,True
11752,2012-05-09,2,1,5,20,0,3,1,3,0.5,0.4848,0.82,0.2239,3,48,51,51,True
11753,2012-05-09,2,1,5,21,0,3,1,3,0.5,0.4848,0.82,0.1642,4,30,34,34,True
11754,2012-05-09,2,1,5,22,0,3,1,3,0.48,0.4697,0.82,0.1045,5,62,67,67,True
11755,2012-05-09,2,1,5,23,0,3,1,3,0.48,0.4697,0.82,0.194,8,47,55,55,True
11756,2012-05-10,2,1,5,0,0,4,1,3,0.5,0.4848,0.77,0.1642,2,31,33,33,True
11757,2012-05-10,2,1,5,1,0,4,1,2,0.48,0.4697,0.88,0.1343,2,9,11,11,True
11758,2012-05-10,2,1,5,2,0,4,1,2,0.48,0.4697,0.88,0.1045,0,3,3,3,True
11759,2012-05-10,2,1,5,3,0,4,1,1,0.46,0.4545,0.88,0.2239,0,3,3,3,True
11760,2012-05-10,2,1,5,4,0,4,1,1,0.46,0.4545,0.77,0.194,0,2,2,2,True
11761,2012-05-10,2,1,5,5,0,4,1,1,0.46,0.4545,0.72,0.2985,1,23,24,24,True
11762,2012-05-10,2,1,5,6,0,4,1,1,0.44,0.4394,0.72,0.2239,9,130,139,139,True
11763,2012-05-10,2,1,5,7,0,4,1,1,0.44,0.4394,0.72,0.2985,8,393,401,401,True
11764,2012-05-10,2,1,5,8,0,4,1,1,0.46,0.4545,0.67,0.3582,27,499,526,526,True
11765,2012-05-10,2,1,5,9,0,4,1,1,0.5,0.4848,0.59,0.4627,62,299,361,361,True
11766,2012-05-10,2,1,5,10,0,4,1,1,0.5,0.4848,0.51,0.4179,42,112,154,154,True
11767,2012-05-10,2,1,5,11,0,4,1,1,0.52,0.5,0.48,0.4775,77,179,256,256,True
11768,2012-05-10,2,1,5,12,0,4,1,1,0.52,0.5,0.48,0.4179,65,207,272,272,True
11769,2012-05-10,2,1,5,13,0,4,1,1,0.54,0.5152,0.39,0.4478,90,228,318,318,True
11770,2012-05-10,2,1,5,14,0,4,1,1,0.56,0.5303,0.37,0.4179,61,186,247,247,True
11771,2012-05-10,2,1,5,15,0,4,1,1,0.54,0.5152,0.37,0.3881,79,192,271,271,True
11772,2012-05-10,2,1,5,16,0,4,1,1,0.58,0.5455,0.3,0.4627,87,334,421,421,True
11773,2012-05-10,2,1,5,17,0,4,1,1,0.6,0.6212,0.31,0.3881,84,499,583,583,True
11774,2012-05-10,2,1,5,18,0,4,1,1,0.56,0.5303,0.35,0.4775,109,499,608,608,True
11775,2012-05-10,2,1,5,19,0,4,1,1,0.54,0.5152,0.37,0.3582,84,469,553,553,True
11776,2012-05-10,2,1,5,20,0,4,1,1,0.52,0.5,0.4,0.3284,59,315,374,374,True
11777,2012-05-10,2,1,5,21,0,4,1,1,0.5,0.4848,0.42,0.194,19,211,230,230,True
11778,2012-05-10,2,1,5,22,0,4,1,1,0.5,0.4848,0.42,0.1045,36,196,232,232,True
11779,2012-05-10,2,1,5,23,0,4,1,1,0.48,0.4697,0.48,0.1045,23,112,135,135,True
11780,2012-05-11,2,1,5,0,0,5,1,1,0.46,0.4545,0.55,0.1045,17,47,64,64,True
11781,2012-05-11,2,1,5,1,0,5,1,1,0.46,0.4545,0.51,0.1343,14,32,46,46,True
11782,2012-05-11,2,1,5,2,0,5,1,1,0.46,0.4545,0.44,0.1642,15,16,31,31,True
11783,2012-05-11,2,1,5,3,0,5,1,1,0.46,0.4545,0.41,0.2836,5,8,13,13,True
11784,2012-05-11,2,1,5,4,0,5,1,1,0.42,0.4242,0.5,0.194,3,6,9,9,True
11785,2012-05-11,2,1,5,5,0,5,1,1,0.42,0.4242,0.47,0.1642,3,23,26,26,True
11786,2012-05-11,2,1,5,6,0,5,1,1,0.42,0.4242,0.5,0.2537,7,128,135,135,True
11787,2012-05-11,2,1,5,7,0,5,1,1,0.42,0.4242,0.5,0.2537,6,345,351,351,True
11788,2012-05-11,2,1,5,8,0,5,1,1,0.46,0.4545,0.44,0.2537,41,499,540,540,True
11789,2012-05-11,2,1,5,9,0,5,1,1,0.48,0.4697,0.41,0.2985,34,288,322,322,True
11790,2012-05-11,2,1,5,10,0,5,1,1,0.52,0.5,0.36,0.3284,69,141,210,210,True
11791,2012-05-11,2,1,5,11,0,5,1,1,0.56,0.5303,0.35,0.2537,88,203,291,291,True
11792,2012-05-11,2,1,5,12,0,5,1,1,0.56,0.5303,0.28,0.4179,89,259,348,348,True
11793,2012-05-11,2,1,5,13,0,5,1,1,0.6,0.6061,0.26,0.3881,100,263,363,363,True
11794,2012-05-11,2,1,5,14,0,5,1,1,0.62,0.6061,0.23,0.2239,114,218,332,332,True
11795,2012-05-11,2,1,5,15,0,5,1,1,0.62,0.6061,0.25,0.194,114,299,413,413,True
11796,2012-05-11,2,1,5,16,0,5,1,1,0.62,0.6061,0.25,0.3284,114,397,511,511,True
11797,2012-05-11,2,1,5,17,0,5,1,1,0.64,0.6061,0.23,0.2537,102,499,601,601,True
11798,2012-05-11,2,1,5,18,0,5,1,1,0.64,0.6061,0.23,0.2836,78,499,577,577,True
11799,2012-05-11,2,1,5,19,0,5,1,1,0.64,0.6061,0.23,0.2537,73,430,503,503,True
11800,2012-05-11,2,1,5,20,0,5,1,1,0.62,0.6061,0.25,0.1343,64,277,341,341,True
11801,2012-05-11,2,1,5,21,0,5,1,1,0.6,0.6061,0.28,0.1045,45,225,270,270,True
11802,2012-05-11,2,1,5,22,0,5,1,1,0.56,0.5303,0.35,0.2239,44,190,234,234,True
11803,2012-05-11,2,1,5,23,0,5,1,1,0.54,0.5152,0.37,0.194,38,142,180,180,True
11804,2012-05-12,2,1,5,0,0,6,0,1,0.52,0.5,0.42,0.1642,25,111,136,136,True
11805,2012-05-12,2,1,5,1,0,6,0,1,0.5,0.4848,0.48,0.0,14,79,93,93,True
11806,2012-05-12,2,1,5,2,0,6,0,1,0.46,0.4545,0.59,0.1343,10,46,56,56,True
11807,2012-05-12,2,1,5,3,0,6,0,1,0.48,0.4697,0.59,0.0,14,20,34,34,True
11808,2012-05-12,2,1,5,4,0,6,0,1,0.44,0.4394,0.67,0.1045,3,6,9,9,True
11809,2012-05-12,2,1,5,5,0,6,0,1,0.42,0.4242,0.67,0.1343,5,8,13,13,True
11810,2012-05-12,2,1,5,6,0,6,0,1,0.42,0.4242,0.67,0.0896,10,23,33,33,True
11811,2012-05-12,2,1,5,7,0,6,0,1,0.42,0.4242,0.71,0.1343,10,57,67,67,True
11812,2012-05-12,2,1,5,8,0,6,0,1,0.52,0.5,0.48,0.0,22,156,178,178,True
11813,2012-05-12,2,1,5,9,0,6,0,1,0.54,0.5152,0.49,0.0,87,248,335,335,True
11814,2012-05-12,2,1,5,10,0,6,0,1,0.56,0.5303,0.49,0.0896,114,279,393,393,True
11815,2012-05-12,2,1,5,11,0,6,0,1,0.62,0.6212,0.41,0.0896,114,365,479,479,True
11816,2012-05-12,2,1,5,12,0,6,0,1,0.64,0.6212,0.36,0.1642,114,353,467,467,True
11817,2012-05-12,2,1,5,13,0,6,0,1,0.64,0.6212,0.36,0.194,114,366,480,480,True
11818,2012-05-12,2,1,5,14,0,6,0,1,0.66,0.6212,0.36,0.194,114,358,472,472,True
11819,2012-05-12,2,1,5,15,0,6,0,1,0.68,0.6212,0.24,0.194,114,321,435,435,True
11820,2012-05-12,2,1,5,16,0,6,0,2,0.7,0.6364,0.21,0.194,114,337,451,451,True
11821,2012-05-12,2,1,5,17,0,6,0,2,0.66,0.6212,0.36,0.194,114,343,457,457,True
11822,2012-05-12,2,1,5,18,0,6,0,2,0.66,0.6212,0.31,0.194,114,382,496,496,True
11823,2012-05-12,2,1,5,19,0,6,0,2,0.64,0.6212,0.36,0.1642,114,273,387,387,True
11824,2012-05-12,2,1,5,20,0,6,0,1,0.62,0.6212,0.46,0.1642,113,174,287,287,True
11825,2012-05-12,2,1,5,21,0,6,0,2,0.6,0.6061,0.6,0.1343,74,156,230,230,True
11826,2012-05-12,2,1,5,22,0,6,0,1,0.56,0.5303,0.68,0.1343,62,212,274,274,True
11827,2012-05-12,2,1,5,23,0,6,0,1,0.58,0.5455,0.56,0.0896,42,134,176,176,True
11828,2012-05-13,2,1,5,0,0,0,0,1,0.56,0.5303,0.64,0.1642,19,79,98,98,True
11829,2012-05-13,2,1,5,1,0,0,0,2,0.54,0.5152,0.68,0.1343,22,72,94,94,True
11830,2012-05-13,2,1,5,2,0,0,0,2,0.54,0.5152,0.68,0.1642,22,60,82,82,True
11831,2012-05-13,2,1,5,3,0,0,0,2,0.54,0.5152,0.64,0.1343,2,26,28,28,True
11832,2012-05-13,2,1,5,4,0,0,0,2,0.54,0.5152,0.68,0.194,2,7,9,9,True
11833,2012-05-13,2,1,5,5,0,0,0,1,0.52,0.5,0.72,0.194,4,8,12,12,True
11834,2012-05-13,2,1,5,6,0,0,0,1,0.52,0.5,0.68,0.1642,6,15,21,21,True
11835,2012-05-13,2,1,5,7,0,0,0,1,0.52,0.5,0.68,0.1642,18,42,60,60,True
11836,2012-05-13,2,1,5,8,0,0,0,1,0.56,0.5303,0.64,0.1642,32,124,156,156,True
11837,2012-05-13,2,1,5,9,0,0,0,1,0.6,0.6212,0.56,0.1343,79,143,222,222,True
11838,2012-05-13,2,1,5,10,0,0,0,1,0.6,0.6061,0.6,0.2537,114,222,336,336,True
11839,2012-05-13,2,1,5,11,0,0,0,1,0.62,0.6212,0.57,0.2537,114,278,392,392,True
11840,2012-05-13,2,1,5,12,0,0,0,1,0.64,0.6212,0.57,0.2239,114,342,456,456,True
11841,2012-05-13,2,1,5,13,0,0,0,1,0.68,0.6364,0.54,0.2537,114,347,461,461,True
11842,2012-05-13,2,1,5,14,0,0,0,1,0.7,0.6515,0.48,0.1343,114,324,438,438,True
11843,2012-05-13,2,1,5,15,0,0,0,1,0.72,0.6515,0.45,0.3582,114,309,423,423,True
11844,2012-05-13,2,1,5,16,0,0,0,1,0.72,0.6515,0.42,0.2537,114,339,453,453,True
11845,2012-05-13,2,1,5,17,0,0,0,1,0.7,0.6364,0.45,0.4179,114,287,401,401,True
11846,2012-05-13,2,1,5,18,0,0,0,2,0.68,0.6364,0.44,0.3582,114,260,374,374,True
11847,2012-05-13,2,1,5,19,0,0,0,2,0.66,0.6212,0.5,0.4179,107,232,339,339,True
11848,2012-05-13,2,1,5,20,0,0,0,2,0.66,0.6212,0.5,0.2836,67,163,230,230,True
11849,2012-05-13,2,1,5,21,0,0,0,2,0.64,0.6212,0.53,0.194,48,121,169,169,True
11850,2012-05-13,2,1,5,22,0,0,0,2,0.62,0.6061,0.61,0.1642,42,89,131,131,True
11851,2012-05-13,2,1,5,23,0,0,0,2,0.62,0.6212,0.57,0.2239,17,57,74,74,True
11852,2012-05-14,2,1,5,0,0,1,1,2,0.6,0.6212,0.56,0.2537,21,14,35,35,True
11853,2012-05-14,2,1,5,1,0,1,1,2,0.6,0.6061,0.6,0.2836,5,6,11,11,True
11854,2012-05-14,2,1,5,2,0,1,1,1,0.6,0.6061,0.6,0.2985,1,1,2,2,True
11855,2012-05-14,2,1,5,3,0,1,1,2,0.58,0.5455,0.68,0.3284,0,2,2,2,True
11856,2012-05-14,2,1,5,4,0,1,1,2,0.54,0.5152,0.77,0.2239,3,3,6,6,True
11857,2012-05-14,2,1,5,5,0,1,1,2,0.54,0.5152,0.77,0.1642,1,25,26,26,True
11858,2012-05-14,2,1,5,6,0,1,1,3,0.52,0.5,0.94,0.2985,3,62,65,65,True
11859,2012-05-14,2,1,5,7,0,1,1,3,0.52,0.5,0.94,0.194,3,72,75,75,True
11860,2012-05-14,2,1,5,8,0,1,1,3,0.54,0.5152,0.88,0.2239,1,155,156,156,True
11861,2012-05-14,2,1,5,9,0,1,1,3,0.54,0.5152,0.88,0.2836,5,105,110,110,True
11862,2012-05-14,2,1,5,10,0,1,1,3,0.54,0.5152,0.88,0.2537,6,53,59,59,True
11863,2012-05-14,2,1,5,11,0,1,1,2,0.56,0.5303,0.83,0.2239,12,67,79,79,True
11864,2012-05-14,2,1,5,12,0,1,1,2,0.56,0.5303,0.88,0.2836,53,132,185,185,True
11865,2012-05-14,2,1,5,13,0,1,1,2,0.62,0.5909,0.73,0.2239,33,143,176,176,True
11866,2012-05-14,2,1,5,14,0,1,1,2,0.62,0.5909,0.73,0.2537,43,128,171,171,True
11867,2012-05-14,2,1,5,15,0,1,1,2,0.62,0.5909,0.73,0.1642,40,156,196,196,True
11868,2012-05-14,2,1,5,16,0,1,1,3,0.62,0.6061,0.69,0.2836,20,91,111,111,True
11869,2012-05-14,2,1,5,17,0,1,1,3,0.56,0.5303,0.88,0.2537,25,204,229,229,True
11870,2012-05-14,2,1,5,18,0,1,1,2,0.58,0.5455,0.83,0.0,17,283,300,300,True
11871,2012-05-14,2,1,5,19,0,1,1,3,0.58,0.5455,0.88,0.1343,10,294,304,304,True
11872,2012-05-14,2,1,5,20,0,1,1,2,0.58,0.5455,0.88,0.194,11,178,189,189,True
11873,2012-05-14,2,1,5,21,0,1,1,2,0.58,0.5455,0.83,0.0896,7,145,152,152,True
11874,2012-05-14,2,1,5,22,0,1,1,2,0.58,0.5455,0.78,0.0896,11,118,129,129,True
11875,2012-05-14,2,1,5,23,0,1,1,2,0.58,0.5455,0.78,0.1045,11,64,75,75,True
11876,2012-05-15,2,1,5,0,0,2,1,2,0.56,0.5303,0.88,0.1343,7,25,32,32,True
11877,2012-05-15,2,1,5,1,0,2,1,3,0.56,0.5303,0.88,0.1343,5,14,19,19,True
11878,2012-05-15,2,1,5,2,0,2,1,2,0.56,0.5303,0.88,0.1343,1,3,4,4,True
11879,2012-05-15,2,1,5,3,0,2,1,3,0.58,0.5455,0.83,0.1343,1,5,6,6,True
11880,2012-05-15,2,1,5,4,0,2,1,3,0.56,0.5303,0.94,0.0,1,4,5,5,True
11881,2012-05-15,2,1,5,5,0,2,1,3,0.56,0.5303,0.94,0.2239,0,8,8,8,True
11882,2012-05-15,2,1,5,6,0,2,1,3,0.56,0.5303,0.94,0.2239,2,22,24,24,True
11883,2012-05-15,2,1,5,7,0,2,1,3,0.56,0.5303,0.94,0.1343,1,91,92,92,True
11884,2012-05-15,2,1,5,8,0,2,1,2,0.58,0.5455,0.88,0.0896,8,401,409,409,True
11885,2012-05-15,2,1,5,9,0,2,1,2,0.58,0.5455,0.88,0.0896,28,327,355,355,True
11886,2012-05-15,2,1,5,10,0,2,1,1,0.62,0.5909,0.78,0.1045,27,144,171,171,True
11887,2012-05-15,2,1,5,11,0,2,1,1,0.64,0.5909,0.78,0.194,38,186,224,224,True
11888,2012-05-15,2,1,5,12,0,2,1,1,0.64,0.6061,0.73,0.194,44,220,264,264,True
11889,2012-05-15,2,1,5,13,0,2,1,3,0.64,0.6061,0.73,0.194,35,204,239,239,True
11890,2012-05-15,2,1,5,14,0,2,1,2,0.64,0.6061,0.73,0.194,39,145,184,184,True
11891,2012-05-15,2,1,5,15,0,2,1,2,0.7,0.6515,0.61,0.0896,51,205,256,256,True
11892,2012-05-15,2,1,5,16,0,2,1,1,0.68,0.6364,0.65,0.1642,74,300,374,374,True
11893,2012-05-15,2,1,5,17,0,2,1,1,0.68,0.6364,0.65,0.1045,75,499,574,574,True
11894,2012-05-15,2,1,5,18,0,2,1,1,0.7,0.6515,0.61,0.0896,68,499,567,567,True
11895,2012-05-15,2,1,5,19,0,2,1,1,0.66,0.6212,0.69,0.1642,57,455,512,512,True
11896,2012-05-15,2,1,5,20,0,2,1,3,0.64,0.6061,0.73,0.1343,30,233,263,263,True
11897,2012-05-15,2,1,5,21,0,2,1,3,0.64,0.6061,0.73,0.2836,11,98,109,109,True
11898,2012-05-15,2,1,5,22,0,2,1,1,0.58,0.5455,0.78,0.2239,9,74,83,83,True
11899,2012-05-15,2,1,5,23,0,2,1,3,0.56,0.5303,0.88,0.1045,13,58,71,71,True
11900,2012-05-16,2,1,5,0,0,3,1,2,0.58,0.5455,0.88,0.0,12,27,39,39,True
11901,2012-05-16,2,1,5,1,0,3,1,2,0.58,0.5455,0.88,0.1343,7,14,21,21,True
11902,2012-05-16,2,1,5,2,0,3,1,1,0.56,0.5303,0.94,0.194,5,14,19,19,True
11903,2012-05-16,2,1,5,3,0,3,1,1,0.56,0.5303,0.88,0.1045,1,5,6,6,True
11904,2012-05-16,2,1,5,4,0,3,1,1,0.54,0.5152,0.94,0.1343,1,3,4,4,True
11905,2012-05-16,2,1,5,5,0,3,1,1,0.54,0.5152,0.94,0.1045,4,34,38,38,True
11906,2012-05-16,2,1,5,6,0,3,1,1,0.54,0.5152,0.94,0.0896,8,150,158,158,True
11907,2012-05-16,2,1,5,7,0,3,1,1,0.56,0.5303,0.83,0.0,14,426,440,440,True
11908,2012-05-16,2,1,5,8,0,3,1,1,0.58,0.5455,0.83,0.0,33,499,532,532,True
11909,2012-05-16,2,1,5,9,0,3,1,2,0.6,0.5758,0.78,0.1343,33,314,347,347,True
11910,2012-05-16,2,1,5,10,0,3,1,1,0.66,0.6212,0.61,0.0,43,149,192,192,True
11911,2012-05-16,2,1,5,11,0,3,1,1,0.7,0.6515,0.54,0.1343,55,212,267,267,True
11912,2012-05-16,2,1,5,12,0,3,1,1,0.7,0.6515,0.54,0.194,59,271,330,330,True
11913,2012-05-16,2,1,5,13,0,3,1,1,0.72,0.6515,0.42,0.0,77,273,350,350,True
11914,2012-05-16,2,1,5,14,0,3,1,1,0.72,0.6515,0.42,0.0896,42,221,263,263,True
11915,2012-05-16,2,1,5,15,0,3,1,2,0.72,0.6667,0.48,0.1045,52,222,274,274,True
11916,2012-05-16,2,1,5,16,0,3,1,1,0.72,0.6515,0.45,0.1045,70,376,446,446,True
11917,2012-05-16,2,1,5,17,0,3,1,1,0.72,0.6667,0.51,0.194,104,499,603,603,True
11918,2012-05-16,2,1,5,18,0,3,1,1,0.72,0.6667,0.51,0.2239,97,499,596,596,True
11919,2012-05-16,2,1,5,19,0,3,1,1,0.7,0.6515,0.54,0.2836,91,499,590,590,True
11920,2012-05-16,2,1,5,20,0,3,1,1,0.66,0.6212,0.65,0.2537,61,398,459,459,True
11921,2012-05-16,2,1,5,21,0,3,1,1,0.64,0.6061,0.73,0.194,63,330,393,393,True
11922,2012-05-16,2,1,5,22,0,3,1,1,0.64,0.6061,0.73,0.1642,33,253,286,286,True
11923,2012-05-16,2,1,5,23,0,3,1,1,0.62,0.5909,0.78,0.1045,26,107,133,133,True
11924,2012-05-17,2,1,5,0,0,4,1,1,0.6,0.5758,0.78,0.1343,30,49,79,79,True
11925,2012-05-17,2,1,5,1,0,4,1,1,0.6,0.5606,0.83,0.1642,12,16,28,28,True
11926,2012-05-17,2,1,5,2,0,4,1,1,0.6,0.5758,0.78,0.1642,8,8,16,16,True
11927,2012-05-17,2,1,5,3,0,4,1,1,0.6,0.5909,0.73,0.2537,0,3,3,3,True
11928,2012-05-17,2,1,5,4,0,4,1,1,0.6,0.6061,0.64,0.3284,3,13,16,16,True
11929,2012-05-17,2,1,5,5,0,4,1,1,0.56,0.5303,0.68,0.3284,1,34,35,35,True
11930,2012-05-17,2,1,5,6,0,4,1,1,0.54,0.5152,0.73,0.3582,10,149,159,159,True
11931,2012-05-17,2,1,5,7,0,4,1,1,0.54,0.5152,0.73,0.3881,25,449,474,474,True
11932,2012-05-17,2,1,5,8,0,4,1,1,0.52,0.5,0.55,0.4478,29,499,528,528,True
11933,2012-05-17,2,1,5,9,0,4,1,1,0.54,0.5152,0.52,0.4179,57,289,346,346,True
11934,2012-05-17,2,1,5,10,0,4,1,1,0.56,0.5303,0.52,0.2537,43,162,205,205,True
11935,2012-05-17,2,1,5,11,0,4,1,1,0.58,0.5455,0.49,0.2239,77,202,279,279,True
11936,2012-05-17,2,1,5,12,0,4,1,1,0.6,0.6212,0.43,0.194,72,276,348,348,True
11937,2012-05-17,2,1,5,13,0,4,1,1,0.62,0.6212,0.41,0.194,86,241,327,327,True
11938,2012-05-17,2,1,5,14,0,4,1,1,0.64,0.6212,0.38,0.194,68,202,270,270,True
11939,2012-05-17,2,1,5,15,0,4,1,1,0.64,0.6212,0.36,0.2537,83,233,316,316,True
11940,2012-05-17,2,1,5,16,0,4,1,1,0.66,0.6212,0.31,0.194,86,344,430,430,True
11941,2012-05-17,2,1,5,17,0,4,1,1,0.66,0.6212,0.31,0.1343,114,499,613,613,True
11942,2012-05-17,2,1,5,18,0,4,1,1,0.66,0.6212,0.27,0.1642,114,499,613,613,True
11943,2012-05-17,2,1,5,19,0,4,1,1,0.64,0.6212,0.31,0.194,86,451,537,537,True
11944,2012-05-17,2,1,5,20,0,4,1,1,0.6,0.6212,0.4,0.194,83,363,446,446,True
11945,2012-05-17,2,1,5,21,0,4,1,1,0.58,0.5455,0.4,0.1045,45,254,299,299,True
11946,2012-05-17,2,1,5,22,0,4,1,1,0.56,0.5303,0.43,0.0896,42,209,251,251,True
11947,2012-05-17,2,1,5,23,0,4,1,1,0.54,0.5152,0.49,0.1343,29,137,166,166,True
11948,2012-05-18,2,1,5,0,0,5,1,1,0.52,0.5,0.59,0.1045,13,57,70,70,True
11949,2012-05-18,2,1,5,1,0,5,1,1,0.5,0.4848,0.59,0.0896,16,33,49,49,True
11950,2012-05-18,2,1,5,2,0,5,1,1,0.48,0.4697,0.67,0.1343,12,9,21,21,True
11951,2012-05-18,2,1,5,3,0,5,1,1,0.46,0.4545,0.72,0.0896,6,8,14,14,True
11952,2012-05-18,2,1,5,4,0,5,1,1,0.46,0.4545,0.77,0.1642,0,11,11,11,True
11953,2012-05-18,2,1,5,5,0,5,1,1,0.46,0.4545,0.77,0.1045,1,33,34,34,True
11954,2012-05-18,2,1,5,6,0,5,1,1,0.44,0.4394,0.77,0.1343,14,168,182,182,True
11955,2012-05-18,2,1,5,7,0,5,1,1,0.46,0.4545,0.82,0.1045,40,475,515,515,True
11956,2012-05-18,2,1,5,8,0,5,1,1,0.52,0.5,0.59,0.1343,49,499,548,548,True
11957,2012-05-18,2,1,5,9,0,5,1,1,0.56,0.5303,0.56,0.1045,57,304,361,361,True
11958,2012-05-18,2,1,5,10,0,5,1,1,0.6,0.6212,0.46,0.1343,74,181,255,255,True
11959,2012-05-18,2,1,5,11,0,5,1,1,0.62,0.6212,0.43,0.0,109,225,334,334,True
11960,2012-05-18,2,1,5,12,0,5,1,1,0.62,0.6212,0.41,0.194,108,252,360,360,True
11961,2012-05-18,2,1,5,13,0,5,1,1,0.64,0.6212,0.36,0.1642,98,297,395,395,True
11962,2012-05-18,2,1,5,14,0,5,1,1,0.66,0.6212,0.34,0.1343,108,242,350,350,True
11963,2012-05-18,2,1,5,15,0,5,1,1,0.66,0.6212,0.36,0.194,114,260,374,374,True
11964,2012-05-18,2,1,5,16,0,5,1,1,0.66,0.6212,0.34,0.2537,114,417,531,531,True
11965,2012-05-18,2,1,5,17,0,5,1,1,0.66,0.6212,0.34,0.1343,114,499,613,613,True
11966,2012-05-18,2,1,5,18,0,5,1,1,0.64,0.6212,0.38,0.2239,99,499,598,598,True
11967,2012-05-18,2,1,5,19,0,5,1,1,0.62,0.6212,0.41,0.194,91,392,483,483,True
11968,2012-05-18,2,1,5,20,0,5,1,1,0.62,0.6212,0.41,0.1642,73,264,337,337,True
11969,2012-05-18,2,1,5,21,0,5,1,1,0.6,0.6212,0.4,0.0,49,209,258,258,True
11970,2012-05-18,2,1,5,22,0,5,1,1,0.56,0.5303,0.52,0.3284,57,194,251,251,True
11971,2012-05-18,2,1,5,23,0,5,1,1,0.52,0.5,0.55,0.0,41,133,174,174,True
11972,2012-05-19,2,1,5,0,0,6,0,1,0.52,0.5,0.48,0.1045,30,118,148,148,True
11973,2012-05-19,2,1,5,1,0,6,0,1,0.5,0.4848,0.48,0.0,20,84,104,104,True
11974,2012-05-19,2,1,5,2,0,6,0,1,0.5,0.4848,0.51,0.1045,13,56,69,69,True
11975,2012-05-19,2,1,5,3,0,6,0,1,0.5,0.4848,0.48,0.1045,10,23,33,33,True
11976,2012-05-19,2,1,5,4,0,6,0,1,0.48,0.4697,0.59,0.0896,6,8,14,14,True
11977,2012-05-19,2,1,5,5,0,6,0,1,0.46,0.4545,0.67,0.0,1,11,12,12,True
11978,2012-05-19,2,1,5,6,0,6,0,1,0.44,0.4394,0.72,0.0896,12,38,50,50,True
11979,2012-05-19,2,1,5,7,0,6,0,1,0.46,0.4545,0.67,0.1045,28,67,95,95,True
11980,2012-05-19,2,1,5,8,0,6,0,1,0.52,0.5,0.52,0.1642,33,162,195,195,True
11981,2012-05-19,2,1,5,9,0,6,0,1,0.56,0.5303,0.43,0.1642,79,213,292,292,True
11982,2012-05-19,2,1,5,10,0,6,0,1,0.56,0.5303,0.43,0.0,114,275,389,389,True
11983,2012-05-19,2,1,5,11,0,6,0,1,0.62,0.6212,0.38,0.0896,114,351,465,465,True
11984,2012-05-19,2,1,5,12,0,6,0,1,0.66,0.6212,0.36,0.0,114,366,480,480,True
11985,2012-05-19,2,1,5,13,0,6,0,1,0.7,0.6364,0.37,0.1343,114,372,486,486,True
11986,2012-05-19,2,1,5,14,0,6,0,1,0.72,0.6515,0.3,0.0896,114,369,483,483,True
11987,2012-05-19,2,1,5,15,0,6,0,1,0.72,0.6515,0.3,0.1045,114,316,430,430,True
11988,2012-05-19,2,1,5,16,0,6,0,1,0.74,0.6515,0.3,0.1045,114,311,425,425,True
11989,2012-05-19,2,1,5,17,0,6,0,1,0.74,0.6515,0.3,0.0896,114,347,461,461,True
11990,2012-05-19,2,1,5,18,0,6,0,1,0.74,0.6515,0.33,0.0896,114,391,505,505,True
11991,2012-05-19,2,1,5,19,0,6,0,1,0.7,0.6364,0.39,0.1343,114,229,343,343,True
11992,2012-05-19,2,1,5,20,0,6,0,1,0.68,0.6364,0.41,0.0896,114,197,311,311,True
11993,2012-05-19,2,1,5,21,0,6,0,1,0.64,0.6212,0.5,0.0,81,178,259,259,True
11994,2012-05-19,2,1,5,22,0,6,0,1,0.64,0.6212,0.47,0.0,104,234,338,338,True
11995,2012-05-19,2,1,5,23,0,6,0,1,0.6,0.6212,0.56,0.1642,71,168,239,239,True
11996,2012-05-20,2,1,5,0,0,0,0,1,0.58,0.5455,0.53,0.1045,42,128,170,170,True
11997,2012-05-20,2,1,5,1,0,0,0,1,0.56,0.5303,0.52,0.0,28,102,130,130,True
11998,2012-05-20,2,1,5,2,0,0,0,1,0.56,0.5303,0.52,0.0,36,62,98,98,True
11999,2012-05-20,2,1,5,3,0,0,0,1,0.54,0.5152,0.56,0.0896,26,40,66,66,True
12000,2012-05-20,2,1,5,4,0,0,0,1,0.52,0.5,0.68,0.0896,2,14,16,16,True
12001,2012-05-20,2,1,5,5,0,0,0,1,0.5,0.4848,0.72,0.1045,1,7,8,8,True
12002,2012-05-20,2,1,5,6,0,0,0,1,0.5,0.4848,0.63,0.1343,4,21,25,25,True
12003,2012-05-20,2,1,5,7,0,0,0,1,0.52,0.5,0.68,0.194,35,55,90,90,True
12004,2012-05-20,2,1,5,8,0,0,0,1,0.56,0.5303,0.56,0.1642,51,120,171,171,True
12005,2012-05-20,2,1,5,9,0,0,0,1,0.62,0.6212,0.32,0.2537,114,184,298,298,True
12006,2012-05-20,2,1,5,10,0,0,0,1,0.66,0.6212,0.34,0.2985,114,258,372,372,True
12007,2012-05-20,2,1,5,11,0,0,0,1,0.66,0.6212,0.36,0.3284,114,323,437,437,True
12008,2012-05-20,2,1,5,12,0,0,0,1,0.68,0.6364,0.36,0.3284,114,390,504,504,True
12009,2012-05-20,2,1,5,13,0,0,0,1,0.7,0.6364,0.37,0.2836,114,363,477,477,True
12010,2012-05-20,2,1,5,14,0,0,0,1,0.72,0.6515,0.39,0.3881,114,307,421,421,True
12011,2012-05-20,2,1,5,15,0,0,0,2,0.7,0.6364,0.39,0.4179,114,256,370,370,True
12012,2012-05-20,2,1,5,16,0,0,0,1,0.72,0.6515,0.42,0.3582,114,339,453,453,True
12013,2012-05-20,2,1,5,17,0,0,0,1,0.72,0.6515,0.45,0.3284,114,340,454,454,True
12014,2012-05-20,2,1,5,18,0,0,0,1,0.7,0.6515,0.51,0.3284,114,328,442,442,True
12015,2012-05-20,2,1,5,19,0,0,0,1,0.66,0.6212,0.61,0.4179,114,260,374,374,True
12016,2012-05-20,2,1,5,20,0,0,0,1,0.66,0.6212,0.61,0.4179,83,191,274,274,True
12017,2012-05-20,2,1,5,21,0,0,0,1,0.64,0.6061,0.69,0.3881,51,182,233,233,True
12018,2012-05-20,2,1,5,22,0,0,0,1,0.62,0.5909,0.73,0.3284,44,101,145,145,True
12019,2012-05-20,2,1,5,23,0,0,0,3,0.6,0.5758,0.78,0.3582,32,54,86,86,True
12020,2012-05-21,2,1,5,0,0,1,1,3,0.58,0.5455,0.88,0.2985,12,28,40,40,True
12021,2012-05-21,2,1,5,1,0,1,1,3,0.58,0.5455,0.88,0.3582,4,11,15,15,True
12022,2012-05-21,2,1,5,2,0,1,1,3,0.56,0.5303,0.94,0.2537,2,9,11,11,True
12023,2012-05-21,2,1,5,3,0,1,1,2,0.56,0.5303,0.88,0.2985,0,2,2,2,True
12024,2012-05-21,2,1,5,4,0,1,1,3,0.56,0.5303,0.88,0.2985,2,5,7,7,True
12025,2012-05-21,2,1,5,5,0,1,1,3,0.56,0.5303,0.88,0.2985,1,14,15,15,True
12026,2012-05-21,2,1,5,6,0,1,1,3,0.56,0.5303,0.88,0.2985,3,76,79,79,True
12027,2012-05-21,2,1,5,7,0,1,1,3,0.56,0.5303,0.88,0.2985,7,146,153,153,True
12028,2012-05-21,2,1,5,8,0,1,1,3,0.56,0.5303,0.88,0.2537,12,258,270,270,True
12029,2012-05-21,2,1,5,9,0,1,1,3,0.56,0.5303,0.88,0.2239,14,172,186,186,True
12030,2012-05-21,2,1,5,10,0,1,1,3,0.58,0.5455,0.88,0.2836,28,71,99,99,True
12031,2012-05-21,2,1,5,11,0,1,1,2,0.6,0.5606,0.83,0.1642,24,82,106,106,True
12032,2012-05-21,2,1,5,12,0,1,1,2,0.6,0.5606,0.83,0.2537,46,124,170,170,True
12033,2012-05-21,2,1,5,13,0,1,1,3,0.6,0.5606,0.83,0.2537,49,135,184,184,True
12034,2012-05-21,2,1,5,14,0,1,1,3,0.6,0.5606,0.83,0.194,45,135,180,180,True
12035,2012-05-21,2,1,5,15,0,1,1,2,0.64,0.6061,0.73,0.194,67,158,225,225,True
12036,2012-05-21,2,1,5,16,0,1,1,2,0.64,0.6061,0.73,0.2537,46,269,315,315,True
12037,2012-05-21,2,1,5,17,0,1,1,2,0.66,0.6212,0.69,0.2537,40,468,508,508,True
12038,2012-05-21,2,1,5,18,0,1,1,1,0.64,0.6061,0.73,0.1045,52,478,530,530,True
12039,2012-05-21,2,1,5,19,0,1,1,1,0.66,0.6212,0.69,0.0896,57,391,448,448,True
12040,2012-05-21,2,1,5,20,0,1,1,1,0.64,0.6061,0.69,0.1343,44,292,336,336,True
12041,2012-05-21,2,1,5,21,0,1,1,1,0.62,0.6061,0.69,0.0896,31,210,241,241,True
12042,2012-05-21,2,1,5,22,0,1,1,2,0.62,0.5909,0.73,0.1642,26,116,142,142,True
12043,2012-05-21,2,1,5,23,0,1,1,1,0.62,0.5909,0.73,0.2836,18,79,97,97,True
12044,2012-05-22,2,1,5,0,0,2,1,1,0.58,0.5455,0.83,0.2537,10,26,36,36,True
12045,2012-05-22,2,1,5,1,0,2,1,2,0.58,0.5455,0.83,0.1343,11,16,27,27,True
12046,2012-05-22,2,1,5,2,0,2,1,2,0.58,0.5455,0.83,0.1045,1,10,11,11,True
12047,2012-05-22,2,1,5,3,0,2,1,2,0.58,0.5455,0.83,0.1045,0,5,5,5,True
12048,2012-05-22,2,1,5,4,0,2,1,2,0.56,0.5303,0.88,0.1642,0,7,7,7,True
12049,2012-05-22,2,1,5,5,0,2,1,3,0.56,0.5303,0.88,0.194,0,17,17,17,True
12050,2012-05-22,2,1,5,6,0,2,1,3,0.56,0.5303,0.88,0.1045,8,129,137,137,True
12051,2012-05-22,2,1,5,7,0,2,1,3,0.56,0.5303,0.88,0.1045,9,315,324,324,True
12052,2012-05-22,2,1,5,8,0,2,1,2,0.56,0.5303,0.88,0.1343,20,499,519,519,True
12053,2012-05-22,2,1,5,9,0,2,1,2,0.6,0.5606,0.83,0.1045,46,287,333,333,True
12054,2012-05-22,2,1,5,10,0,2,1,2,0.6,0.5758,0.78,0.0896,52,148,200,200,True
12055,2012-05-22,2,1,5,11,0,2,1,2,0.6,0.5758,0.78,0.0,39,150,189,189,True
12056,2012-05-22,2,1,5,12,0,2,1,2,0.62,0.5909,0.78,0.1045,76,178,254,254,True
12057,2012-05-22,2,1,5,13,0,2,1,2,0.64,0.6061,0.73,0.0,48,195,243,243,True
12058,2012-05-22,2,1,5,14,0,2,1,2,0.64,0.6061,0.73,0.1045,73,149,222,222,True
12059,2012-05-22,2,1,5,15,0,2,1,1,0.7,0.6515,0.61,0.0896,54,191,245,245,True
12060,2012-05-22,2,1,5,16,0,2,1,1,0.68,0.6364,0.61,0.1045,70,316,386,386,True
12061,2012-05-22,2,1,5,17,0,2,1,1,0.72,0.6667,0.54,0.0,69,499,568,568,True
12062,2012-05-22,2,1,5,18,0,2,1,1,0.68,0.6364,0.61,0.1343,76,499,575,575,True
12063,2012-05-22,2,1,5,19,0,2,1,1,0.66,0.6212,0.69,0.2239,44,320,364,364,True
12064,2012-05-22,2,1,5,20,0,2,1,1,0.64,0.6061,0.73,0.2537,54,319,373,373,True
12065,2012-05-22,2,1,5,21,0,2,1,1,0.62,0.5909,0.78,0.1343,28,233,261,261,True
12066,2012-05-22,2,1,5,22,0,2,1,1,0.62,0.5909,0.73,0.0896,17,157,174,174,True
12067,2012-05-22,2,1,5,23,0,2,1,1,0.62,0.5909,0.73,0.1045,14,91,105,105,True
12068,2012-05-23,2,1,5,0,0,3,1,1,0.62,0.5909,0.78,0.1343,19,28,47,47,True
12069,2012-05-23,2,1,5,1,0,3,1,1,0.6,0.5606,0.83,0.1642,23,9,32,32,True
12070,2012-05-23,2,1,5,2,0,3,1,2,0.6,0.5606,0.83,0.1642,2,10,12,12,True
12071,2012-05-23,2,1,5,3,0,3,1,1,0.6,0.5758,0.78,0.1045,0,5,5,5,True
12072,2012-05-23,2,1,5,4,0,3,1,3,0.58,0.5455,0.83,0.194,0,3,3,3,True
12073,2012-05-23,2,1,5,5,0,3,1,3,0.56,0.5303,0.88,0.2537,6,29,35,35,True
12074,2012-05-23,2,1,5,6,0,3,1,1,0.56,0.5303,0.88,0.1045,6,154,160,160,True
12075,2012-05-23,2,1,5,7,0,3,1,1,0.58,0.5455,0.83,0.0,16,452,468,468,True
12076,2012-05-23,2,1,5,8,0,3,1,1,0.58,0.5455,0.83,0.0,38,499,537,537,True
12077,2012-05-23,2,1,5,9,0,3,1,2,0.62,0.5909,0.78,0.0,39,258,297,297,True
12078,2012-05-23,2,1,5,10,0,3,1,1,0.62,0.5909,0.78,0.0896,52,139,191,191,True
12079,2012-05-23,2,1,5,11,0,3,1,1,0.64,0.6061,0.73,0.0,46,151,197,197,True
12080,2012-05-23,2,1,5,12,0,3,1,2,0.66,0.6212,0.69,0.0896,42,206,248,248,True
12081,2012-05-23,2,1,5,13,0,3,1,2,0.66,0.6212,0.74,0.1642,69,201,270,270,True
12082,2012-05-23,2,1,5,14,0,3,1,1,0.68,0.6364,0.65,0.1343,67,181,248,248,True
12083,2012-05-23,2,1,5,15,0,3,1,2,0.7,0.6515,0.61,0.0,65,192,257,257,True
12084,2012-05-23,2,1,5,16,0,3,1,3,0.7,0.6515,0.61,0.0896,62,216,278,278,True
12085,2012-05-23,2,1,5,17,0,3,1,3,0.64,0.6061,0.69,0.1045,45,240,285,285,True
12086,2012-05-23,2,1,5,18,0,3,1,3,0.64,0.6061,0.69,0.1045,31,296,327,327,True
12087,2012-05-23,2,1,5,19,0,3,1,2,0.62,0.5758,0.83,0.1642,40,336,376,376,True
12088,2012-05-23,2,1,5,20,0,3,1,2,0.62,0.5758,0.83,0.0896,28,267,295,295,True
12089,2012-05-23,2,1,5,21,0,3,1,2,0.62,0.5758,0.83,0.0,24,221,245,245,True
12090,2012-05-23,2,1,5,22,0,3,1,2,0.62,0.5758,0.83,0.1642,23,136,159,159,True
12091,2012-05-23,2,1,5,23,0,3,1,1,0.6,0.5606,0.83,0.1343,23,83,106,106,True
12092,2012-05-24,2,1,5,0,0,4,1,1,0.6,0.5606,0.83,0.0896,7,49,56,56,True
12093,2012-05-24,2,1,5,1,0,4,1,1,0.6,0.5455,0.88,0.0896,9,21,30,30,True
12094,2012-05-24,2,1,5,2,0,4,1,1,0.6,0.5455,0.88,0.0,1,15,16,16,True
12095,2012-05-24,2,1,5,3,0,4,1,2,0.6,0.5455,0.88,0.1045,1,3,4,4,True
12096,2012-05-24,2,1,5,4,0,4,1,2,0.6,0.5455,0.88,0.1642,0,5,5,5,True
12097,2012-05-24,2,1,5,5,0,4,1,2,0.6,0.5455,0.88,0.1642,1,29,30,30,True
12098,2012-05-24,2,1,5,6,0,4,1,2,0.6,0.5455,0.88,0.1642,10,146,156,156,True
12099,2012-05-24,2,1,5,7,0,4,1,1,0.6,0.5606,0.83,0.1045,22,393,415,415,True
12100,2012-05-24,2,1,5,8,0,4,1,1,0.62,0.5909,0.73,0.1343,33,499,532,532,True
12101,2012-05-24,2,1,5,9,0,4,1,1,0.62,0.5909,0.73,0.1642,34,267,301,301,True
12102,2012-05-24,2,1,5,10,0,4,1,1,0.64,0.6061,0.65,0.1343,47,138,185,185,True
12103,2012-05-24,2,1,5,11,0,4,1,1,0.66,0.6212,0.65,0.1343,61,160,221,221,True
12104,2012-05-24,2,1,5,12,0,4,1,1,0.7,0.6515,0.58,0.1045,76,213,289,289,True
12105,2012-05-24,2,1,5,13,0,4,1,1,0.72,0.6667,0.54,0.1642,69,233,302,302,True
12106,2012-05-24,2,1,5,14,0,4,1,1,0.74,0.6818,0.55,0.2239,72,180,252,252,True
12107,2012-05-24,2,1,5,15,0,4,1,1,0.74,0.6818,0.55,0.2537,69,222,291,291,True
12108,2012-05-24,2,1,5,16,0,4,1,1,0.74,0.6818,0.55,0.3582,61,329,390,390,True
12109,2012-05-24,2,1,5,17,0,4,1,1,0.74,0.6818,0.55,0.2836,114,499,613,613,True
12110,2012-05-24,2,1,5,18,0,4,1,1,0.72,0.6667,0.54,0.3284,114,499,613,613,True
12111,2012-05-24,2,1,5,19,0,4,1,1,0.7,0.6515,0.61,0.2985,76,416,492,492,True
12112,2012-05-24,2,1,5,20,0,4,1,2,0.66,0.6212,0.69,0.2836,55,343,398,398,True
12113,2012-05-24,2,1,5,21,0,4,1,3,0.64,0.5909,0.78,0.1642,48,237,285,285,True
12114,2012-05-24,2,1,5,22,0,4,1,2,0.64,0.5909,0.78,0.1045,33,210,243,243,True
12115,2012-05-24,2,1,5,23,0,4,1,2,0.64,0.5909,0.78,0.1343,36,131,167,167,True
12116,2012-05-25,2,1,5,0,0,5,1,1,0.62,0.5758,0.83,0.1343,10,63,73,73,True
12117,2012-05-25,2,1,5,1,0,5,1,1,0.62,0.5758,0.83,0.0896,8,34,42,42,True
12118,2012-05-25,2,1,5,2,0,5,1,2,0.62,0.5758,0.83,0.0,7,16,23,23,True
12119,2012-05-25,2,1,5,3,0,5,1,2,0.62,0.5606,0.88,0.1045,8,6,14,14,True
12120,2012-05-25,2,1,5,4,0,5,1,2,0.62,0.5606,0.88,0.0,3,6,9,9,True
12121,2012-05-25,2,1,5,5,0,5,1,2,0.62,0.5606,0.88,0.0896,2,28,30,30,True
12122,2012-05-25,2,1,5,6,0,5,1,2,0.62,0.5606,0.88,0.1045,5,108,113,113,True
12123,2012-05-25,2,1,5,7,0,5,1,2,0.62,0.5606,0.88,0.1642,7,352,359,359,True
12124,2012-05-25,2,1,5,8,0,5,1,2,0.64,0.5758,0.89,0.1045,32,499,531,531,True
12125,2012-05-25,2,1,5,9,0,5,1,2,0.64,0.5758,0.89,0.1343,52,288,340,340,True
12126,2012-05-25,2,1,5,10,0,5,1,1,0.68,0.6364,0.79,0.1642,69,163,232,232,True
12127,2012-05-25,2,1,5,11,0,5,1,1,0.68,0.6364,0.79,0.1343,90,193,283,283,True
12128,2012-05-25,2,1,5,12,0,5,1,1,0.72,0.6818,0.66,0.1045,84,237,321,321,True
12129,2012-05-25,2,1,5,13,0,5,1,1,0.74,0.6818,0.62,0.1343,86,247,333,333,True
12130,2012-05-25,2,1,5,14,0,5,1,1,0.74,0.6818,0.58,0.1343,104,263,367,367,True
12131,2012-05-25,2,1,5,15,0,5,1,1,0.76,0.7121,0.62,0.194,106,360,466,466,True
12132,2012-05-25,2,1,5,16,0,5,1,1,0.78,0.7121,0.52,0.2239,114,447,561,561,True
12133,2012-05-25,2,1,5,17,0,5,1,1,0.76,0.7121,0.62,0.2836,114,499,613,613,True
12134,2012-05-25,2,1,5,18,0,5,1,1,0.76,0.7121,0.62,0.194,114,391,505,505,True
12135,2012-05-25,2,1,5,19,0,5,1,1,0.74,0.6818,0.62,0.2537,111,293,404,404,True
12136,2012-05-25,2,1,5,20,0,5,1,1,0.7,0.6515,0.65,0.1642,80,270,350,350,True
12137,2012-05-25,2,1,5,21,0,5,1,1,0.7,0.6515,0.65,0.1343,62,193,255,255,True
12138,2012-05-25,2,1,5,22,0,5,1,1,0.66,0.6212,0.74,0.1045,65,147,212,212,True
12139,2012-05-25,2,1,5,23,0,5,1,1,0.66,0.6061,0.78,0.2239,34,132,166,166,True
12140,2012-05-26,2,1,5,0,0,6,0,1,0.64,0.5758,0.83,0.1642,18,98,116,116,True
12141,2012-05-26,2,1,5,1,0,6,0,1,0.64,0.5758,0.83,0.1343,18,64,82,82,True
12142,2012-05-26,2,1,5,2,0,6,0,1,0.64,0.5758,0.89,0.1343,9,55,64,64,True
12143,2012-05-26,2,1,5,3,0,6,0,1,0.62,0.5606,0.88,0.1045,9,22,31,31,True
12144,2012-05-26,2,1,5,4,0,6,0,1,0.62,0.5606,0.88,0.1343,0,2,2,2,True
12145,2012-05-26,2,1,5,5,0,6,0,1,0.62,0.5758,0.83,0.2537,0,10,10,10,True
12146,2012-05-26,2,1,5,6,0,6,0,1,0.62,0.5606,0.88,0.194,6,25,31,31,True
12147,2012-05-26,2,1,5,7,0,6,0,2,0.62,0.5606,0.88,0.1642,10,44,54,54,True
12148,2012-05-26,2,1,5,8,0,6,0,1,0.64,0.5909,0.78,0.1343,38,103,141,141,True
12149,2012-05-26,2,1,5,9,0,6,0,1,0.64,0.5758,0.83,0.194,97,192,289,289,True
12150,2012-05-26,2,1,5,10,0,6,0,1,0.68,0.6364,0.79,0.2239,114,256,370,370,True
12151,2012-05-26,2,1,5,11,0,6,0,1,0.7,0.6667,0.74,0.194,114,312,426,426,True
12152,2012-05-26,2,1,5,12,0,6,0,1,0.74,0.697,0.66,0.2239,114,293,407,407,True
12153,2012-05-26,2,1,5,13,0,6,0,1,0.76,0.7273,0.66,0.194,114,274,388,388,True
12154,2012-05-26,2,1,5,14,0,6,0,1,0.76,0.7273,0.66,0.2239,114,257,371,371,True
12155,2012-05-26,2,1,5,15,0,6,0,1,0.76,0.7273,0.66,0.2836,114,239,353,353,True
12156,2012-05-26,2,1,5,16,0,6,0,1,0.78,0.7273,0.55,0.2537,114,243,357,357,True
12157,2012-05-26,2,1,5,17,0,6,0,2,0.78,0.7121,0.52,0.2537,114,227,341,341,True
12158,2012-05-26,2,1,5,18,0,6,0,2,0.76,0.697,0.52,0.194,114,216,330,330,True
12159,2012-05-26,2,1,5,19,0,6,0,2,0.74,0.697,0.66,0.2239,114,214,328,328,True
12160,2012-05-26,2,1,5,20,0,6,0,2,0.74,0.6818,0.55,0.194,103,152,255,255,True
12161,2012-05-26,2,1,5,21,0,6,0,2,0.72,0.6818,0.62,0.194,100,151,251,251,True
12162,2012-05-26,2,1,5,22,0,6,0,1,0.7,0.6667,0.74,0.2537,86,118,204,204,True
12163,2012-05-26,2,1,5,23,0,6,0,1,0.7,0.6667,0.74,0.2537,36,114,150,150,True
12164,2012-05-27,2,1,5,0,0,0,0,2,0.68,0.6364,0.69,0.1642,48,89,137,137,True
12165,2012-05-27,2,1,5,1,0,0,0,1,0.66,0.6212,0.74,0.2239,17,61,78,78,True
12166,2012-05-27,2,1,5,2,0,0,0,1,0.64,0.6061,0.73,0.2239,16,45,61,61,True
12167,2012-05-27,2,1,5,3,0,0,0,1,0.64,0.6061,0.73,0.1642,11,25,36,36,True
12168,2012-05-27,2,1,5,4,0,0,0,1,0.62,0.5758,0.83,0.194,4,7,11,11,True
12169,2012-05-27,2,1,5,5,0,0,0,1,0.62,0.5758,0.83,0.194,2,5,7,7,True
12170,2012-05-27,2,1,5,6,0,0,0,1,0.62,0.5758,0.83,0.1642,8,14,22,22,True
12171,2012-05-27,2,1,5,7,0,0,0,1,0.62,0.5606,0.88,0.1642,22,30,52,52,True
12172,2012-05-27,2,1,5,8,0,0,0,1,0.64,0.5758,0.83,0.194,69,82,151,151,True
12173,2012-05-27,2,1,5,9,0,0,0,1,0.66,0.6061,0.83,0.2239,114,140,254,254,True
12174,2012-05-27,2,1,5,10,0,0,0,1,0.68,0.6364,0.74,0.2537,114,215,329,329,True
12175,2012-05-27,2,1,5,11,0,0,0,1,0.72,0.6818,0.66,0.2239,114,251,365,365,True
12176,2012-05-27,2,1,5,12,0,0,0,1,0.74,0.697,0.66,0.2537,114,269,383,383,True
12177,2012-05-27,2,1,5,13,0,0,0,1,0.76,0.7121,0.58,0.194,114,228,342,342,True
12178,2012-05-27,2,1,5,14,0,0,0,1,0.76,0.7121,0.58,0.2537,114,230,344,344,True
12179,2012-05-27,2,1,5,15,0,0,0,1,0.78,0.7121,0.52,0.2836,114,245,359,359,True
12180,2012-05-27,2,1,5,16,0,0,0,1,0.78,0.7121,0.52,0.2836,114,243,357,357,True
12181,2012-05-27,2,1,5,17,0,0,0,1,0.78,0.7121,0.49,0.2985,114,247,361,361,True
12182,2012-05-27,2,1,5,18,0,0,0,1,0.76,0.7121,0.58,0.2985,114,252,366,366,True
12183,2012-05-27,2,1,5,19,0,0,0,1,0.76,0.7121,0.58,0.194,114,212,326,326,True
12184,2012-05-27,2,1,5,20,0,0,0,1,0.74,0.6818,0.55,0.1642,114,224,338,338,True
12185,2012-05-27,2,1,5,21,0,0,0,3,0.66,0.6212,0.69,0.4179,64,79,143,143,True
12186,2012-05-27,2,1,5,22,0,0,0,3,0.62,0.5758,0.83,0.0,9,50,59,59,True
12187,2012-05-27,2,1,5,23,0,0,0,3,0.62,0.5758,0.83,0.1343,31,65,96,96,True
12188,2012-05-28,2,1,5,0,1,1,0,1,0.62,0.5758,0.83,0.2239,21,44,65,65,True
12189,2012-05-28,2,1,5,1,1,1,0,2,0.62,0.5909,0.78,0.2985,14,45,59,59,True
12190,2012-05-28,2,1,5,2,1,1,0,1,0.6,0.5606,0.83,0.2239,20,28,48,48,True
12191,2012-05-28,2,1,5,3,1,1,0,1,0.62,0.5909,0.73,0.1642,6,12,18,18,True
12192,2012-05-28,2,1,5,4,1,1,0,1,0.6,0.5758,0.78,0.1343,2,4,6,6,True
12193,2012-05-28,2,1,5,5,1,1,0,1,0.6,0.5758,0.78,0.1343,4,5,9,9,True
12194,2012-05-28,2,1,5,6,1,1,0,1,0.62,0.5909,0.73,0.1642,6,14,20,20,True
12195,2012-05-28,2,1,5,7,1,1,0,1,0.62,0.5909,0.78,0.1045,24,43,67,67,True
12196,2012-05-28,2,1,5,8,1,1,0,1,0.66,0.6212,0.69,0.0,62,93,155,155,True
12197,2012-05-28,2,1,5,9,1,1,0,1,0.7,0.6515,0.61,0.0,114,142,256,256,True
12198,2012-05-28,2,1,5,10,1,1,0,1,0.7,0.6515,0.61,0.0,114,175,289,289,True
12199,2012-05-28,2,1,5,11,1,1,0,1,0.72,0.6818,0.66,0.1343,114,222,336,336,True
12200,2012-05-28,2,1,5,12,1,1,0,1,0.76,0.7121,0.62,0.1343,114,292,406,406,True
12201,2012-05-28,2,1,5,13,1,1,0,1,0.8,0.7879,0.63,0.2836,114,284,398,398,True
12202,2012-05-28,2,1,5,14,1,1,0,1,0.8,0.7879,0.63,0.2836,114,227,341,341,True
12203,2012-05-28,2,1,5,15,1,1,0,1,0.82,0.7879,0.56,0.2985,114,279,393,393,True
12204,2012-05-28,2,1,5,16,1,1,0,1,0.82,0.7879,0.56,0.3284,114,278,392,392,True
12205,2012-05-28,2,1,5,17,1,1,0,1,0.82,0.7879,0.56,0.2985,114,247,361,361,True
12206,2012-05-28,2,1,5,18,1,1,0,1,0.8,0.7727,0.59,0.2985,114,251,365,365,True
12207,2012-05-28,2,1,5,19,1,1,0,1,0.8,0.7576,0.55,0.2985,114,247,361,361,True
12208,2012-05-28,2,1,5,20,1,1,0,1,0.78,0.7424,0.62,0.2985,114,203,317,317,True
12209,2012-05-28,2,1,5,21,1,1,0,1,0.76,0.7273,0.66,0.2836,66,181,247,247,True
12210,2012-05-28,2,1,5,22,1,1,0,1,0.74,0.697,0.7,0.1642,47,110,157,157,True
12211,2012-05-28,2,1,5,23,1,1,0,1,0.72,0.697,0.74,0.1642,22,60,82,82,True
12212,2012-05-29,2,1,5,0,0,2,1,1,0.7,0.6667,0.79,0.194,12,33,45,45,True
12213,2012-05-29,2,1,5,1,0,2,1,1,0.7,0.6667,0.79,0.194,1,13,14,14,True
12214,2012-05-29,2,1,5,2,0,2,1,1,0.68,0.6364,0.83,0.1343,0,8,8,8,True
12215,2012-05-29,2,1,5,3,0,2,1,1,0.68,0.6364,0.79,0.2836,1,2,3,3,True
12216,2012-05-29,2,1,5,4,0,2,1,1,0.66,0.6061,0.78,0.2239,0,5,5,5,True
12217,2012-05-29,2,1,5,5,0,2,1,1,0.66,0.6061,0.78,0.2239,1,32,33,33,True
12218,2012-05-29,2,1,5,6,0,2,1,1,0.66,0.6061,0.78,0.2239,9,145,154,154,True
12219,2012-05-29,2,1,5,7,0,2,1,1,0.66,0.6061,0.78,0.2239,19,431,450,450,True
12220,2012-05-29,2,1,5,8,0,2,1,1,0.7,0.6667,0.74,0.194,46,499,545,545,True
12221,2012-05-29,2,1,5,9,0,2,1,1,0.72,0.6818,0.7,0.2537,26,231,257,257,True
12222,2012-05-29,2,1,5,10,0,2,1,1,0.74,0.697,0.7,0.2985,67,116,183,183,True
12223,2012-05-29,2,1,5,11,0,2,1,1,0.76,0.7121,0.62,0.2985,50,147,197,197,True
12224,2012-05-29,2,1,5,12,0,2,1,1,0.8,0.7576,0.55,0.3284,56,181,237,237,True
12225,2012-05-29,2,1,5,13,0,2,1,1,0.82,0.7727,0.52,0.3881,63,176,239,239,True
12226,2012-05-29,2,1,5,14,0,2,1,1,0.82,0.7727,0.52,0.4179,80,158,238,238,True
12227,2012-05-29,2,1,5,15,0,2,1,1,0.82,0.7727,0.49,0.3881,71,185,256,256,True
12228,2012-05-29,2,1,5,16,0,2,1,1,0.82,0.7727,0.49,0.4775,73,320,393,393,True
12229,2012-05-29,2,1,5,17,0,2,1,1,0.82,0.7576,0.46,0.4179,107,499,606,606,True
12230,2012-05-29,2,1,5,18,0,2,1,1,0.8,0.7424,0.49,0.4775,78,499,577,577,True
12231,2012-05-29,2,1,5,19,0,2,1,1,0.78,0.7121,0.52,0.3582,69,457,526,526,True
12232,2012-05-29,2,1,5,20,0,2,1,3,0.7,0.6515,0.61,0.4775,36,168,204,204,True
12233,2012-05-29,2,1,5,21,0,2,1,3,0.6,0.5455,0.88,0.4478,3,68,71,71,True
12234,2012-05-29,2,1,5,22,0,2,1,2,0.62,0.5606,0.88,0.0896,2,53,55,55,True
12235,2012-05-29,2,1,5,23,0,2,1,3,0.62,0.5455,0.94,0.0,10,40,50,50,True
12236,2012-05-30,2,1,5,0,0,3,1,3,0.64,0.5758,0.89,0.1045,4,32,36,36,True
12237,2012-05-30,2,1,5,1,0,3,1,3,0.64,0.5758,0.89,0.194,0,4,4,4,True
12238,2012-05-30,2,1,5,2,0,3,1,3,0.62,0.5455,0.94,0.0896,1,4,5,5,True
12239,2012-05-30,2,1,5,3,0,3,1,3,0.62,0.5606,0.88,0.1343,0,5,5,5,True
12240,2012-05-30,2,1,5,4,0,3,1,2,0.62,0.5606,0.88,0.1343,0,6,6,6,True
12241,2012-05-30,2,1,5,5,0,3,1,2,0.62,0.5909,0.78,0.1343,1,40,41,41,True
12242,2012-05-30,2,1,5,6,0,3,1,2,0.6,0.5758,0.78,0.1045,5,139,144,144,True
12243,2012-05-30,2,1,5,7,0,3,1,3,0.6,0.5758,0.78,0.194,14,469,483,483,True
12244,2012-05-30,2,1,5,8,0,3,1,2,0.6,0.5909,0.73,0.1642,29,499,528,528,True
12245,2012-05-30,2,1,5,9,0,3,1,2,0.62,0.6061,0.69,0.194,23,282,305,305,True
12246,2012-05-30,2,1,5,10,0,3,1,2,0.62,0.6061,0.69,0.2836,39,138,177,177,True
12247,2012-05-30,2,1,5,11,0,3,1,2,0.66,0.6212,0.65,0.194,53,155,208,208,True
12248,2012-05-30,2,1,5,12,0,3,1,1,0.7,0.6515,0.54,0.0,33,220,253,253,True
12249,2012-05-30,2,1,5,13,0,3,1,1,0.7,0.6515,0.51,0.0,53,236,289,289,True
12250,2012-05-30,2,1,5,14,0,3,1,1,0.72,0.6515,0.42,0.1343,44,208,252,252,True
12251,2012-05-30,2,1,5,15,0,3,1,1,0.72,0.6667,0.51,0.1343,54,221,275,275,True
12252,2012-05-30,2,1,5,16,0,3,1,1,0.72,0.6667,0.51,0.1642,46,352,398,398,True
12253,2012-05-30,2,1,5,17,0,3,1,1,0.74,0.6667,0.48,0.0896,83,499,582,582,True
12254,2012-05-30,2,1,5,18,0,3,1,1,0.74,0.6667,0.48,0.1642,50,499,549,549,True
12255,2012-05-30,2,1,5,19,0,3,1,1,0.72,0.6667,0.54,0.1642,50,499,549,549,True
12256,2012-05-30,2,1,5,20,0,3,1,2,0.54,0.5152,0.6,0.1343,57,374,431,431,True
12257,2012-05-30,2,1,5,21,0,3,1,1,0.68,0.6364,0.57,0.1045,41,263,304,304,True
12258,2012-05-30,2,1,5,22,0,3,1,1,0.66,0.6212,0.69,0.1045,26,191,217,217,True
12259,2012-05-30,2,1,5,23,0,3,1,1,0.66,0.6212,0.65,0.1045,39,121,160,160,True
12260,2012-05-31,2,1,5,0,0,4,1,1,0.64,0.6061,0.69,0.1343,13,48,61,61,True
12261,2012-05-31,2,1,5,1,0,4,1,1,0.64,0.6061,0.69,0.0896,4,22,26,26,True
12262,2012-05-31,2,1,5,2,0,4,1,1,0.64,0.6061,0.65,0.0896,6,8,14,14,True
12263,2012-05-31,2,1,5,3,0,4,1,1,0.62,0.6061,0.69,0.0896,0,8,8,8,True
12264,2012-05-31,2,1,5,4,0,4,1,1,0.62,0.6061,0.69,0.0,0,8,8,8,True
12265,2012-05-31,2,1,5,5,0,4,1,1,0.62,0.6061,0.69,0.2537,1,32,33,33,True
12266,2012-05-31,2,1,5,6,0,4,1,1,0.6,0.5909,0.73,0.2239,7,171,178,178,True
12267,2012-05-31,2,1,5,7,0,4,1,1,0.6,0.6061,0.64,0.2836,18,489,507,507,True
12268,2012-05-31,2,1,5,8,0,4,1,1,0.62,0.6212,0.57,0.2537,18,499,517,517,True
12269,2012-05-31,2,1,5,9,0,4,1,1,0.66,0.6212,0.47,0.2537,47,264,311,311,True
12270,2012-05-31,2,1,5,10,0,4,1,1,0.7,0.6364,0.39,0.3881,65,155,220,220,True
12271,2012-05-31,2,1,5,11,0,4,1,1,0.72,0.6515,0.37,0.2836,65,153,218,218,True
12272,2012-05-31,2,1,5,12,0,4,1,1,0.72,0.6515,0.37,0.194,62,230,292,292,True
12273,2012-05-31,2,1,5,13,0,4,1,1,0.74,0.6515,0.35,0.1343,77,216,293,293,True
12274,2012-05-31,2,1,5,14,0,4,1,1,0.76,0.6667,0.31,0.194,61,193,254,254,True
12275,2012-05-31,2,1,5,15,0,4,1,1,0.76,0.6667,0.33,0.2985,81,209,290,290,True
12276,2012-05-31,2,1,5,16,0,4,1,1,0.76,0.6667,0.33,0.2836,103,384,487,487,True
12277,2012-05-31,2,1,5,17,0,4,1,1,0.76,0.6667,0.31,0.1642,85,499,584,584,True
12278,2012-05-31,2,1,5,18,0,4,1,1,0.74,0.6515,0.3,0.194,85,499,584,584,True
12279,2012-05-31,2,1,5,19,0,4,1,1,0.72,0.6515,0.34,0.1642,104,487,591,591,True
12280,2012-05-31,2,1,5,20,0,4,1,1,0.68,0.6364,0.44,0.1642,88,391,479,479,True
12281,2012-05-31,2,1,5,21,0,4,1,1,0.68,0.6364,0.44,0.1642,41,318,359,359,True
12282,2012-05-31,2,1,5,22,0,4,1,1,0.66,0.6212,0.5,0.1642,43,221,264,264,True
12283,2012-05-31,2,1,5,23,0,4,1,1,0.66,0.6212,0.54,0.2239,26,114,140,140,True
12284,2012-06-01,2,1,6,0,0,5,1,1,0.66,0.6212,0.5,0.2537,10,76,86,86,True
12285,2012-06-01,2,1,6,1,0,5,1,1,0.64,0.6212,0.53,0.2239,0,34,34,34,True
12286,2012-06-01,2,1,6,2,0,5,1,1,0.64,0.6212,0.57,0.2239,3,13,16,16,True
12287,2012-06-01,2,1,6,3,0,5,1,2,0.62,0.5909,0.73,0.0896,0,4,4,4,True
12288,2012-06-01,2,1,6,4,0,5,1,2,0.62,0.5909,0.73,0.0896,1,5,6,6,True
12289,2012-06-01,2,1,6,5,0,5,1,2,0.62,0.5909,0.78,0.0896,4,41,45,45,True
12290,2012-06-01,2,1,6,6,0,5,1,3,0.62,0.5606,0.88,0.1343,5,136,141,141,True
12291,2012-06-01,2,1,6,7,0,5,1,2,0.64,0.5758,0.89,0.194,33,369,402,402,True
12292,2012-06-01,2,1,6,8,0,5,1,2,0.64,0.5758,0.89,0.194,19,499,518,518,True
12293,2012-06-01,2,1,6,9,0,5,1,2,0.64,0.5758,0.83,0.2239,24,274,298,298,True
12294,2012-06-01,2,1,6,10,0,5,1,2,0.66,0.6061,0.78,0.2836,49,155,204,204,True
12295,2012-06-01,2,1,6,11,0,5,1,2,0.7,0.6667,0.74,0.2836,42,193,235,235,True
12296,2012-06-01,2,1,6,12,0,5,1,2,0.7,0.6667,0.74,0.3582,72,238,310,310,True
12297,2012-06-01,2,1,6,13,0,5,1,1,0.72,0.6818,0.7,0.2985,76,240,316,316,True
12298,2012-06-01,2,1,6,14,0,5,1,3,0.72,0.6818,0.66,0.2836,55,199,254,254,True
12299,2012-06-01,2,1,6,15,0,5,1,3,0.72,0.6818,0.66,0.2836,45,213,258,258,True
12300,2012-06-01,2,1,6,16,0,5,1,3,0.74,0.6818,0.58,0.4478,36,186,222,222,True
12301,2012-06-01,2,1,6,17,0,5,1,3,0.7,0.6515,0.7,0.2537,25,202,227,227,True
12302,2012-06-01,2,1,6,18,0,5,1,3,0.62,0.5606,0.88,0.3582,10,100,110,110,True
12303,2012-06-01,2,1,6,19,0,5,1,3,0.62,0.5606,0.88,0.3582,4,41,45,45,True
12304,2012-06-01,2,1,6,20,0,5,1,3,0.62,0.5455,0.94,0.2537,1,38,39,39,True
12305,2012-06-01,2,1,6,21,0,5,1,3,0.64,0.5909,0.78,0.2537,12,73,85,85,True
12306,2012-06-01,2,1,6,22,0,5,1,3,0.6,0.5455,0.88,0.1343,1,22,23,23,True
12307,2012-06-01,2,1,6,23,0,5,1,3,0.6,0.5455,0.88,0.1343,6,67,73,73,True
12308,2012-06-02,2,1,6,0,0,6,0,2,0.56,0.5303,0.83,0.1343,5,81,86,86,True
12309,2012-06-02,2,1,6,1,0,6,0,2,0.56,0.5303,0.83,0.1045,15,61,76,76,True
12310,2012-06-02,2,1,6,2,0,6,0,2,0.54,0.5152,0.88,0.0,3,38,41,41,True
12311,2012-06-02,2,1,6,3,0,6,0,1,0.56,0.5303,0.73,0.2537,8,18,26,26,True
12312,2012-06-02,2,1,6,4,0,6,0,1,0.54,0.5152,0.68,0.2836,2,11,13,13,True
12313,2012-06-02,2,1,6,5,0,6,0,1,0.5,0.4848,0.72,0.194,1,11,12,12,True
12314,2012-06-02,2,1,6,6,0,6,0,2,0.5,0.4848,0.77,0.194,5,31,36,36,True
12315,2012-06-02,2,1,6,7,0,6,0,1,0.52,0.5,0.72,0.1045,9,77,86,86,True
12316,2012-06-02,2,1,6,8,0,6,0,1,0.54,0.5152,0.64,0.1642,30,180,210,210,True
12317,2012-06-02,2,1,6,9,0,6,0,1,0.56,0.5303,0.6,0.2537,89,243,332,332,True
12318,2012-06-02,2,1,6,10,0,6,0,1,0.6,0.6212,0.53,0.2985,114,348,462,462,True
12319,2012-06-02,2,1,6,11,0,6,0,1,0.58,0.5455,0.46,0.2836,114,357,471,471,True
12320,2012-06-02,2,1,6,12,0,6,0,1,0.62,0.6212,0.43,0.3582,114,418,532,532,True
12321,2012-06-02,2,1,6,13,0,6,0,1,0.62,0.6212,0.41,0.2537,114,400,514,514,True
12322,2012-06-02,2,1,6,14,0,6,0,1,0.64,0.6212,0.38,0.2985,114,388,502,502,True
12323,2012-06-02,2,1,6,15,0,6,0,1,0.64,0.6212,0.38,0.2537,114,405,519,519,True
12324,2012-06-02,2,1,6,16,0,6,0,1,0.64,0.6212,0.38,0.2537,114,369,483,483,True
12325,2012-06-02,2,1,6,17,0,6,0,1,0.64,0.6212,0.36,0.0,114,338,452,452,True
12326,2012-06-02,2,1,6,18,0,6,0,1,0.64,0.6212,0.36,0.0,114,341,455,455,True
12327,2012-06-02,2,1,6,19,0,6,0,1,0.64,0.6212,0.36,0.1642,114,369,483,483,True
12328,2012-06-02,2,1,6,20,0,6,0,1,0.62,0.6212,0.35,0.2836,114,260,374,374,True
12329,2012-06-02,2,1,6,21,0,6,0,1,0.6,0.6212,0.4,0.1045,96,220,316,316,True
12330,2012-06-02,2,1,6,22,0,6,0,1,0.58,0.5455,0.46,0.1343,52,176,228,228,True
12331,2012-06-02,2,1,6,23,0,6,0,1,0.56,0.5303,0.52,0.1045,53,185,238,238,True
12332,2012-06-03,2,1,6,0,0,0,0,1,0.54,0.5152,0.6,0.1642,27,142,169,169,True
12333,2012-06-03,2,1,6,1,0,0,0,1,0.54,0.5152,0.56,0.1343,21,100,121,121,True
12334,2012-06-03,2,1,6,2,0,0,0,1,0.52,0.5,0.59,0.1045,22,67,89,89,True
12335,2012-06-03,2,1,6,3,0,0,0,1,0.52,0.5,0.63,0.1045,16,34,50,50,True
12336,2012-06-03,2,1,6,4,0,0,0,1,0.5,0.4848,0.72,0.0896,1,12,13,13,True
12337,2012-06-03,2,1,6,5,0,0,0,1,0.5,0.4848,0.68,0.0,1,11,12,12,True
12338,2012-06-03,2,1,6,6,0,0,0,1,0.46,0.4545,0.82,0.1045,6,16,22,22,True
12339,2012-06-03,2,1,6,7,0,0,0,1,0.5,0.4848,0.68,0.1045,6,29,35,35,True
12340,2012-06-03,2,1,6,8,0,0,0,1,0.54,0.5152,0.6,0.0896,30,110,140,140,True
12341,2012-06-03,2,1,6,9,0,0,0,1,0.6,0.6212,0.46,0.194,70,230,300,300,True
12342,2012-06-03,2,1,6,10,0,0,0,1,0.62,0.6212,0.43,0.2239,114,277,391,391,True
12343,2012-06-03,2,1,6,11,0,0,0,1,0.64,0.6212,0.41,0.2537,114,312,426,426,True
12344,2012-06-03,2,1,6,12,0,0,0,1,0.66,0.6212,0.39,0.2985,114,408,522,522,True
12345,2012-06-03,2,1,6,13,0,0,0,1,0.68,0.6364,0.36,0.2836,114,421,535,535,True
12346,2012-06-03,2,1,6,14,0,0,0,1,0.68,0.6364,0.36,0.3284,114,411,525,525,True
12347,2012-06-03,2,1,6,15,0,0,0,1,0.7,0.6364,0.34,0.0,114,408,522,522,True
12348,2012-06-03,2,1,6,16,0,0,0,1,0.7,0.6364,0.34,0.2985,114,436,550,550,True
12349,2012-06-03,2,1,6,17,0,0,0,1,0.7,0.6364,0.34,0.2537,114,386,500,500,True
12350,2012-06-03,2,1,6,18,0,0,0,1,0.7,0.6364,0.34,0.2537,114,343,457,457,True
12351,2012-06-03,2,1,6,19,0,0,0,1,0.68,0.6364,0.34,0.2836,114,337,451,451,True
12352,2012-06-03,2,1,6,20,0,0,0,1,0.66,0.6212,0.39,0.194,84,230,314,314,True
12353,2012-06-03,2,1,6,21,0,0,0,1,0.62,0.6212,0.43,0.1642,66,180,246,246,True
12354,2012-06-03,2,1,6,22,0,0,0,1,0.62,0.6212,0.5,0.3881,61,165,226,226,True
12355,2012-06-03,2,1,6,23,0,0,0,1,0.58,0.5455,0.53,0.1045,26,82,108,108,True
12356,2012-06-04,2,1,6,0,0,1,1,1,0.58,0.5455,0.53,0.0,11,38,49,49,True
12357,2012-06-04,2,1,6,1,0,1,1,3,0.56,0.5303,0.6,0.1642,4,10,14,14,True
12358,2012-06-04,2,1,6,2,0,1,1,1,0.56,0.5303,0.6,0.2239,1,10,11,11,True
12359,2012-06-04,2,1,6,3,0,1,1,2,0.56,0.5303,0.6,0.1642,0,5,5,5,True
12360,2012-06-04,2,1,6,4,0,1,1,1,0.54,0.5152,0.64,0.0896,2,6,8,8,True
12361,2012-06-04,2,1,6,5,0,1,1,1,0.52,0.5,0.68,0.0,2,33,35,35,True
12362,2012-06-04,2,1,6,6,0,1,1,1,0.52,0.5,0.68,0.0,4,135,139,139,True
12363,2012-06-04,2,1,6,7,0,1,1,1,0.56,0.5303,0.6,0.2239,13,499,512,512,True
12364,2012-06-04,2,1,6,8,0,1,1,1,0.6,0.6212,0.49,0.2239,22,499,521,521,True
12365,2012-06-04,2,1,6,9,0,1,1,1,0.62,0.6212,0.43,0.2836,38,244,282,282,True
12366,2012-06-04,2,1,6,10,0,1,1,1,0.64,0.6212,0.41,0.4627,67,120,187,187,True
12367,2012-06-04,2,1,6,11,0,1,1,1,0.64,0.6212,0.38,0.4775,71,168,239,239,True
12368,2012-06-04,2,1,6,12,0,1,1,1,0.64,0.6212,0.41,0.4478,62,220,282,282,True
12369,2012-06-04,2,1,6,13,0,1,1,1,0.64,0.6212,0.41,0.3582,85,189,274,274,True
12370,2012-06-04,2,1,6,14,0,1,1,1,0.62,0.6212,0.41,0.4775,84,186,270,270,True
12371,2012-06-04,2,1,6,15,0,1,1,1,0.66,0.6212,0.39,0.2985,77,215,292,292,True
12372,2012-06-04,2,1,6,16,0,1,1,1,0.66,0.6212,0.39,0.4627,73,375,448,448,True
12373,2012-06-04,2,1,6,17,0,1,1,1,0.64,0.6212,0.38,0.4478,101,499,600,600,True
12374,2012-06-04,2,1,6,18,0,1,1,1,0.64,0.6212,0.38,0.3881,103,499,602,602,True
12375,2012-06-04,2,1,6,19,0,1,1,1,0.62,0.6212,0.38,0.4179,91,499,590,590,True
12376,2012-06-04,2,1,6,20,0,1,1,1,0.6,0.6212,0.4,0.3582,71,390,461,461,True
12377,2012-06-04,2,1,6,21,0,1,1,1,0.58,0.5455,0.49,0.2537,40,225,265,265,True
12378,2012-06-04,2,1,6,22,0,1,1,1,0.56,0.5303,0.52,0.2836,41,127,168,168,True
12379,2012-06-04,2,1,6,23,0,1,1,1,0.58,0.5455,0.49,0.2985,8,78,86,86,True
12380,2012-06-05,2,1,6,0,0,2,1,1,0.54,0.5152,0.68,0.4179,6,28,34,34,True
12381,2012-06-05,2,1,6,1,0,2,1,2,0.52,0.5,0.77,0.3284,2,18,20,20,True
12382,2012-06-05,2,1,6,2,0,2,1,3,0.52,0.5,0.72,0.2985,0,8,8,8,True
12383,2012-06-05,2,1,6,3,0,2,1,3,0.5,0.4848,0.82,0.194,0,5,5,5,True
12384,2012-06-05,2,1,6,4,0,2,1,3,0.5,0.4848,0.82,0.194,1,4,5,5,True
12385,2012-06-05,2,1,6,5,0,2,1,3,0.48,0.4697,0.82,0.1642,1,35,36,36,True
12386,2012-06-05,2,1,6,6,0,2,1,1,0.48,0.4697,0.82,0.2537,7,177,184,184,True
12387,2012-06-05,2,1,6,7,0,2,1,1,0.48,0.4697,0.77,0.2985,29,499,528,528,True
12388,2012-06-05,2,1,6,8,0,2,1,2,0.48,0.4697,0.77,0.2239,30,499,529,529,True
12389,2012-06-05,2,1,6,9,0,2,1,2,0.52,0.5,0.72,0.2537,50,285,335,335,True
12390,2012-06-05,2,1,6,10,0,2,1,2,0.52,0.5,0.63,0.2985,58,118,176,176,True
12391,2012-06-05,2,1,6,11,0,2,1,2,0.56,0.5303,0.56,0.194,65,162,227,227,True
12392,2012-06-05,2,1,6,12,0,2,1,2,0.54,0.5152,0.56,0.2239,45,202,247,247,True
12393,2012-06-05,2,1,6,13,0,2,1,2,0.6,0.6212,0.46,0.1642,66,201,267,267,True
12394,2012-06-05,2,1,6,14,0,2,1,2,0.58,0.5455,0.46,0.1642,82,194,276,276,True
12395,2012-06-05,2,1,6,15,0,2,1,2,0.58,0.5455,0.46,0.1343,54,218,272,272,True
12396,2012-06-05,2,1,6,16,0,2,1,1,0.6,0.6212,0.43,0.194,91,382,473,473,True
12397,2012-06-05,2,1,6,17,0,2,1,1,0.6,0.6212,0.43,0.0,86,499,585,585,True
12398,2012-06-05,2,1,6,18,0,2,1,1,0.6,0.6212,0.43,0.194,111,499,610,610,True
12399,2012-06-05,2,1,6,19,0,2,1,1,0.58,0.5455,0.46,0.2537,68,445,513,513,True
12400,2012-06-05,2,1,6,20,0,2,1,1,0.56,0.5303,0.49,0.2239,44,371,415,415,True
12401,2012-06-05,2,1,6,21,0,2,1,1,0.54,0.5152,0.56,0.1642,30,253,283,283,True
12402,2012-06-05,2,1,6,22,0,2,1,1,0.56,0.5303,0.52,0.1045,22,171,193,193,True
12403,2012-06-05,2,1,6,23,0,2,1,1,0.54,0.5152,0.56,0.0896,20,93,113,113,True
12404,2012-06-06,2,1,6,0,0,3,1,1,0.52,0.5,0.59,0.0896,3,46,49,49,True
12405,2012-06-06,2,1,6,1,0,3,1,1,0.52,0.5,0.68,0.0,6,21,27,27,True
12406,2012-06-06,2,1,6,2,0,3,1,1,0.5,0.4848,0.68,0.0,4,7,11,11,True
12407,2012-06-06,2,1,6,3,0,3,1,1,0.46,0.4545,0.82,0.0,0,8,8,8,True
12408,2012-06-06,2,1,6,4,0,3,1,1,0.46,0.4545,0.82,0.1045,3,7,10,10,True
12409,2012-06-06,2,1,6,5,0,3,1,1,0.48,0.4697,0.77,0.0,1,37,38,38,True
12410,2012-06-06,2,1,6,6,0,3,1,1,0.48,0.4697,0.77,0.0,7,165,172,172,True
12411,2012-06-06,2,1,6,7,0,3,1,1,0.5,0.4848,0.72,0.0,16,499,515,515,True
12412,2012-06-06,2,1,6,8,0,3,1,1,0.54,0.5152,0.68,0.0,31,499,530,530,True
12413,2012-06-06,2,1,6,9,0,3,1,1,0.56,0.5303,0.6,0.0896,35,268,303,303,True
12414,2012-06-06,2,1,6,10,0,3,1,1,0.6,0.6212,0.46,0.0896,55,148,203,203,True
12415,2012-06-06,2,1,6,11,0,3,1,1,0.62,0.6212,0.43,0.0896,65,161,226,226,True
12416,2012-06-06,2,1,6,12,0,3,1,1,0.62,0.6212,0.38,0.0,80,235,315,315,True
12417,2012-06-06,2,1,6,13,0,3,1,1,0.62,0.6212,0.41,0.0896,73,230,303,303,True
12418,2012-06-06,2,1,6,14,0,3,1,1,0.64,0.6212,0.38,0.0,111,191,302,302,True
12419,2012-06-06,2,1,6,15,0,3,1,1,0.64,0.6212,0.38,0.0,75,225,300,300,True
12420,2012-06-06,2,1,6,16,0,3,1,1,0.64,0.6212,0.41,0.1343,107,345,452,452,True
12421,2012-06-06,2,1,6,17,0,3,1,1,0.62,0.6212,0.43,0.1343,72,499,571,571,True
12422,2012-06-06,2,1,6,18,0,3,1,3,0.6,0.6212,0.53,0.194,94,499,593,593,True
12423,2012-06-06,2,1,6,19,0,3,1,1,0.56,0.5303,0.73,0.2985,52,486,538,538,True
12424,2012-06-06,2,1,6,20,0,3,1,1,0.54,0.5152,0.73,0.2836,59,349,408,408,True
12425,2012-06-06,2,1,6,21,0,3,1,1,0.54,0.5152,0.73,0.1642,38,260,298,298,True
12426,2012-06-06,2,1,6,22,0,3,1,1,0.52,0.5,0.77,0.0896,27,221,248,248,True
12427,2012-06-06,2,1,6,23,0,3,1,1,0.52,0.5,0.77,0.0,13,110,123,123,True
12428,2012-06-07,2,1,6,0,0,4,1,1,0.52,0.5,0.77,0.1343,9,50,59,59,True
12429,2012-06-07,2,1,6,1,0,4,1,1,0.52,0.5,0.77,0.1642,5,17,22,22,True
12430,2012-06-07,2,1,6,2,0,4,1,1,0.52,0.5,0.77,0.0896,0,12,12,12,True
12431,2012-06-07,2,1,6,3,0,4,1,1,0.5,0.4848,0.77,0.1045,0,5,5,5,True
12432,2012-06-07,2,1,6,4,0,4,1,1,0.46,0.4545,0.88,0.1045,0,6,6,6,True
12433,2012-06-07,2,1,6,5,0,4,1,1,0.48,0.4697,0.82,0.0896,0,34,34,34,True
12434,2012-06-07,2,1,6,6,0,4,1,1,0.46,0.4545,0.88,0.1045,5,165,170,170,True
12435,2012-06-07,2,1,6,7,0,4,1,1,0.5,0.4848,0.82,0.1642,20,499,519,519,True
12436,2012-06-07,2,1,6,8,0,4,1,1,0.52,0.5,0.77,0.0,20,499,519,519,True
12437,2012-06-07,2,1,6,9,0,4,1,1,0.58,0.5455,0.68,0.0,37,300,337,337,True
12438,2012-06-07,2,1,6,10,0,4,1,1,0.6,0.6061,0.64,0.0896,56,154,210,210,True
12439,2012-06-07,2,1,6,11,0,4,1,1,0.66,0.6212,0.47,0.2239,67,170,237,237,True
12440,2012-06-07,2,1,6,12,0,4,1,1,0.7,0.6364,0.42,0.0,62,274,336,336,True
12441,2012-06-07,2,1,6,13,0,4,1,1,0.7,0.6364,0.37,0.2836,65,250,315,315,True
12442,2012-06-07,2,1,6,14,0,4,1,1,0.72,0.6515,0.37,0.2537,67,198,265,265,True
12443,2012-06-07,2,1,6,15,0,4,1,1,0.74,0.6515,0.3,0.0,99,234,333,333,True
12444,2012-06-07,2,1,6,16,0,4,1,1,0.72,0.6515,0.34,0.2239,77,389,466,466,True
12445,2012-06-07,2,1,6,17,0,4,1,1,0.72,0.6515,0.34,0.2537,91,499,590,590,True
12446,2012-06-07,2,1,6,18,0,4,1,1,0.7,0.6364,0.34,0.2836,110,499,609,609,True
12447,2012-06-07,2,1,6,19,0,4,1,1,0.7,0.6364,0.34,0.2836,65,499,564,564,True
12448,2012-06-07,2,1,6,20,0,4,1,1,0.66,0.6212,0.36,0.2985,76,402,478,478,True
12449,2012-06-07,2,1,6,21,0,4,1,1,0.62,0.6212,0.41,0.3284,30,283,313,313,True
12450,2012-06-07,2,1,6,22,0,4,1,1,0.6,0.6212,0.46,0.1642,35,193,228,228,True
12451,2012-06-07,2,1,6,23,0,4,1,1,0.56,0.5303,0.52,0.1343,42,135,177,177,True
12452,2012-06-08,2,1,6,0,0,5,1,1,0.56,0.5303,0.56,0.1642,18,59,77,77,True
12453,2012-06-08,2,1,6,1,0,5,1,1,0.56,0.5303,0.56,0.1642,4,25,29,29,True
12454,2012-06-08,2,1,6,2,0,5,1,1,0.56,0.5303,0.56,0.0,2,17,19,19,True
12455,2012-06-08,2,1,6,3,0,5,1,1,0.54,0.5152,0.6,0.0896,0,8,8,8,True
12456,2012-06-08,2,1,6,4,0,5,1,1,0.52,0.5,0.63,0.0,1,9,10,10,True
12457,2012-06-08,2,1,6,5,0,5,1,1,0.5,0.4848,0.72,0.1045,1,28,29,29,True
12458,2012-06-08,2,1,6,6,0,5,1,1,0.52,0.5,0.68,0.0896,8,131,139,139,True
12459,2012-06-08,2,1,6,7,0,5,1,1,0.52,0.5,0.72,0.1045,19,409,428,428,True
12460,2012-06-08,2,1,6,8,0,5,1,1,0.58,0.5455,0.6,0.0896,37,499,536,536,True
12461,2012-06-08,2,1,6,9,0,5,1,1,0.62,0.6212,0.53,0.1642,47,335,382,382,True
12462,2012-06-08,2,1,6,10,0,5,1,1,0.66,0.6212,0.47,0.2537,62,187,249,249,True
12463,2012-06-08,2,1,6,11,0,5,1,1,0.7,0.6364,0.42,0.2537,65,199,264,264,True
12464,2012-06-08,2,1,6,12,0,5,1,1,0.72,0.6515,0.39,0.3284,89,280,369,369,True
12465,2012-06-08,2,1,6,13,0,5,1,1,0.74,0.6515,0.37,0.2537,114,287,401,401,True
12466,2012-06-08,2,1,6,14,0,5,1,1,0.76,0.6667,0.31,0.3881,114,245,359,359,True
12467,2012-06-08,2,1,6,15,0,5,1,1,0.76,0.6667,0.29,0.2836,98,299,397,397,True
12468,2012-06-08,2,1,6,16,0,5,1,1,0.76,0.6667,0.29,0.2985,111,412,523,523,True
12469,2012-06-08,2,1,6,17,0,5,1,1,0.76,0.6667,0.29,0.194,114,499,613,613,True
12470,2012-06-08,2,1,6,18,0,5,1,1,0.76,0.6667,0.27,0.2239,114,499,613,613,True
12471,2012-06-08,2,1,6,19,0,5,1,1,0.74,0.6515,0.3,0.2239,95,460,555,555,True
12472,2012-06-08,2,1,6,20,0,5,1,1,0.72,0.6515,0.32,0.1343,114,291,405,405,True
12473,2012-06-08,2,1,6,21,0,5,1,1,0.7,0.6364,0.37,0.1343,83,256,339,339,True
12474,2012-06-08,2,1,6,22,0,5,1,1,0.68,0.6364,0.41,0.1045,61,230,291,291,True
12475,2012-06-08,2,1,6,23,0,5,1,1,0.64,0.6212,0.57,0.1642,52,163,215,215,True
12476,2012-06-09,2,1,6,0,0,6,0,1,0.64,0.6212,0.53,0.1045,54,152,206,206,True
12477,2012-06-09,2,1,6,1,0,6,0,1,0.64,0.6212,0.53,0.0896,34,89,123,123,True
12478,2012-06-09,2,1,6,2,0,6,0,1,0.64,0.6212,0.5,0.2239,21,68,89,89,True
12479,2012-06-09,2,1,6,3,0,6,0,1,0.62,0.6212,0.57,0.0,12,28,40,40,True
12480,2012-06-09,2,1,6,4,0,6,0,1,0.62,0.6212,0.57,0.0,2,6,8,8,True
12481,2012-06-09,2,1,6,5,0,6,0,1,0.6,0.6212,0.56,0.1045,4,15,19,19,True
12482,2012-06-09,2,1,6,6,0,6,0,1,0.56,0.5303,0.64,0.1045,17,63,80,80,True
12483,2012-06-09,2,1,6,7,0,6,0,1,0.58,0.5455,0.64,0.1045,26,61,87,87,True
12484,2012-06-09,2,1,6,8,0,6,0,1,0.62,0.6061,0.61,0.1045,42,202,244,244,True
12485,2012-06-09,2,1,6,9,0,6,0,1,0.64,0.6212,0.57,0.1642,99,241,340,340,True
12486,2012-06-09,2,1,6,10,0,6,0,1,0.7,0.6515,0.51,0.1045,114,298,412,412,True
12487,2012-06-09,2,1,6,11,0,6,0,1,0.76,0.6667,0.35,0.0,114,351,465,465,True
12488,2012-06-09,2,1,6,12,0,6,0,1,0.8,0.697,0.29,0.2537,114,335,449,449,True
12489,2012-06-09,2,1,6,13,0,6,0,1,0.82,0.697,0.24,0.2836,114,349,463,463,True
12490,2012-06-09,2,1,6,14,0,6,0,1,0.82,0.697,0.23,0.194,114,354,468,468,True
12491,2012-06-09,2,1,6,15,0,6,0,1,0.84,0.7121,0.2,0.2985,114,337,451,451,True
12492,2012-06-09,2,1,6,16,0,6,0,1,0.82,0.697,0.24,0.194,114,315,429,429,True
12493,2012-06-09,2,1,6,17,0,6,0,1,0.84,0.7121,0.24,0.0,114,257,371,371,True
12494,2012-06-09,2,1,6,18,0,6,0,1,0.82,0.697,0.24,0.2239,114,276,390,390,True
12495,2012-06-09,2,1,6,19,0,6,0,1,0.8,0.697,0.29,0.1642,114,232,346,346,True
12496,2012-06-09,2,1,6,20,0,6,0,1,0.76,0.6667,0.35,0.2239,114,238,352,352,True
12497,2012-06-09,2,1,6,21,0,6,0,1,0.74,0.6515,0.4,0.194,105,211,316,316,True
12498,2012-06-09,2,1,6,22,0,6,0,1,0.7,0.6515,0.58,0.1642,63,151,214,214,True
12499,2012-06-09,2,1,6,23,0,6,0,1,0.68,0.6364,0.61,0.1642,69,161,230,230,True
12500,2012-06-10,2,1,6,0,0,0,0,1,0.66,0.6212,0.69,0.1045,33,125,158,158,True
12501,2012-06-10,2,1,6,1,0,0,0,1,0.64,0.6061,0.73,0.1343,32,84,116,116,True
12502,2012-06-10,2,1,6,2,0,0,0,1,0.64,0.6061,0.69,0.1343,17,56,73,73,True
12503,2012-06-10,2,1,6,3,0,0,0,1,0.64,0.6061,0.73,0.1045,6,23,29,29,True
12504,2012-06-10,2,1,6,4,0,0,0,1,0.62,0.5909,0.78,0.0896,1,9,10,10,True
12505,2012-06-10,2,1,6,5,0,0,0,1,0.62,0.6061,0.69,0.0896,3,10,13,13,True
12506,2012-06-10,2,1,6,6,0,0,0,1,0.62,0.5909,0.73,0.0,3,27,30,30,True
12507,2012-06-10,2,1,6,7,0,0,0,1,0.6,0.5758,0.78,0.1045,21,41,62,62,True
12508,2012-06-10,2,1,6,8,0,0,0,1,0.64,0.6061,0.73,0.0896,59,122,181,181,True
12509,2012-06-10,2,1,6,9,0,0,0,1,0.7,0.6515,0.58,0.0,91,175,266,266,True
12510,2012-06-10,2,1,6,10,0,0,0,1,0.76,0.6818,0.4,0.1045,114,265,379,379,True
12511,2012-06-10,2,1,6,11,0,0,0,1,0.76,0.6818,0.45,0.0896,114,315,429,429,True
12512,2012-06-10,2,1,6,12,0,0,0,1,0.82,0.7121,0.3,0.0,114,329,443,443,True
12513,2012-06-10,2,1,6,13,0,0,0,1,0.84,0.7273,0.28,0.1343,114,288,402,402,True
12514,2012-06-10,2,1,6,14,0,0,0,1,0.84,0.7273,0.3,0.1343,114,314,428,428,True
12515,2012-06-10,2,1,6,15,0,0,0,1,0.84,0.7273,0.3,0.2239,114,316,430,430,True
12516,2012-06-10,2,1,6,16,0,0,0,1,0.84,0.7424,0.36,0.2836,114,335,449,449,True
12517,2012-06-10,2,1,6,17,0,0,0,1,0.82,0.7424,0.41,0.2836,114,337,451,451,True
12518,2012-06-10,2,1,6,18,0,0,0,1,0.82,0.7273,0.38,0.2239,114,326,440,440,True
12519,2012-06-10,2,1,6,19,0,0,0,1,0.82,0.7121,0.28,0.2836,114,260,374,374,True
12520,2012-06-10,2,1,6,20,0,0,0,1,0.76,0.6818,0.48,0.1642,113,250,363,363,True
12521,2012-06-10,2,1,6,21,0,0,0,1,0.72,0.6818,0.62,0.1642,83,170,253,253,True
12522,2012-06-10,2,1,6,22,0,0,0,1,0.7,0.6515,0.65,0.1642,42,117,159,159,True
12523,2012-06-10,2,1,6,23,0,0,0,1,0.72,0.6667,0.58,0.1045,30,80,110,110,True
12524,2012-06-11,2,1,6,0,0,1,1,1,0.7,0.6515,0.65,0.1045,8,33,41,41,True
12525,2012-06-11,2,1,6,1,0,1,1,1,0.66,0.6212,0.74,0.1642,9,15,24,24,True
12526,2012-06-11,2,1,6,2,0,1,1,1,0.66,0.6212,0.74,0.1045,5,12,17,17,True
12527,2012-06-11,2,1,6,3,0,1,1,1,0.64,0.5909,0.78,0.1045,2,4,6,6,True
12528,2012-06-11,2,1,6,4,0,1,1,1,0.64,0.5909,0.78,0.1343,0,7,7,7,True
12529,2012-06-11,2,1,6,5,0,1,1,1,0.64,0.5909,0.78,0.1343,1,36,37,37,True
12530,2012-06-11,2,1,6,6,0,1,1,1,0.62,0.5758,0.83,0.1045,8,136,144,144,True
12531,2012-06-11,2,1,6,7,0,1,1,1,0.64,0.5909,0.78,0.1045,25,478,503,503,True
12532,2012-06-11,2,1,6,8,0,1,1,1,0.66,0.6212,0.74,0.1343,38,499,537,537,True
12533,2012-06-11,2,1,6,9,0,1,1,1,0.7,0.6515,0.65,0.1343,57,259,316,316,True
12534,2012-06-11,2,1,6,10,0,1,1,1,0.72,0.6818,0.62,0.1642,52,95,147,147,True
12535,2012-06-11,2,1,6,11,0,1,1,2,0.76,0.6818,0.48,0.2239,59,143,202,202,True
12536,2012-06-11,2,1,6,12,0,1,1,2,0.8,0.7273,0.43,0.194,63,198,261,261,True
12537,2012-06-11,2,1,6,13,0,1,1,2,0.8,0.7121,0.41,0.2985,63,185,248,248,True
12538,2012-06-11,2,1,6,14,0,1,1,2,0.82,0.7273,0.34,0.2836,66,193,259,259,True
12539,2012-06-11,2,1,6,15,0,1,1,1,0.8,0.7121,0.41,0.3582,72,187,259,259,True
12540,2012-06-11,2,1,6,16,0,1,1,2,0.8,0.7121,0.41,0.4179,87,340,427,427,True
12541,2012-06-11,2,1,6,17,0,1,1,2,0.8,0.7121,0.41,0.3582,85,499,584,584,True
12542,2012-06-11,2,1,6,18,0,1,1,2,0.8,0.7273,0.43,0.2985,105,499,604,604,True
12543,2012-06-11,2,1,6,19,0,1,1,2,0.76,0.6818,0.48,0.3284,89,499,588,588,True
12544,2012-06-11,2,1,6,20,0,1,1,2,0.74,0.6667,0.48,0.2239,61,333,394,394,True
12545,2012-06-11,2,1,6,21,0,1,1,2,0.72,0.6667,0.58,0.194,32,218,250,250,True
12546,2012-06-11,2,1,6,22,0,1,1,2,0.72,0.6667,0.58,0.194,22,142,164,164,True
12547,2012-06-11,2,1,6,23,0,1,1,2,0.7,0.6515,0.58,0.2239,8,72,80,80,True
12548,2012-06-12,2,1,6,0,0,2,1,2,0.7,0.6515,0.58,0.2239,2,26,28,28,True
12549,2012-06-12,2,1,6,1,0,2,1,2,0.68,0.6364,0.65,0.1642,5,11,16,16,True
12550,2012-06-12,2,1,6,2,0,2,1,2,0.68,0.6364,0.65,0.194,0,6,6,6,True
12551,2012-06-12,2,1,6,3,0,2,1,2,0.66,0.6212,0.69,0.2537,3,9,12,12,True
12552,2012-06-12,2,1,6,4,0,2,1,3,0.6,0.5455,0.88,0.1642,0,4,4,4,True
12553,2012-06-12,2,1,6,5,0,2,1,3,0.6,0.5455,0.88,0.1343,1,28,29,29,True
12554,2012-06-12,2,1,6,6,0,2,1,2,0.6,0.5455,0.88,0.1343,6,130,136,136,True
12555,2012-06-12,2,1,6,7,0,2,1,3,0.62,0.5606,0.88,0.2537,16,287,303,303,True
12556,2012-06-12,2,1,6,8,0,2,1,2,0.62,0.5606,0.88,0.2239,15,499,514,514,True
12557,2012-06-12,2,1,6,9,0,2,1,2,0.64,0.5758,0.89,0.2836,31,254,285,285,True
12558,2012-06-12,2,1,6,10,0,2,1,3,0.64,0.5758,0.89,0.2836,29,96,125,125,True
12559,2012-06-12,2,1,6,11,0,2,1,3,0.66,0.6061,0.83,0.3582,8,57,65,65,True
12560,2012-06-12,2,1,6,12,0,2,1,3,0.66,0.6061,0.83,0.2537,19,76,95,95,True
12561,2012-06-12,2,1,6,13,0,2,1,3,0.66,0.6061,0.83,0.194,11,48,59,59,True
12562,2012-06-12,2,1,6,14,0,2,1,3,0.64,0.5758,0.89,0.2537,12,48,60,60,True
12563,2012-06-12,2,1,6,15,0,2,1,3,0.66,0.5909,0.89,0.194,22,94,116,116,True
12564,2012-06-12,2,1,6,16,0,2,1,2,0.66,0.5909,0.89,0.2836,30,209,239,239,True
12565,2012-06-12,2,1,6,17,0,2,1,2,0.66,0.5909,0.89,0.2836,56,499,555,555,True
12566,2012-06-12,2,1,6,18,0,2,1,1,0.68,0.6364,0.83,0.194,57,499,556,556,True
12567,2012-06-12,2,1,6,19,0,2,1,1,0.68,0.6364,0.83,0.194,47,444,491,491,True
12568,2012-06-12,2,1,6,20,0,2,1,1,0.68,0.6364,0.83,0.194,36,350,386,386,True
12569,2012-06-12,2,1,6,21,0,2,1,1,0.68,0.6364,0.83,0.1045,41,233,274,274,True
12570,2012-06-12,2,1,6,22,0,2,1,1,0.66,0.5909,0.94,0.1045,19,188,207,207,True
12571,2012-06-12,2,1,6,23,0,2,1,3,0.66,0.5909,0.94,0.2239,11,78,89,89,True
12572,2012-06-13,2,1,6,0,0,3,1,2,0.66,0.5909,0.94,0.194,7,27,34,34,True
12573,2012-06-13,2,1,6,1,0,3,1,1,0.64,0.5909,0.78,0.0,7,21,28,28,True
12574,2012-06-13,2,1,6,2,0,3,1,1,0.62,0.5758,0.83,0.1343,0,4,4,4,True
12575,2012-06-13,2,1,6,3,0,3,1,1,0.62,0.5758,0.83,0.194,1,7,8,8,True
12576,2012-06-13,2,1,6,4,0,3,1,1,0.6,0.5606,0.83,0.1343,1,9,10,10,True
12577,2012-06-13,2,1,6,5,0,3,1,1,0.6,0.5606,0.83,0.194,2,38,40,40,True
12578,2012-06-13,2,1,6,6,0,3,1,1,0.6,0.5606,0.83,0.2239,6,188,194,194,True
12579,2012-06-13,2,1,6,7,0,3,1,1,0.6,0.5606,0.83,0.2985,25,480,505,505,True
12580,2012-06-13,2,1,6,8,0,3,1,2,0.62,0.5909,0.73,0.4775,41,499,540,540,True
12581,2012-06-13,2,1,6,9,0,3,1,2,0.64,0.6061,0.69,0.4775,54,298,352,352,True
12582,2012-06-13,2,1,6,10,0,3,1,2,0.64,0.6061,0.65,0.4179,64,134,198,198,True
12583,2012-06-13,2,1,6,11,0,3,1,2,0.66,0.6212,0.54,0.4478,64,182,246,246,True
12584,2012-06-13,2,1,6,12,0,3,1,2,0.68,0.6364,0.44,0.4179,93,241,334,334,True
12585,2012-06-13,2,1,6,13,0,3,1,2,0.7,0.6364,0.45,0.3881,52,203,255,255,True
12586,2012-06-13,2,1,6,14,0,3,1,2,0.72,0.6515,0.37,0.4179,98,222,320,320,True
12587,2012-06-13,2,1,6,15,0,3,1,1,0.72,0.6515,0.32,0.4775,65,216,281,281,True
12588,2012-06-13,2,1,6,16,0,3,1,1,0.72,0.6515,0.3,0.4775,72,320,392,392,True
12589,2012-06-13,2,1,6,17,0,3,1,1,0.72,0.6515,0.32,0.4775,75,499,574,574,True
12590,2012-06-13,2,1,6,18,0,3,1,1,0.72,0.6515,0.32,0.4478,104,499,603,603,True
12591,2012-06-13,2,1,6,19,0,3,1,1,0.7,0.6364,0.34,0.3881,114,499,613,613,True
12592,2012-06-13,2,1,6,20,0,3,1,1,0.68,0.6364,0.36,0.4179,86,362,448,448,True
12593,2012-06-13,2,1,6,21,0,3,1,1,0.64,0.6212,0.44,0.3582,79,317,396,396,True
12594,2012-06-13,2,1,6,22,0,3,1,1,0.62,0.6212,0.5,0.2985,29,209,238,238,True
12595,2012-06-13,2,1,6,23,0,3,1,1,0.62,0.6212,0.5,0.2836,25,128,153,153,True
12596,2012-06-14,2,1,6,0,0,4,1,1,0.6,0.6212,0.53,0.2985,3,45,48,48,True
12597,2012-06-14,2,1,6,1,0,4,1,1,0.6,0.6212,0.56,0.2239,4,17,21,21,True
12598,2012-06-14,2,1,6,2,0,4,1,2,0.62,0.6212,0.53,0.2537,1,8,9,9,True
12599,2012-06-14,2,1,6,3,0,4,1,2,0.62,0.6212,0.53,0.2836,1,4,5,5,True
12600,2012-06-14,2,1,6,4,0,4,1,2,0.6,0.6212,0.56,0.2537,0,6,6,6,True
12601,2012-06-14,2,1,6,5,0,4,1,2,0.6,0.6212,0.56,0.2537,0,40,40,40,True
12602,2012-06-14,2,1,6,6,0,4,1,1,0.58,0.5455,0.6,0.2836,12,169,181,181,True
12603,2012-06-14,2,1,6,7,0,4,1,1,0.6,0.6061,0.6,0.2836,26,480,506,506,True
12604,2012-06-14,2,1,6,8,0,4,1,1,0.6,0.6061,0.64,0.3284,37,499,536,536,True
12605,2012-06-14,2,1,6,9,0,4,1,1,0.62,0.6061,0.61,0.2239,45,312,357,357,True
12606,2012-06-14,2,1,6,10,0,4,1,1,0.64,0.6061,0.65,0.4179,47,132,179,179,True
12607,2012-06-14,2,1,6,11,0,4,1,1,0.66,0.6212,0.57,0.2537,60,168,228,228,True
12608,2012-06-14,2,1,6,12,0,4,1,2,0.66,0.6212,0.61,0.2239,55,210,265,265,True
12609,2012-06-14,2,1,6,13,0,4,1,1,0.68,0.6364,0.57,0.1642,71,213,284,284,True
12610,2012-06-14,2,1,6,14,0,4,1,1,0.7,0.6515,0.54,0.2836,84,214,298,298,True
12611,2012-06-14,2,1,6,15,0,4,1,1,0.74,0.6667,0.48,0.2985,111,213,324,324,True
12612,2012-06-14,2,1,6,16,0,4,1,1,0.72,0.6667,0.51,0.2836,70,368,438,438,True
12613,2012-06-14,2,1,6,17,0,4,1,1,0.72,0.6667,0.48,0.2239,114,499,613,613,True
12614,2012-06-14,2,1,6,18,0,4,1,1,0.74,0.6667,0.42,0.194,107,499,606,606,True
12615,2012-06-14,2,1,6,19,0,4,1,1,0.7,0.6515,0.48,0.2537,96,483,579,579,True
12616,2012-06-14,2,1,6,20,0,4,1,1,0.66,0.6212,0.65,0.2537,84,351,435,435,True
12617,2012-06-14,2,1,6,21,0,4,1,1,0.64,0.6061,0.65,0.1642,67,270,337,337,True
12618,2012-06-14,2,1,6,22,0,4,1,2,0.64,0.6061,0.65,0.2239,46,196,242,242,True
12619,2012-06-14,2,1,6,23,0,4,1,2,0.62,0.6061,0.69,0.1642,36,136,172,172,True
12620,2012-06-15,2,1,6,0,0,5,1,1,0.6,0.5909,0.73,0.1642,26,68,94,94,True
12621,2012-06-15,2,1,6,1,0,5,1,1,0.58,0.5455,0.78,0.194,9,42,51,51,True
12622,2012-06-15,2,1,6,2,0,5,1,1,0.56,0.5303,0.83,0.1045,0,15,15,15,True
12623,2012-06-15,2,1,6,3,0,5,1,1,0.56,0.5303,0.83,0.1642,2,3,5,5,True
12624,2012-06-15,2,1,6,4,0,5,1,1,0.56,0.5303,0.83,0.1642,1,13,14,14,True
12625,2012-06-15,2,1,6,5,0,5,1,1,0.54,0.5152,0.88,0.1045,2,31,33,33,True
12626,2012-06-15,2,1,6,6,0,5,1,1,0.54,0.5152,0.83,0.1343,9,142,151,151,True
12627,2012-06-15,2,1,6,7,0,5,1,1,0.56,0.5303,0.83,0.1642,17,413,430,430,True
12628,2012-06-15,2,1,6,8,0,5,1,1,0.6,0.5909,0.69,0.1642,44,499,543,543,True
12629,2012-06-15,2,1,6,9,0,5,1,1,0.62,0.6061,0.65,0.1642,58,308,366,366,True
12630,2012-06-15,2,1,6,10,0,5,1,1,0.64,0.6212,0.57,0.1642,56,160,216,216,True
12631,2012-06-15,2,1,6,11,0,5,1,1,0.66,0.6212,0.5,0.194,106,180,286,286,True
12632,2012-06-15,2,1,6,12,0,5,1,1,0.7,0.6364,0.45,0.1642,111,292,403,403,True
12633,2012-06-15,2,1,6,13,0,5,1,1,0.7,0.6364,0.42,0.2537,114,272,386,386,True
12634,2012-06-15,2,1,6,14,0,5,1,1,0.72,0.6515,0.39,0.194,114,255,369,369,True
12635,2012-06-15,2,1,6,15,0,5,1,1,0.72,0.6515,0.39,0.194,107,270,377,377,True
12636,2012-06-15,2,1,6,16,0,5,1,1,0.72,0.6515,0.37,0.194,114,426,540,540,True
12637,2012-06-15,2,1,6,17,0,5,1,1,0.74,0.6515,0.37,0.2836,114,499,613,613,True
12638,2012-06-15,2,1,6,18,0,5,1,1,0.72,0.6515,0.39,0.2239,114,499,613,613,True
12639,2012-06-15,2,1,6,19,0,5,1,1,0.7,0.6364,0.42,0.1642,98,369,467,467,True
12640,2012-06-15,2,1,6,20,0,5,1,1,0.68,0.6364,0.44,0.194,89,296,385,385,True
12641,2012-06-15,2,1,6,21,0,5,1,1,0.66,0.6212,0.5,0.1045,83,250,333,333,True
12642,2012-06-15,2,1,6,22,0,5,1,1,0.64,0.6212,0.53,0.1343,79,242,321,321,True
12643,2012-06-15,2,1,6,23,0,5,1,1,0.62,0.6212,0.53,0.2537,46,176,222,222,True
12644,2012-06-16,2,1,6,0,0,6,0,1,0.58,0.5455,0.56,0.1343,25,112,137,137,True
12645,2012-06-16,2,1,6,1,0,6,0,1,0.56,0.5303,0.56,0.0,16,79,95,95,True
12646,2012-06-16,2,1,6,2,0,6,0,1,0.58,0.5455,0.53,0.0,12,55,67,67,True
12647,2012-06-16,2,1,6,3,0,6,0,1,0.56,0.5303,0.6,0.0896,8,19,27,27,True
12648,2012-06-16,2,1,6,4,0,6,0,1,0.54,0.5152,0.68,0.1343,3,5,8,8,True
12649,2012-06-16,2,1,6,5,0,6,0,1,0.54,0.5152,0.68,0.1045,2,21,23,23,True
12650,2012-06-16,2,1,6,6,0,6,0,1,0.54,0.5152,0.68,0.194,11,36,47,47,True
12651,2012-06-16,2,1,6,7,0,6,0,1,0.54,0.5152,0.68,0.194,10,68,78,78,True
12652,2012-06-16,2,1,6,8,0,6,0,1,0.58,0.5455,0.64,0.1642,47,157,204,204,True
12653,2012-06-16,2,1,6,9,0,6,0,1,0.6,0.6061,0.6,0.0896,88,279,367,367,True
12654,2012-06-16,2,1,6,10,0,6,0,1,0.64,0.6212,0.47,0.194,114,296,410,410,True
12655,2012-06-16,2,1,6,11,0,6,0,1,0.66,0.6212,0.39,0.1642,114,353,467,467,True
12656,2012-06-16,2,1,6,12,0,6,0,1,0.68,0.6364,0.41,0.1045,114,349,463,463,True
12657,2012-06-16,2,1,6,13,0,6,0,1,0.72,0.6515,0.34,0.1642,114,324,438,438,True
12658,2012-06-16,2,1,6,14,0,6,0,1,0.72,0.6515,0.37,0.2239,114,309,423,423,True
12659,2012-06-16,2,1,6,15,0,6,0,1,0.74,0.6515,0.35,0.2537,114,288,402,402,True
12660,2012-06-16,2,1,6,16,0,6,0,2,0.72,0.6515,0.37,0.1045,114,304,418,418,True
12661,2012-06-16,2,1,6,17,0,6,0,2,0.72,0.6515,0.37,0.2537,114,349,463,463,True
12662,2012-06-16,2,1,6,18,0,6,0,2,0.72,0.6515,0.37,0.2239,114,315,429,429,True
12663,2012-06-16,2,1,6,19,0,6,0,2,0.7,0.6364,0.42,0.194,114,277,391,391,True
12664,2012-06-16,2,1,6,20,0,6,0,2,0.66,0.6212,0.47,0.194,114,229,343,343,True
12665,2012-06-16,2,1,6,21,0,6,0,2,0.64,0.6212,0.5,0.2239,98,192,290,290,True
12666,2012-06-16,2,1,6,22,0,6,0,1,0.62,0.6212,0.53,0.2985,91,189,280,280,True
12667,2012-06-16,2,1,6,23,0,6,0,1,0.6,0.6212,0.53,0.2985,49,134,183,183,True
12668,2012-06-17,2,1,6,0,0,0,0,1,0.56,0.5303,0.56,0.1343,31,117,148,148,True
12669,2012-06-17,2,1,6,1,0,0,0,1,0.56,0.5303,0.6,0.1642,21,67,88,88,True
12670,2012-06-17,2,1,6,2,0,0,0,1,0.56,0.5303,0.56,0.0896,19,55,74,74,True
12671,2012-06-17,2,1,6,3,0,0,0,1,0.54,0.5152,0.64,0.1045,6,22,28,28,True
12672,2012-06-17,2,1,6,4,0,0,0,1,0.54,0.5152,0.64,0.0896,2,16,18,18,True
12673,2012-06-17,2,1,6,5,0,0,0,1,0.54,0.5152,0.68,0.1343,4,13,17,17,True
12674,2012-06-17,2,1,6,6,0,0,0,1,0.52,0.5,0.72,0.1045,7,16,23,23,True
12675,2012-06-17,2,1,6,7,0,0,0,1,0.52,0.5,0.72,0.0896,18,30,48,48,True
12676,2012-06-17,2,1,6,8,0,0,0,1,0.56,0.5303,0.68,0.2537,24,95,119,119,True
12677,2012-06-17,2,1,6,9,0,0,0,1,0.56,0.5303,0.68,0.1642,91,183,274,274,True
12678,2012-06-17,2,1,6,10,0,0,0,1,0.58,0.5455,0.64,0.0,114,288,402,402,True
12679,2012-06-17,2,1,6,11,0,0,0,1,0.62,0.6212,0.57,0.1045,114,350,464,464,True
12680,2012-06-17,2,1,6,12,0,0,0,1,0.62,0.6212,0.57,0.0,114,355,469,469,True
12681,2012-06-17,2,1,6,13,0,0,0,1,0.64,0.6212,0.53,0.1642,114,347,461,461,True
12682,2012-06-17,2,1,6,14,0,0,0,1,0.64,0.6212,0.53,0.0,114,327,441,441,True
12683,2012-06-17,2,1,6,15,0,0,0,1,0.66,0.6212,0.5,0.2239,114,260,374,374,True
12684,2012-06-17,2,1,6,16,0,0,0,1,0.66,0.6212,0.54,0.2985,114,340,454,454,True
12685,2012-06-17,2,1,6,17,0,0,0,1,0.64,0.6212,0.57,0.2239,114,361,475,475,True
12686,2012-06-17,2,1,6,18,0,0,0,1,0.64,0.6212,0.53,0.194,114,310,424,424,True
12687,2012-06-17,2,1,6,19,0,0,0,1,0.64,0.6212,0.53,0.1642,114,244,358,358,True
12688,2012-06-17,2,1,6,20,0,0,0,1,0.62,0.6212,0.57,0.194,101,201,302,302,True
12689,2012-06-17,2,1,6,21,0,0,0,1,0.62,0.6212,0.57,0.194,76,170,246,246,True
12690,2012-06-17,2,1,6,22,0,0,0,1,0.6,0.6061,0.6,0.194,55,98,153,153,True
12691,2012-06-17,2,1,6,23,0,0,0,1,0.58,0.5455,0.64,0.194,29,79,108,108,True
12692,2012-06-18,2,1,6,0,0,1,1,1,0.56,0.5303,0.73,0.2537,12,28,40,40,True
12693,2012-06-18,2,1,6,1,0,1,1,1,0.54,0.5152,0.77,0.2239,9,5,14,14,True
12694,2012-06-18,2,1,6,2,0,1,1,1,0.54,0.5152,0.77,0.2239,3,6,9,9,True
12695,2012-06-18,2,1,6,3,0,1,1,2,0.52,0.5,0.83,0.2239,1,3,4,4,True
12696,2012-06-18,2,1,6,4,0,1,1,2,0.54,0.5152,0.77,0.194,0,9,9,9,True
12697,2012-06-18,2,1,6,5,0,1,1,3,0.52,0.5,0.83,0.1343,1,22,23,23,True
12698,2012-06-18,2,1,6,6,0,1,1,3,0.52,0.5,0.88,0.1343,0,37,37,37,True
12699,2012-06-18,2,1,6,7,0,1,1,3,0.52,0.5,0.94,0.2239,10,135,145,145,True
12700,2012-06-18,2,1,6,8,0,1,1,2,0.54,0.5152,0.83,0.194,27,447,474,474,True
12701,2012-06-18,2,1,6,9,0,1,1,2,0.54,0.5152,0.83,0.2239,28,222,250,250,True
12702,2012-06-18,2,1,6,10,0,1,1,3,0.54,0.5152,0.88,0.1045,13,78,91,91,True
12703,2012-06-18,2,1,6,11,0,1,1,2,0.54,0.5152,0.88,0.1642,25,96,121,121,True
12704,2012-06-18,2,1,6,12,0,1,1,3,0.56,0.5303,0.78,0.1343,29,139,168,168,True
12705,2012-06-18,2,1,6,13,0,1,1,2,0.58,0.5455,0.73,0.1343,51,174,225,225,True
12706,2012-06-18,2,1,6,14,0,1,1,2,0.58,0.5455,0.68,0.194,59,160,219,219,True
12707,2012-06-18,2,1,6,15,0,1,1,2,0.6,0.5909,0.69,0.194,61,176,237,237,True
12708,2012-06-18,2,1,6,16,0,1,1,2,0.6,0.5909,0.73,0.194,53,279,332,332,True
12709,2012-06-18,2,1,6,17,0,1,1,2,0.6,0.5909,0.73,0.194,54,499,553,553,True
12710,2012-06-18,2,1,6,18,0,1,1,2,0.62,0.6061,0.69,0.1642,47,499,546,546,True
12711,2012-06-18,2,1,6,19,0,1,1,2,0.62,0.5909,0.73,0.0896,52,411,463,463,True
12712,2012-06-18,2,1,6,20,0,1,1,2,0.62,0.5909,0.73,0.1343,45,317,362,362,True
12713,2012-06-18,2,1,6,21,0,1,1,2,0.62,0.5909,0.73,0.1045,35,238,273,273,True
12714,2012-06-18,2,1,6,22,0,1,1,2,0.62,0.5909,0.73,0.1642,21,143,164,164,True
12715,2012-06-18,2,1,6,23,0,1,1,3,0.6,0.5758,0.78,0.194,17,57,74,74,True
12716,2012-06-19,2,1,6,0,0,2,1,2,0.6,0.5758,0.78,0.1642,5,30,35,35,True
12717,2012-06-19,2,1,6,1,0,2,1,2,0.6,0.5758,0.78,0.1642,1,13,14,14,True
12718,2012-06-19,2,1,6,2,0,2,1,2,0.6,0.5758,0.78,0.1343,1,14,15,15,True
12719,2012-06-19,2,1,6,3,0,2,1,2,0.6,0.5758,0.78,0.1045,1,7,8,8,True
12720,2012-06-19,2,1,6,4,0,2,1,2,0.6,0.5758,0.78,0.1343,1,9,10,10,True
12721,2012-06-19,2,1,6,5,0,2,1,2,0.6,0.5758,0.78,0.194,3,34,37,37,True
12722,2012-06-19,2,1,6,6,0,2,1,2,0.6,0.5758,0.78,0.1045,9,152,161,161,True
12723,2012-06-19,2,1,6,7,0,2,1,2,0.6,0.5758,0.78,0.1343,18,462,480,480,True
12724,2012-06-19,2,1,6,8,0,2,1,2,0.6,0.5758,0.78,0.1642,40,499,539,539,True
12725,2012-06-19,2,1,6,9,0,2,1,1,0.64,0.6061,0.73,0.0896,40,288,328,328,True
12726,2012-06-19,2,1,6,10,0,2,1,1,0.64,0.6061,0.73,0.0896,44,136,180,180,True
12727,2012-06-19,2,1,6,11,0,2,1,1,0.66,0.6212,0.69,0.1343,56,174,230,230,True
12728,2012-06-19,2,1,6,12,0,2,1,1,0.7,0.6515,0.65,0.0896,70,222,292,292,True
12729,2012-06-19,2,1,6,13,0,2,1,1,0.74,0.6818,0.58,0.1343,69,203,272,272,True
12730,2012-06-19,2,1,6,14,0,2,1,1,0.76,0.7121,0.58,0.1045,61,166,227,227,True
12731,2012-06-19,2,1,6,15,0,2,1,1,0.78,0.7424,0.59,0.1642,72,187,259,259,True
12732,2012-06-19,2,1,6,16,0,2,1,1,0.8,0.7576,0.55,0.2239,48,286,334,334,True
12733,2012-06-19,2,1,6,17,0,2,1,1,0.8,0.7576,0.55,0.194,86,499,585,585,True
12734,2012-06-19,2,1,6,18,0,2,1,1,0.8,0.7576,0.55,0.1642,91,499,590,590,True
12735,2012-06-19,2,1,6,19,0,2,1,1,0.8,0.7727,0.59,0.2239,82,432,514,514,True
12736,2012-06-19,2,1,6,20,0,2,1,1,0.8,0.7576,0.55,0.2537,59,399,458,458,True
12737,2012-06-19,2,1,6,21,0,2,1,1,0.76,0.7121,0.62,0.1642,37,239,276,276,True
12738,2012-06-19,2,1,6,22,0,2,1,1,0.72,0.697,0.79,0.0896,51,240,291,291,True
12739,2012-06-19,2,1,6,23,0,2,1,1,0.72,0.697,0.79,0.1343,23,102,125,125,True
12740,2012-06-20,2,1,6,0,0,3,1,1,0.7,0.6667,0.79,0.194,5,48,53,53,True
12741,2012-06-20,2,1,6,1,0,3,1,1,0.68,0.6364,0.79,0.194,7,20,27,27,True
12742,2012-06-20,2,1,6,2,0,3,1,1,0.66,0.6061,0.83,0.1642,1,5,6,6,True
12743,2012-06-20,2,1,6,3,0,3,1,1,0.66,0.6061,0.83,0.1343,2,6,8,8,True
12744,2012-06-20,2,1,6,4,0,3,1,1,0.66,0.6061,0.83,0.0896,1,6,7,7,True
12745,2012-06-20,2,1,6,5,0,3,1,1,0.66,0.6061,0.83,0.0896,2,37,39,39,True
12746,2012-06-20,2,1,6,6,0,3,1,2,0.64,0.5758,0.89,0.0896,9,156,165,165,True
12747,2012-06-20,2,1,6,7,0,3,1,2,0.66,0.5909,0.89,0.0,20,444,464,464,True
12748,2012-06-20,2,1,6,8,0,3,1,2,0.7,0.6667,0.79,0.1045,43,499,542,542,True
12749,2012-06-20,2,1,6,9,0,3,1,2,0.72,0.697,0.74,0.0,40,276,316,316,True
12750,2012-06-20,2,1,6,10,0,3,1,1,0.82,0.7727,0.52,0.1343,41,126,167,167,True
12751,2012-06-20,2,1,6,11,0,3,1,1,0.84,0.7879,0.49,0.194,54,134,188,188,True
12752,2012-06-20,2,1,6,12,0,3,1,1,0.86,0.803,0.47,0.1642,30,150,180,180,True
12753,2012-06-20,2,1,6,13,0,3,1,1,0.86,0.7879,0.44,0.1045,48,163,211,211,True
12754,2012-06-20,2,1,6,14,0,3,1,1,0.88,0.803,0.39,0.194,56,134,190,190,True
12755,2012-06-20,2,1,6,15,0,3,1,1,0.9,0.8182,0.35,0.0,36,143,179,179,True
12756,2012-06-20,2,1,6,16,0,3,1,1,0.9,0.8182,0.35,0.1045,51,284,335,335,True
12757,2012-06-20,2,1,6,17,0,3,1,1,0.9,0.8182,0.37,0.0,80,499,579,579,True
12758,2012-06-20,2,1,6,18,0,3,1,1,0.9,0.8182,0.37,0.0,81,499,580,580,True
12759,2012-06-20,2,1,6,19,0,3,1,1,0.88,0.7879,0.37,0.2537,90,449,539,539,True
12760,2012-06-20,2,1,6,20,0,3,1,1,0.86,0.7727,0.39,0.2239,81,326,407,407,True
12761,2012-06-20,2,1,6,21,0,3,1,1,0.84,0.7576,0.44,0.0896,42,302,344,344,True
12762,2012-06-20,2,1,6,22,0,3,1,1,0.82,0.7576,0.46,0.1045,31,226,257,257,True
12763,2012-06-20,2,1,6,23,0,3,1,1,0.78,0.7424,0.59,0.1045,21,102,123,123,True
12764,2012-06-21,3,1,6,0,0,4,1,1,0.74,0.697,0.7,0.0896,16,53,69,69,True
12765,2012-06-21,3,1,6,1,0,4,1,1,0.72,0.697,0.79,0.1343,2,16,18,18,True
12766,2012-06-21,3,1,6,2,0,4,1,1,0.72,0.697,0.79,0.1045,11,7,18,18,True
12767,2012-06-21,3,1,6,3,0,4,1,1,0.72,0.697,0.74,0.0,3,8,11,11,True
12768,2012-06-21,3,1,6,4,0,4,1,1,0.7,0.6667,0.84,0.0896,1,11,12,12,True
12769,2012-06-21,3,1,6,5,0,4,1,1,0.7,0.6667,0.84,0.1045,3,37,40,40,True
12770,2012-06-21,3,1,6,6,0,4,1,2,0.7,0.6667,0.84,0.0896,3,147,150,150,True
12771,2012-06-21,3,1,6,7,0,4,1,2,0.7,0.6667,0.84,0.0896,26,437,463,463,True
12772,2012-06-21,3,1,6,8,0,4,1,1,0.74,0.697,0.7,0.0,27,499,526,526,True
12773,2012-06-21,3,1,6,9,0,4,1,1,0.8,0.7576,0.55,0.194,32,224,256,256,True
12774,2012-06-21,3,1,6,10,0,4,1,1,0.84,0.7879,0.49,0.1045,36,114,150,150,True
12775,2012-06-21,3,1,6,11,0,4,1,1,0.86,0.7879,0.41,0.1343,40,121,161,161,True
12776,2012-06-21,3,1,6,12,0,4,1,1,0.9,0.8182,0.35,0.194,33,182,215,215,True
12777,2012-06-21,3,1,6,13,0,4,1,1,0.9,0.8182,0.35,0.0,31,141,172,172,True
12778,2012-06-21,3,1,6,14,0,4,1,1,0.88,0.7879,0.37,0.1642,27,149,176,176,True
12779,2012-06-21,3,1,6,15,0,4,1,1,0.92,0.8333,0.33,0.1642,40,154,194,194,True
12780,2012-06-21,3,1,6,16,0,4,1,1,0.9,0.8182,0.35,0.1343,37,283,320,320,True
12781,2012-06-21,3,1,6,17,0,4,1,1,0.88,0.7879,0.37,0.0,80,499,579,579,True
12782,2012-06-21,3,1,6,18,0,4,1,1,0.86,0.7879,0.41,0.194,78,499,577,577,True
12783,2012-06-21,3,1,6,19,0,4,1,1,0.88,0.803,0.39,0.2239,84,415,499,499,True
12784,2012-06-21,3,1,6,20,0,4,1,1,0.86,0.7879,0.44,0.194,79,357,436,436,True
12785,2012-06-21,3,1,6,21,0,4,1,1,0.82,0.7727,0.52,0.194,55,256,311,311,True
12786,2012-06-21,3,1,6,22,0,4,1,1,0.8,0.7879,0.63,0.1642,22,221,243,243,True
12787,2012-06-21,3,1,6,23,0,4,1,1,0.8,0.7727,0.59,0.0896,12,134,146,146,True
12788,2012-06-22,3,1,6,0,0,5,1,2,0.76,0.7273,0.7,0.1045,16,77,93,93,True
12789,2012-06-22,3,1,6,1,0,5,1,1,0.76,0.7424,0.75,0.1642,3,28,31,31,True
12790,2012-06-22,3,1,6,2,0,5,1,1,0.74,0.7121,0.79,0.0,0,12,12,12,True
12791,2012-06-22,3,1,6,3,0,5,1,1,0.74,0.7121,0.79,0.0,1,6,7,7,True
12792,2012-06-22,3,1,6,4,0,5,1,2,0.76,0.7273,0.66,0.0,3,7,10,10,True
12793,2012-06-22,3,1,6,5,0,5,1,2,0.74,0.697,0.66,0.0896,3,35,38,38,True
12794,2012-06-22,3,1,6,6,0,5,1,2,0.74,0.697,0.66,0.0,4,118,122,122,True
12795,2012-06-22,3,1,6,7,0,5,1,1,0.74,0.6818,0.58,0.1642,19,340,359,359,True
12796,2012-06-22,3,1,6,8,0,5,1,1,0.76,0.697,0.55,0.1343,49,499,548,548,True
12797,2012-06-22,3,1,6,9,0,5,1,1,0.76,0.7121,0.58,0.2239,55,278,333,333,True
12798,2012-06-22,3,1,6,10,0,5,1,1,0.8,0.7424,0.52,0.3582,52,133,185,185,True
12799,2012-06-22,3,1,6,11,0,5,1,1,0.8,0.7424,0.49,0.1642,76,160,236,236,True
12800,2012-06-22,3,1,6,12,0,5,1,1,0.84,0.7879,0.49,0.1343,63,191,254,254,True
12801,2012-06-22,3,1,6,13,0,5,1,1,0.88,0.803,0.39,0.2239,72,228,300,300,True
12802,2012-06-22,3,1,6,14,0,5,1,1,0.88,0.803,0.39,0.2239,65,198,263,263,True
12803,2012-06-22,3,1,6,15,0,5,1,1,0.9,0.8182,0.35,0.3582,72,212,284,284,True
12804,2012-06-22,3,1,6,16,0,5,1,1,0.9,0.803,0.31,0.2239,67,313,380,380,True
12805,2012-06-22,3,1,6,17,0,5,1,2,0.82,0.7273,0.38,0.1642,95,499,594,594,True
12806,2012-06-22,3,1,6,18,0,5,1,2,0.8,0.7576,0.55,0.194,62,443,505,505,True
12807,2012-06-22,3,1,6,19,0,5,1,2,0.76,0.697,0.55,0.4775,45,317,362,362,True
12808,2012-06-22,3,1,6,20,0,5,1,2,0.76,0.697,0.55,0.4775,31,171,202,202,True
12809,2012-06-22,3,1,6,21,0,5,1,3,0.68,0.6364,0.65,0.2836,40,177,217,217,True
12810,2012-06-22,3,1,6,22,0,5,1,1,0.68,0.6364,0.69,0.1343,42,155,197,197,True
12811,2012-06-22,3,1,6,23,0,5,1,2,0.66,0.6212,0.74,0.0,29,145,174,174,True
12812,2012-06-23,3,1,6,0,0,6,0,1,0.64,0.5758,0.83,0.0,14,102,116,116,True
12813,2012-06-23,3,1,6,1,0,6,0,1,0.66,0.6061,0.78,0.1343,16,107,123,123,True
12814,2012-06-23,3,1,6,2,0,6,0,2,0.64,0.5758,0.83,0.194,18,75,93,93,True
12815,2012-06-23,3,1,6,3,0,6,0,2,0.64,0.5758,0.83,0.0896,10,32,42,42,True
12816,2012-06-23,3,1,6,4,0,6,0,2,0.64,0.5758,0.83,0.1642,6,13,19,19,True
12817,2012-06-23,3,1,6,5,0,6,0,2,0.64,0.5758,0.83,0.194,1,11,12,12,True
12818,2012-06-23,3,1,6,6,0,6,0,1,0.64,0.5758,0.83,0.0896,10,37,47,47,True
12819,2012-06-23,3,1,6,7,0,6,0,1,0.64,0.5758,0.83,0.1642,19,59,78,78,True
12820,2012-06-23,3,1,6,8,0,6,0,1,0.68,0.6364,0.69,0.2239,34,133,167,167,True
12821,2012-06-23,3,1,6,9,0,6,0,1,0.72,0.6818,0.62,0.194,85,247,332,332,True
12822,2012-06-23,3,1,6,10,0,6,0,1,0.74,0.6818,0.55,0.194,114,317,431,431,True
12823,2012-06-23,3,1,6,11,0,6,0,1,0.76,0.6818,0.48,0.2239,114,349,463,463,True
12824,2012-06-23,3,1,6,12,0,6,0,1,0.8,0.7273,0.43,0.194,114,399,513,513,True
12825,2012-06-23,3,1,6,13,0,6,0,1,0.82,0.7273,0.34,0.194,114,338,452,452,True
12826,2012-06-23,3,1,6,14,0,6,0,1,0.78,0.6818,0.33,0.2537,114,371,485,485,True
12827,2012-06-23,3,1,6,15,0,6,0,1,0.84,0.7273,0.3,0.3284,114,266,380,380,True
12828,2012-06-23,3,1,6,16,0,6,0,1,0.84,0.7121,0.26,0.2985,114,317,431,431,True
12829,2012-06-23,3,1,6,17,0,6,0,1,0.82,0.7121,0.26,0.2537,114,316,430,430,True
12830,2012-06-23,3,1,6,18,0,6,0,1,0.82,0.7121,0.26,0.2985,114,287,401,401,True
12831,2012-06-23,3,1,6,19,0,6,0,1,0.8,0.697,0.27,0.194,114,240,354,354,True
12832,2012-06-23,3,1,6,20,0,6,0,1,0.78,0.6818,0.31,0.194,114,228,342,342,True
12833,2012-06-23,3,1,6,21,0,6,0,1,0.76,0.6667,0.33,0.1343,99,223,322,322,True
12834,2012-06-23,3,1,6,22,0,6,0,1,0.74,0.6515,0.37,0.1045,101,178,279,279,True
12835,2012-06-23,3,1,6,23,0,6,0,1,0.72,0.6515,0.44,0.0,69,156,225,225,True
12836,2012-06-24,3,1,6,0,0,0,0,1,0.7,0.6515,0.51,0.0,31,132,163,163,True
12837,2012-06-24,3,1,6,1,0,0,0,2,0.68,0.6364,0.54,0.0896,39,88,127,127,True
12838,2012-06-24,3,1,6,2,0,0,0,2,0.68,0.6364,0.51,0.0,34,80,114,114,True
12839,2012-06-24,3,1,6,3,0,0,0,2,0.66,0.6212,0.65,0.0896,19,41,60,60,True
12840,2012-06-24,3,1,6,4,0,0,0,2,0.66,0.6212,0.65,0.0,4,9,13,13,True
12841,2012-06-24,3,1,6,5,0,0,0,1,0.62,0.6061,0.69,0.1343,1,7,8,8,True
12842,2012-06-24,3,1,6,6,0,0,0,1,0.64,0.6061,0.65,0.1642,6,19,25,25,True
12843,2012-06-24,3,1,6,7,0,0,0,1,0.64,0.6061,0.69,0.1045,23,48,71,71,True
12844,2012-06-24,3,1,6,8,0,0,0,1,0.7,0.6515,0.58,0.0,38,103,141,141,True
12845,2012-06-24,3,1,6,9,0,0,0,1,0.72,0.6667,0.51,0.0,63,169,232,232,True
12846,2012-06-24,3,1,6,10,0,0,0,1,0.76,0.6818,0.4,0.0,114,291,405,405,True
12847,2012-06-24,3,1,6,11,0,0,0,1,0.76,0.6818,0.4,0.1343,114,291,405,405,True
12848,2012-06-24,3,1,6,12,0,0,0,1,0.8,0.697,0.33,0.2239,114,329,443,443,True
12849,2012-06-24,3,1,6,13,0,0,0,1,0.8,0.697,0.33,0.2836,114,348,462,462,True
12850,2012-06-24,3,1,6,14,0,0,0,1,0.84,0.7273,0.3,0.2985,114,298,412,412,True
12851,2012-06-24,3,1,6,15,0,0,0,1,0.86,0.7424,0.28,0.2239,114,290,404,404,True
12852,2012-06-24,3,1,6,16,0,0,0,1,0.84,0.7273,0.3,0.2537,114,280,394,394,True
12853,2012-06-24,3,1,6,17,0,0,0,1,0.84,0.7273,0.32,0.2537,114,329,443,443,True
12854,2012-06-24,3,1,6,18,0,0,0,1,0.82,0.7273,0.34,0.2537,114,348,462,462,True
12855,2012-06-24,3,1,6,19,0,0,0,1,0.8,0.7121,0.38,0.2985,114,247,361,361,True
12856,2012-06-24,3,1,6,20,0,0,0,1,0.78,0.697,0.46,0.2537,108,224,332,332,True
12857,2012-06-24,3,1,6,21,0,0,0,1,0.76,0.697,0.55,0.2239,76,177,253,253,True
12858,2012-06-24,3,1,6,22,0,0,0,1,0.74,0.6818,0.55,0.1045,53,125,178,178,True
12859,2012-06-24,3,1,6,23,0,0,0,1,0.74,0.6818,0.58,0.1045,20,67,87,87,True
12860,2012-06-25,3,1,6,0,0,1,1,1,0.72,0.6818,0.62,0.2537,31,37,68,68,True
12861,2012-06-25,3,1,6,1,0,1,1,1,0.7,0.6515,0.65,0.2239,11,20,31,31,True
12862,2012-06-25,3,1,6,2,0,1,1,1,0.7,0.6515,0.7,0.2239,4,10,14,14,True
12863,2012-06-25,3,1,6,3,0,1,1,1,0.68,0.6364,0.69,0.2537,1,4,5,5,True
12864,2012-06-25,3,1,6,4,0,1,1,1,0.66,0.6061,0.78,0.2537,0,4,4,4,True
12865,2012-06-25,3,1,6,5,0,1,1,1,0.66,0.6212,0.74,0.1642,1,42,43,43,True
12866,2012-06-25,3,1,6,6,0,1,1,1,0.64,0.5909,0.78,0.1642,11,147,158,158,True
12867,2012-06-25,3,1,6,7,0,1,1,1,0.66,0.6212,0.74,0.2239,30,455,485,485,True
12868,2012-06-25,3,1,6,8,0,1,1,1,0.66,0.6212,0.69,0.194,53,499,552,552,True
12869,2012-06-25,3,1,6,9,0,1,1,1,0.7,0.6515,0.65,0.194,37,231,268,268,True
12870,2012-06-25,3,1,6,10,0,1,1,1,0.76,0.697,0.55,0.1642,58,126,184,184,True
12871,2012-06-25,3,1,6,11,0,1,1,1,0.8,0.7273,0.43,0.3284,54,127,181,181,True
12872,2012-06-25,3,1,6,12,0,1,1,2,0.76,0.6818,0.45,0.2985,74,196,270,270,True
12873,2012-06-25,3,1,6,13,0,1,1,1,0.72,0.6667,0.51,0.2985,79,181,260,260,True
12874,2012-06-25,3,1,6,14,0,1,1,1,0.78,0.697,0.43,0.2537,90,161,251,251,True
12875,2012-06-25,3,1,6,15,0,1,1,1,0.78,0.6818,0.38,0.4627,65,168,233,233,True
12876,2012-06-25,3,1,6,16,0,1,1,1,0.8,0.697,0.31,0.3881,104,310,414,414,True
12877,2012-06-25,3,1,6,17,0,1,1,1,0.8,0.6818,0.24,0.4627,76,499,575,575,True
12878,2012-06-25,3,1,6,18,0,1,1,1,0.76,0.6667,0.27,0.4478,100,499,599,599,True
12879,2012-06-25,3,1,6,19,0,1,1,1,0.74,0.6515,0.27,0.4627,74,499,573,573,True
12880,2012-06-25,3,1,6,20,0,1,1,1,0.72,0.6515,0.3,0.4478,100,375,475,475,True
12881,2012-06-25,3,1,6,21,0,1,1,1,0.68,0.6212,0.3,0.3284,50,281,331,331,True
12882,2012-06-25,3,1,6,22,0,1,1,1,0.66,0.6212,0.29,0.3881,21,166,187,187,True
12883,2012-06-25,3,1,6,23,0,1,1,1,0.64,0.6212,0.33,0.3284,15,88,103,103,True
12884,2012-06-26,3,1,6,0,0,2,1,1,0.62,0.6212,0.33,0.3284,8,29,37,37,True
12885,2012-06-26,3,1,6,1,0,2,1,1,0.6,0.6212,0.35,0.3881,11,19,30,30,True
12886,2012-06-26,3,1,6,2,0,2,1,1,0.56,0.5303,0.43,0.2836,2,7,9,9,True
12887,2012-06-26,3,1,6,3,0,2,1,1,0.54,0.5152,0.45,0.2836,2,7,9,9,True
12888,2012-06-26,3,1,6,4,0,2,1,1,0.54,0.5152,0.45,0.2985,1,9,10,10,True
12889,2012-06-26,3,1,6,5,0,2,1,1,0.52,0.5,0.48,0.3881,3,36,39,39,True
12890,2012-06-26,3,1,6,6,0,2,1,1,0.52,0.5,0.52,0.2985,12,176,188,188,True
12891,2012-06-26,3,1,6,7,0,2,1,1,0.52,0.5,0.52,0.3582,21,499,520,520,True
12892,2012-06-26,3,1,6,8,0,2,1,1,0.56,0.5303,0.49,0.3284,34,499,533,533,True
12893,2012-06-26,3,1,6,9,0,2,1,1,0.58,0.5455,0.46,0.4179,30,298,328,328,True
12894,2012-06-26,3,1,6,10,0,2,1,1,0.62,0.6212,0.41,0.3582,37,153,190,190,True
12895,2012-06-26,3,1,6,11,0,2,1,1,0.64,0.6212,0.36,0.4179,46,189,235,235,True
12896,2012-06-26,3,1,6,12,0,2,1,1,0.66,0.6212,0.34,0.4478,80,228,308,308,True
12897,2012-06-26,3,1,6,13,0,2,1,1,0.7,0.6364,0.3,0.4627,74,232,306,306,True
12898,2012-06-26,3,1,6,14,0,2,1,1,0.7,0.6364,0.3,0.4627,81,186,267,267,True
12899,2012-06-26,3,1,6,15,0,2,1,1,0.72,0.6515,0.28,0.4627,88,229,317,317,True
12900,2012-06-26,3,1,6,16,0,2,1,1,0.72,0.6364,0.26,0.4775,67,349,416,416,True
12901,2012-06-26,3,1,6,17,0,2,1,1,0.72,0.6515,0.28,0.4179,104,499,603,603,True
12902,2012-06-26,3,1,6,18,0,2,1,1,0.72,0.6515,0.28,0.3582,105,499,604,604,True
12903,2012-06-26,3,1,6,19,0,2,1,1,0.72,0.6515,0.28,0.2239,83,499,582,582,True
12904,2012-06-26,3,1,6,20,0,2,1,1,0.7,0.6364,0.3,0.2836,88,417,505,505,True
12905,2012-06-26,3,1,6,21,0,2,1,1,0.68,0.6364,0.34,0.194,61,267,328,328,True
12906,2012-06-26,3,1,6,22,0,2,1,1,0.66,0.6212,0.34,0.2537,26,219,245,245,True
12907,2012-06-26,3,1,6,23,0,2,1,1,0.62,0.6212,0.41,0.1343,13,118,131,131,True
12908,2012-06-27,3,1,6,0,0,3,1,1,0.62,0.6212,0.41,0.194,15,39,54,54,True
12909,2012-06-27,3,1,6,1,0,3,1,1,0.6,0.6212,0.43,0.1642,5,18,23,23,True
12910,2012-06-27,3,1,6,2,0,3,1,1,0.56,0.5303,0.49,0.1343,2,12,14,14,True
12911,2012-06-27,3,1,6,3,0,3,1,1,0.58,0.5455,0.46,0.0896,1,7,8,8,True
12912,2012-06-27,3,1,6,4,0,3,1,1,0.6,0.6212,0.4,0.2537,0,11,11,11,True
12913,2012-06-27,3,1,6,5,0,3,1,1,0.6,0.6212,0.43,0.2836,2,34,36,36,True
12914,2012-06-27,3,1,6,6,0,3,1,1,0.58,0.5455,0.46,0.2836,7,193,200,200,True
12915,2012-06-27,3,1,6,7,0,3,1,1,0.6,0.6212,0.43,0.3582,29,498,527,527,True
12916,2012-06-27,3,1,6,8,0,3,1,1,0.62,0.6212,0.43,0.3284,49,499,548,548,True
12917,2012-06-27,3,1,6,9,0,3,1,1,0.66,0.6212,0.41,0.3582,29,253,282,282,True
12918,2012-06-27,3,1,6,10,0,3,1,1,0.7,0.6364,0.37,0.2537,34,138,172,172,True
12919,2012-06-27,3,1,6,11,0,3,1,1,0.74,0.6515,0.3,0.3284,64,145,209,209,True
12920,2012-06-27,3,1,6,12,0,3,1,1,0.76,0.6667,0.29,0.2985,77,245,322,322,True
12921,2012-06-27,3,1,6,13,0,3,1,1,0.8,0.697,0.27,0.3284,77,244,321,321,True
12922,2012-06-27,3,1,6,14,0,3,1,1,0.8,0.6818,0.24,0.3582,78,192,270,270,True
12923,2012-06-27,3,1,6,15,0,3,1,1,0.8,0.697,0.26,0.4627,61,188,249,249,True
12924,2012-06-27,3,1,6,16,0,3,1,1,0.82,0.697,0.24,0.4478,55,337,392,392,True
12925,2012-06-27,3,1,6,17,0,3,1,1,0.82,0.697,0.24,0.3881,113,499,612,612,True
12926,2012-06-27,3,1,6,18,0,3,1,1,0.8,0.697,0.27,0.3284,85,499,584,584,True
12927,2012-06-27,3,1,6,19,0,3,1,1,0.78,0.6818,0.29,0.3284,101,499,600,600,True
12928,2012-06-27,3,1,6,20,0,3,1,1,0.76,0.6667,0.31,0.194,76,369,445,445,True
12929,2012-06-27,3,1,6,21,0,3,1,1,0.74,0.6515,0.35,0.1343,54,313,367,367,True
12930,2012-06-27,3,1,6,22,0,3,1,1,0.72,0.6515,0.39,0.0896,52,245,297,297,True
12931,2012-06-27,3,1,6,23,0,3,1,1,0.68,0.6364,0.47,0.1343,11,148,159,159,True
12932,2012-06-28,3,1,6,0,0,4,1,1,0.66,0.6212,0.5,0.1045,2,52,54,54,True
12933,2012-06-28,3,1,6,1,0,4,1,1,0.66,0.6212,0.54,0.0,11,14,25,25,True
12934,2012-06-28,3,1,6,2,0,4,1,1,0.66,0.6212,0.5,0.0896,1,12,13,13,True
12935,2012-06-28,3,1,6,3,0,4,1,1,0.66,0.6212,0.5,0.0896,1,6,7,7,True
12936,2012-06-28,3,1,6,4,0,4,1,1,0.62,0.6061,0.61,0.1045,0,11,11,11,True
12937,2012-06-28,3,1,6,5,0,4,1,1,0.62,0.6212,0.57,0.0896,8,39,47,47,True
12938,2012-06-28,3,1,6,6,0,4,1,1,0.62,0.6212,0.57,0.0896,8,185,193,193,True
12939,2012-06-28,3,1,6,7,0,4,1,1,0.62,0.6061,0.61,0.1045,24,484,508,508,True
12940,2012-06-28,3,1,6,8,0,4,1,1,0.66,0.6212,0.5,0.1343,40,499,539,539,True
12941,2012-06-28,3,1,6,9,0,4,1,1,0.7,0.6515,0.54,0.1642,33,318,351,351,True
12942,2012-06-28,3,1,6,10,0,4,1,1,0.74,0.6667,0.48,0.194,40,144,184,184,True
12943,2012-06-28,3,1,6,11,0,4,1,1,0.8,0.697,0.31,0.194,41,170,211,211,True
12944,2012-06-28,3,1,6,12,0,4,1,1,0.84,0.7121,0.26,0.2836,49,227,276,276,True
12945,2012-06-28,3,1,6,13,0,4,1,1,0.86,0.7424,0.26,0.2239,31,205,236,236,True
12946,2012-06-28,3,1,6,14,0,4,1,1,0.86,0.7273,0.25,0.3284,66,188,254,254,True
12947,2012-06-28,3,1,6,15,0,4,1,1,0.86,0.7273,0.25,0.3284,24,195,219,219,True
12948,2012-06-28,3,1,6,16,0,4,1,1,0.88,0.7424,0.23,0.194,56,331,387,387,True
12949,2012-06-28,3,1,6,17,0,4,1,1,0.88,0.7424,0.22,0.194,71,499,570,570,True
12950,2012-06-28,3,1,6,18,0,4,1,1,0.86,0.7273,0.25,0.2239,100,499,599,599,True
12951,2012-06-28,3,1,6,19,0,4,1,1,0.84,0.7273,0.3,0.2985,79,492,571,571,True
12952,2012-06-28,3,1,6,20,0,4,1,1,0.82,0.7273,0.34,0.194,71,399,470,470,True
12953,2012-06-28,3,1,6,21,0,4,1,1,0.76,0.697,0.55,0.194,89,309,398,398,True
12954,2012-06-28,3,1,6,22,0,4,1,1,0.76,0.697,0.52,0.1642,50,224,274,274,True
12955,2012-06-28,3,1,6,23,0,4,1,1,0.74,0.6667,0.48,0.1343,26,145,171,171,True
12956,2012-06-29,3,1,6,0,0,5,1,1,0.74,0.6667,0.48,0.1343,24,90,114,114,True
12957,2012-06-29,3,1,6,1,0,5,1,1,0.74,0.6667,0.51,0.1642,9,33,42,42,True
12958,2012-06-29,3,1,6,2,0,5,1,1,0.72,0.6667,0.58,0.194,3,15,18,18,True
12959,2012-06-29,3,1,6,3,0,5,1,1,0.72,0.6667,0.58,0.194,3,5,8,8,True
12960,2012-06-29,3,1,6,4,0,5,1,1,0.7,0.6515,0.65,0.1642,1,9,10,10,True
12961,2012-06-29,3,1,6,5,0,5,1,1,0.7,0.6515,0.61,0.1045,6,39,45,45,True
12962,2012-06-29,3,1,6,6,0,5,1,2,0.7,0.6515,0.61,0.1642,15,148,163,163,True
12963,2012-06-29,3,1,6,7,0,5,1,1,0.7,0.6515,0.61,0.1045,19,361,380,380,True
12964,2012-06-29,3,1,6,8,0,5,1,2,0.74,0.6818,0.55,0.1045,48,499,547,547,True
12965,2012-06-29,3,1,6,9,0,5,1,1,0.76,0.697,0.55,0.1642,39,261,300,300,True
12966,2012-06-29,3,1,6,10,0,5,1,1,0.9,0.8333,0.39,0.2985,32,139,171,171,True
12967,2012-06-29,3,1,6,11,0,5,1,2,0.9,0.8485,0.42,0.2836,51,137,188,188,True
12968,2012-06-29,3,1,6,12,0,5,1,2,0.92,0.8788,0.4,0.2537,53,173,226,226,True
12969,2012-06-29,3,1,6,13,0,5,1,1,0.94,0.8788,0.38,0.194,45,194,239,239,True
12970,2012-06-29,3,1,6,14,0,5,1,1,0.96,0.9091,0.36,0.2239,49,184,233,233,True
12971,2012-06-29,3,1,6,15,0,5,1,1,0.96,0.9091,0.36,0.0,47,183,230,230,True
12972,2012-06-29,3,1,6,16,0,5,1,1,0.96,0.9091,0.36,0.0,59,292,351,351,True
12973,2012-06-29,3,1,6,17,0,5,1,1,0.98,0.9242,0.34,0.194,82,457,539,539,True
12974,2012-06-29,3,1,6,18,0,5,1,1,0.96,0.8636,0.31,0.0,50,414,464,464,True
12975,2012-06-29,3,1,6,19,0,5,1,1,0.9,0.8788,0.47,0.194,60,303,363,363,True
12976,2012-06-29,3,1,6,20,0,5,1,1,0.92,0.8939,0.42,0.2537,53,255,308,308,True
12977,2012-06-29,3,1,6,21,0,5,1,2,0.86,0.8333,0.53,0.194,41,195,236,236,True
12978,2012-06-29,3,1,6,22,0,5,1,3,0.82,0.8333,0.63,0.194,34,129,163,163,True
12979,2012-06-29,3,1,6,23,0,5,1,3,0.82,0.8333,0.63,0.194,6,42,48,48,True
12980,2012-06-30,3,1,6,0,0,6,0,3,0.64,0.5758,0.89,0.1642,4,65,69,69,True
12981,2012-06-30,3,1,6,1,0,6,0,3,0.64,0.5758,0.89,0.2239,3,55,58,58,True
12982,2012-06-30,3,1,6,2,0,6,0,2,0.64,0.5758,0.89,0.0,7,54,61,61,True
12983,2012-06-30,3,1,6,3,0,6,0,2,0.64,0.5758,0.89,0.0,3,20,23,23,True
12984,2012-06-30,3,1,6,4,0,6,0,2,0.62,0.5455,0.94,0.0,3,15,18,18,True
12985,2012-06-30,3,1,6,5,0,6,0,1,0.64,0.5758,0.89,0.1642,3,7,10,10,True
12986,2012-06-30,3,1,6,6,0,6,0,1,0.64,0.5758,0.89,0.1642,6,36,42,42,True
12987,2012-06-30,3,1,6,7,0,6,0,1,0.64,0.5758,0.89,0.1642,10,82,92,92,True
12988,2012-06-30,3,1,6,8,0,6,0,1,0.64,0.5758,0.89,0.1642,26,168,194,194,True
12989,2012-06-30,3,1,6,9,0,6,0,1,0.64,0.5758,0.89,0.1642,41,234,275,275,True
12990,2012-06-30,3,1,6,10,0,6,0,1,0.88,0.7727,0.3,0.2537,96,308,404,404,True
12991,2012-06-30,3,1,6,11,0,6,0,1,0.88,0.7727,0.3,0.2537,102,350,452,452,True
12992,2012-06-30,3,1,6,12,0,6,0,1,0.88,0.7727,0.3,0.2537,114,328,442,442,True
12993,2012-06-30,3,1,6,13,0,6,0,1,0.88,0.7727,0.3,0.2537,105,323,428,428,True
12994,2012-06-30,3,1,6,14,0,6,0,1,0.88,0.7727,0.3,0.2537,114,295,409,409,True
12995,2012-06-30,3,1,6,15,0,6,0,1,0.88,0.7727,0.3,0.2537,114,287,401,401,True
12996,2012-06-30,3,1,6,16,0,6,0,1,0.9,0.7879,0.29,0.1642,109,264,373,373,True
12997,2012-06-30,3,1,6,17,0,6,0,1,0.88,0.7727,0.32,0.1343,114,231,345,345,True
12998,2012-06-30,3,1,6,18,0,6,0,1,0.88,0.7879,0.35,0.0,91,248,339,339,True
12999,2012-06-30,3,1,6,19,0,6,0,1,0.84,0.7576,0.44,0.2537,114,240,354,354,True
13000,2012-06-30,3,1,6,20,0,6,0,1,0.82,0.7727,0.52,0.1642,88,204,292,292,True
13001,2012-06-30,3,1,6,21,0,6,0,1,0.82,0.7727,0.52,0.1642,48,165,213,213,True
13002,2012-06-30,3,1,6,22,0,6,0,1,0.78,0.7424,0.62,0.1642,38,134,172,172,True
13003,2012-06-30,3,1,6,23,0,6,0,1,0.78,0.7424,0.62,0.0896,33,119,152,152,True
13004,2012-07-01,3,1,7,0,0,0,0,1,0.76,0.7273,0.66,0.0,27,122,149,149,True
13005,2012-07-01,3,1,7,1,0,0,0,1,0.74,0.697,0.7,0.1343,12,81,93,93,True
13006,2012-07-01,3,1,7,2,0,0,0,1,0.72,0.697,0.74,0.0896,21,69,90,90,True
13007,2012-07-01,3,1,7,3,0,0,0,1,0.72,0.7121,0.84,0.1343,6,27,33,33,True
13008,2012-07-01,3,1,7,4,0,0,0,1,0.7,0.6667,0.79,0.194,0,4,4,4,True
13009,2012-07-01,3,1,7,5,0,0,0,1,0.68,0.6364,0.79,0.1045,3,7,10,10,True
13010,2012-07-01,3,1,7,6,0,0,0,1,0.7,0.6667,0.79,0.0896,8,19,27,27,True
13011,2012-07-01,3,1,7,7,0,0,0,1,0.74,0.697,0.7,0.0,13,37,50,50,True
13012,2012-07-01,3,1,7,8,0,0,0,1,0.78,0.7424,0.62,0.1045,36,106,142,142,True
13013,2012-07-01,3,1,7,9,0,0,0,1,0.82,0.7879,0.56,0.0,51,168,219,219,True
13014,2012-07-01,3,1,7,10,0,0,0,1,0.86,0.7879,0.44,0.2985,98,268,366,366,True
13015,2012-07-01,3,1,7,11,0,0,0,1,0.88,0.803,0.39,0.2239,114,256,370,370,True
13016,2012-07-01,3,1,7,12,0,0,0,1,0.9,0.8182,0.37,0.2239,114,319,433,433,True
13017,2012-07-01,3,1,7,13,0,0,0,1,0.92,0.8333,0.33,0.2537,111,309,420,420,True
13018,2012-07-01,3,1,7,14,0,0,0,1,0.92,0.8333,0.33,0.2537,98,346,444,444,True
13019,2012-07-01,3,1,7,15,0,0,0,1,0.9,0.8182,0.37,0.2836,101,244,345,345,True
13020,2012-07-01,3,1,7,16,0,0,0,1,0.92,0.8333,0.33,0.2985,85,228,313,313,True
13021,2012-07-01,3,1,7,17,0,0,0,1,0.92,0.803,0.26,0.2985,90,323,413,413,True
13022,2012-07-01,3,1,7,18,0,0,0,1,0.88,0.7727,0.32,0.3582,95,275,370,370,True
13023,2012-07-01,3,1,7,19,0,0,0,1,0.84,0.7424,0.39,0.1343,103,279,382,382,True
13024,2012-07-01,3,1,7,20,0,0,0,1,0.84,0.7424,0.39,0.1343,88,244,332,332,True
13025,2012-07-01,3,1,7,21,0,0,0,1,0.84,0.7424,0.39,0.1343,77,181,258,258,True
13026,2012-07-01,3,1,7,22,0,0,0,1,0.82,0.7424,0.43,0.1343,41,110,151,151,True
13027,2012-07-01,3,1,7,23,0,0,0,3,0.78,0.7121,0.52,0.1642,22,88,110,110,True
13028,2012-07-02,3,1,7,0,0,1,1,2,0.76,0.7121,0.58,0.2239,12,31,43,43,True
13029,2012-07-02,3,1,7,1,0,1,1,2,0.76,0.7121,0.58,0.194,3,14,17,17,True
13030,2012-07-02,3,1,7,2,0,1,1,2,0.74,0.6667,0.51,0.2537,1,14,15,15,True
13031,2012-07-02,3,1,7,3,0,1,1,2,0.72,0.6667,0.54,0.4179,0,5,5,5,True
13032,2012-07-02,3,1,7,4,0,1,1,2,0.72,0.6667,0.54,0.2985,2,10,12,12,True
13033,2012-07-02,3,1,7,5,0,1,1,2,0.72,0.6667,0.51,0.0,3,37,40,40,True
13034,2012-07-02,3,1,7,6,0,1,1,1,0.7,0.6515,0.58,0.1045,4,132,136,136,True
13035,2012-07-02,3,1,7,7,0,1,1,1,0.74,0.6667,0.51,0.1045,8,390,398,398,True
13036,2012-07-02,3,1,7,8,0,1,1,1,0.76,0.697,0.52,0.194,20,499,519,519,True
13037,2012-07-02,3,1,7,9,0,1,1,1,0.78,0.697,0.46,0.2537,56,239,295,295,True
13038,2012-07-02,3,1,7,10,0,1,1,1,0.8,0.7273,0.43,0.2537,70,104,174,174,True
13039,2012-07-02,3,1,7,11,0,1,1,1,0.84,0.7273,0.28,0.2985,67,134,201,201,True
13040,2012-07-02,3,1,7,12,0,1,1,1,0.84,0.7273,0.32,0.194,74,183,257,257,True
13041,2012-07-02,3,1,7,13,0,1,1,1,0.86,0.7576,0.34,0.2239,74,162,236,236,True
13042,2012-07-02,3,1,7,14,0,1,1,1,0.86,0.7576,0.34,0.2239,79,151,230,230,True
13043,2012-07-02,3,1,7,15,0,1,1,1,0.84,0.7424,0.36,0.194,59,175,234,234,True
13044,2012-07-02,3,1,7,16,0,1,1,1,0.84,0.7424,0.36,0.2836,61,304,365,365,True
13045,2012-07-02,3,1,7,17,0,1,1,1,0.84,0.7273,0.32,0.1343,82,499,581,581,True
13046,2012-07-02,3,1,7,18,0,1,1,1,0.84,0.7273,0.32,0.1642,72,499,571,571,True
13047,2012-07-02,3,1,7,19,0,1,1,1,0.78,0.697,0.43,0.1343,71,499,570,570,True
13048,2012-07-02,3,1,7,20,0,1,1,1,0.78,0.697,0.43,0.1343,38,357,395,395,True
13049,2012-07-02,3,1,7,21,0,1,1,1,0.76,0.6818,0.45,0.1343,17,241,258,258,True
13050,2012-07-02,3,1,7,22,0,1,1,1,0.74,0.6667,0.51,0.1642,19,169,188,188,True
13051,2012-07-02,3,1,7,23,0,1,1,1,0.74,0.6667,0.51,0.1045,12,90,102,102,True
13052,2012-07-03,3,1,7,0,0,2,1,1,0.72,0.6667,0.54,0.0,9,44,53,53,True
13053,2012-07-03,3,1,7,1,0,2,1,1,0.72,0.6667,0.58,0.0,5,9,14,14,True
13054,2012-07-03,3,1,7,2,0,2,1,1,0.72,0.6667,0.58,0.0,2,8,10,10,True
13055,2012-07-03,3,1,7,3,0,2,1,1,0.7,0.6515,0.65,0.1343,0,2,2,2,True
13056,2012-07-03,3,1,7,4,0,2,1,1,0.68,0.6364,0.65,0.1045,0,6,6,6,True
13057,2012-07-03,3,1,7,5,0,2,1,1,0.7,0.6515,0.61,0.0,2,33,35,35,True
13058,2012-07-03,3,1,7,6,0,2,1,1,0.7,0.6515,0.65,0.1343,5,149,154,154,True
13059,2012-07-03,3,1,7,7,0,2,1,1,0.74,0.6818,0.58,0.0,21,462,483,483,True
13060,2012-07-03,3,1,7,8,0,2,1,1,0.74,0.6818,0.62,0.0896,42,499,541,541,True
13061,2012-07-03,3,1,7,9,0,2,1,1,0.8,0.7424,0.49,0.1642,46,226,272,272,True
13062,2012-07-03,3,1,7,10,0,2,1,1,0.82,0.7424,0.43,0.2239,56,153,209,209,True
13063,2012-07-03,3,1,7,11,0,2,1,1,0.86,0.7576,0.34,0.194,66,151,217,217,True
13064,2012-07-03,3,1,7,12,0,2,1,1,0.88,0.7576,0.28,0.194,74,198,272,272,True
13065,2012-07-03,3,1,7,13,0,2,1,1,0.9,0.7727,0.25,0.1343,80,203,283,283,True
13066,2012-07-03,3,1,7,14,0,2,1,1,0.9,0.7727,0.25,0.194,69,241,310,310,True
13067,2012-07-03,3,1,7,15,0,2,1,2,0.9,0.7727,0.24,0.0,71,330,401,401,True
13068,2012-07-03,3,1,7,16,0,2,1,2,0.9,0.7727,0.24,0.194,90,437,527,527,True
13069,2012-07-03,3,1,7,17,0,2,1,2,0.86,0.7424,0.3,0.1642,102,499,601,601,True
13070,2012-07-03,3,1,7,18,0,2,1,2,0.86,0.7424,0.3,0.0,85,499,584,584,True
13071,2012-07-03,3,1,7,19,0,2,1,2,0.84,0.7424,0.36,0.1343,66,431,497,497,True
13072,2012-07-03,3,1,7,20,0,2,1,3,0.76,0.697,0.55,0.4775,80,296,376,376,True
13073,2012-07-03,3,1,7,21,0,2,1,2,0.7,0.6515,0.7,0.2836,36,160,196,196,True
13074,2012-07-03,3,1,7,22,0,2,1,1,0.68,0.6364,0.79,0.194,26,151,177,177,True
13075,2012-07-03,3,1,7,23,0,2,1,1,0.66,0.6061,0.83,0.0,19,152,171,171,True
13076,2012-07-04,3,1,7,0,1,3,0,1,0.68,0.6364,0.79,0.0896,19,140,159,159,True
13077,2012-07-04,3,1,7,1,1,3,0,1,0.68,0.6364,0.74,0.0,27,96,123,123,True
13078,2012-07-04,3,1,7,2,1,3,0,1,0.66,0.6061,0.83,0.1343,27,66,93,93,True
13079,2012-07-04,3,1,7,3,1,3,0,1,0.68,0.6364,0.74,0.194,9,23,32,32,True
13080,2012-07-04,3,1,7,4,1,3,0,1,0.68,0.6364,0.69,0.2537,5,11,16,16,True
13081,2012-07-04,3,1,7,5,1,3,0,1,0.66,0.6212,0.69,0.0,5,14,19,19,True
13082,2012-07-04,3,1,7,6,1,3,0,1,0.66,0.6212,0.69,0.0,9,23,32,32,True
13083,2012-07-04,3,1,7,7,1,3,0,1,0.68,0.6364,0.65,0.0,10,62,72,72,True
13084,2012-07-04,3,1,7,8,1,3,0,1,0.7,0.6515,0.61,0.1045,43,110,153,153,True
13085,2012-07-04,3,1,7,9,1,3,0,1,0.76,0.697,0.52,0.0,90,203,293,293,True
13086,2012-07-04,3,1,7,10,1,3,0,1,0.8,0.7273,0.46,0.0,114,304,418,418,True
13087,2012-07-04,3,1,7,11,1,3,0,1,0.82,0.7576,0.46,0.1343,114,321,435,435,True
13088,2012-07-04,3,1,7,12,1,3,0,1,0.86,0.7879,0.41,0.2239,114,330,444,444,True
13089,2012-07-04,3,1,7,13,1,3,0,1,0.9,0.8182,0.35,0.0,114,322,436,436,True
13090,2012-07-04,3,1,7,14,1,3,0,1,0.9,0.8182,0.37,0.1642,114,357,471,471,True
13091,2012-07-04,3,1,7,15,1,3,0,1,0.92,0.8485,0.35,0.2985,114,299,413,413,True
13092,2012-07-04,3,1,7,16,1,3,0,1,0.92,0.8485,0.35,0.2537,114,226,340,340,True
13093,2012-07-04,3,1,7,17,1,3,0,1,0.92,0.8485,0.35,0.2985,114,253,367,367,True
13094,2012-07-04,3,1,7,18,1,3,0,1,0.9,0.8485,0.42,0.194,114,271,385,385,True
13095,2012-07-04,3,1,7,19,1,3,0,1,0.86,0.803,0.47,0.2239,114,255,369,369,True
13096,2012-07-04,3,1,7,20,1,3,0,1,0.86,0.803,0.47,0.2239,114,314,428,428,True
13097,2012-07-04,3,1,7,21,1,3,0,1,0.84,0.803,0.53,0.1343,114,362,476,476,True
13098,2012-07-04,3,1,7,22,1,3,0,1,0.82,0.7879,0.56,0.2239,114,327,441,441,True
13099,2012-07-04,3,1,7,23,1,3,0,2,0.78,0.697,0.43,0.0896,31,152,183,183,True
13100,2012-07-05,3,1,7,0,0,4,1,1,0.74,0.6667,0.51,0.1045,17,71,88,88,True
13101,2012-07-05,3,1,7,1,0,4,1,1,0.74,0.6667,0.51,0.2836,6,24,30,30,True
13102,2012-07-05,3,1,7,2,0,4,1,1,0.74,0.6667,0.51,0.0,4,14,18,18,True
13103,2012-07-05,3,1,7,3,0,4,1,1,0.72,0.6667,0.54,0.194,2,5,7,7,True
13104,2012-07-05,3,1,7,4,0,4,1,1,0.72,0.6667,0.58,0.0,0,7,7,7,True
13105,2012-07-05,3,1,7,5,0,4,1,1,0.72,0.6818,0.62,0.0,1,28,29,29,True
13106,2012-07-05,3,1,7,6,0,4,1,1,0.72,0.6667,0.58,0.0,3,130,133,133,True
13107,2012-07-05,3,1,7,7,0,4,1,1,0.76,0.697,0.55,0.0,27,316,343,343,True
13108,2012-07-05,3,1,7,8,0,4,1,1,0.8,0.7424,0.49,0.1343,36,499,535,535,True
13109,2012-07-05,3,1,7,9,0,4,1,1,0.84,0.7879,0.49,0.2985,47,246,293,293,True
13110,2012-07-05,3,1,7,10,0,4,1,1,0.86,0.7879,0.44,0.3582,69,117,186,186,True
13111,2012-07-05,3,1,7,11,0,4,1,1,0.9,0.8182,0.35,0.2985,107,137,244,244,True
13112,2012-07-05,3,1,7,12,0,4,1,1,0.9,0.8182,0.35,0.3582,88,188,276,276,True
13113,2012-07-05,3,1,7,13,0,4,1,1,0.92,0.8333,0.33,0.2239,114,181,295,295,True
13114,2012-07-05,3,1,7,14,0,4,1,1,0.92,0.8333,0.33,0.3284,87,154,241,241,True
13115,2012-07-05,3,1,7,15,0,4,1,1,0.92,0.8333,0.33,0.3582,71,183,254,254,True
13116,2012-07-05,3,1,7,16,0,4,1,1,0.92,0.8333,0.33,0.2537,109,324,433,433,True
13117,2012-07-05,3,1,7,17,0,4,1,1,0.92,0.8485,0.35,0.1642,114,499,613,613,True
13118,2012-07-05,3,1,7,18,0,4,1,2,0.9,0.8333,0.39,0.3284,96,499,595,595,True
13119,2012-07-05,3,1,7,19,0,4,1,2,0.88,0.803,0.39,0.2537,114,375,489,489,True
13120,2012-07-05,3,1,7,20,0,4,1,2,0.86,0.7879,0.41,0.2239,78,243,321,321,True
13121,2012-07-05,3,1,7,21,0,4,1,1,0.84,0.7727,0.47,0.194,91,232,323,323,True
13122,2012-07-05,3,1,7,22,0,4,1,1,0.82,0.803,0.59,0.1343,63,162,225,225,True
13123,2012-07-05,3,1,7,23,0,4,1,1,0.8,0.7576,0.55,0.1642,32,99,131,131,True
13124,2012-07-06,3,1,7,0,0,5,1,1,0.78,0.7424,0.62,0.1343,39,63,102,102,True
13125,2012-07-06,3,1,7,1,0,5,1,1,0.78,0.7273,0.55,0.2239,7,22,29,29,True
13126,2012-07-06,3,1,7,2,0,5,1,1,0.76,0.7121,0.62,0.1343,4,13,17,17,True
13127,2012-07-06,3,1,7,3,0,5,1,2,0.74,0.697,0.7,0.194,1,6,7,7,True
13128,2012-07-06,3,1,7,4,0,5,1,1,0.74,0.697,0.66,0.2239,2,4,6,6,True
13129,2012-07-06,3,1,7,5,0,5,1,1,0.74,0.697,0.66,0.194,4,31,35,35,True
13130,2012-07-06,3,1,7,6,0,5,1,1,0.74,0.697,0.66,0.194,4,127,131,131,True
13131,2012-07-06,3,1,7,7,0,5,1,1,0.78,0.697,0.46,0.1343,20,333,353,353,True
13132,2012-07-06,3,1,7,8,0,5,1,1,0.8,0.7121,0.41,0.1642,28,499,527,527,True
13133,2012-07-06,3,1,7,9,0,5,1,1,0.82,0.7273,0.36,0.1343,55,249,304,304,True
13134,2012-07-06,3,1,7,10,0,5,1,1,0.86,0.7424,0.3,0.0,80,130,210,210,True
13135,2012-07-06,3,1,7,11,0,5,1,1,0.84,0.7273,0.32,0.0896,92,141,233,233,True
13136,2012-07-06,3,1,7,12,0,5,1,1,0.88,0.7576,0.28,0.1045,111,220,331,331,True
13137,2012-07-06,3,1,7,13,0,5,1,1,0.9,0.7879,0.27,0.1045,99,194,293,293,True
13138,2012-07-06,3,1,7,14,0,5,1,1,0.9,0.803,0.31,0.1642,91,184,275,275,True
13139,2012-07-06,3,1,7,15,0,5,1,1,0.92,0.8182,0.29,0.194,79,206,285,285,True
13140,2012-07-06,3,1,7,16,0,5,1,1,0.92,0.8182,0.29,0.1045,69,300,369,369,True
13141,2012-07-06,3,1,7,17,0,5,1,1,0.92,0.8182,0.29,0.0,90,486,576,576,True
13142,2012-07-06,3,1,7,18,0,5,1,1,0.9,0.803,0.33,0.2537,106,454,560,560,True
13143,2012-07-06,3,1,7,19,0,5,1,1,0.88,0.7879,0.35,0.2239,112,306,418,418,True
13144,2012-07-06,3,1,7,20,0,5,1,1,0.86,0.7727,0.39,0.1045,91,245,336,336,True
13145,2012-07-06,3,1,7,21,0,5,1,1,0.82,0.7727,0.52,0.1343,77,223,300,300,True
13146,2012-07-06,3,1,7,22,0,5,1,1,0.8,0.7576,0.55,0.194,78,210,288,288,True
13147,2012-07-06,3,1,7,23,0,5,1,1,0.8,0.7879,0.63,0.1045,27,137,164,164,True
13148,2012-07-07,3,1,7,0,0,6,0,1,0.78,0.7576,0.66,0.1343,35,115,150,150,True
13149,2012-07-07,3,1,7,1,0,6,0,1,0.76,0.7273,0.7,0.1642,16,55,71,71,True
13150,2012-07-07,3,1,7,2,0,6,0,1,0.76,0.7424,0.72,0.1642,11,47,58,58,True
13151,2012-07-07,3,1,7,3,0,6,0,1,0.74,0.7121,0.74,0.1343,12,19,31,31,True
13152,2012-07-07,3,1,7,4,0,6,0,1,0.74,0.7121,0.74,0.1642,3,13,16,16,True
13153,2012-07-07,3,1,7,5,0,6,0,1,0.74,0.7121,0.74,0.194,2,12,14,14,True
13154,2012-07-07,3,1,7,6,0,6,0,1,0.74,0.7121,0.74,0.1045,4,27,31,31,True
13155,2012-07-07,3,1,7,7,0,6,0,1,0.78,0.7576,0.66,0.1045,8,63,71,71,True
13156,2012-07-07,3,1,7,8,0,6,0,1,0.82,0.8333,0.63,0.194,32,120,152,152,True
13157,2012-07-07,3,1,7,9,0,6,0,1,0.84,0.8333,0.59,0.1642,69,187,256,256,True
13158,2012-07-07,3,1,7,10,0,6,0,1,0.92,0.8636,0.37,0.2239,100,225,325,325,True
13159,2012-07-07,3,1,7,11,0,6,0,1,0.94,0.8788,0.38,0.194,114,245,359,359,True
13160,2012-07-07,3,1,7,12,0,6,0,1,0.96,0.8636,0.31,0.3582,114,218,332,332,True
13161,2012-07-07,3,1,7,13,0,6,0,2,0.96,0.8636,0.31,0.2537,114,244,358,358,True
13162,2012-07-07,3,1,7,14,0,6,0,2,0.96,0.8636,0.3,0.1343,105,203,308,308,True
13163,2012-07-07,3,1,7,15,0,6,0,1,0.96,0.8485,0.26,0.0,113,193,306,306,True
13164,2012-07-07,3,1,7,16,0,6,0,1,1.0,0.8636,0.19,0.1642,102,192,294,294,True
13165,2012-07-07,3,1,7,17,0,6,0,1,0.96,0.8485,0.26,0.1343,103,176,279,279,True
13166,2012-07-07,3,1,7,18,0,6,0,1,0.94,0.8333,0.29,0.0896,83,194,277,277,True
13167,2012-07-07,3,1,7,19,0,6,0,1,0.92,0.8333,0.33,0.1343,68,219,287,287,True
13168,2012-07-07,3,1,7,20,0,6,0,1,0.9,0.8182,0.37,0.1642,79,197,276,276,True
13169,2012-07-07,3,1,7,21,0,6,0,1,0.88,0.7879,0.37,0.194,51,150,201,201,True
13170,2012-07-07,3,1,7,22,0,6,0,1,0.84,0.8333,0.59,0.194,56,164,220,220,True
13171,2012-07-07,3,1,7,23,0,6,0,1,0.84,0.8182,0.56,0.1642,34,114,148,148,True
13172,2012-07-08,3,1,7,0,0,0,0,1,0.82,0.7879,0.56,0.1343,22,125,147,147,True
13173,2012-07-08,3,1,7,1,0,0,0,1,0.82,0.7879,0.56,0.1045,25,99,124,124,True
13174,2012-07-08,3,1,7,2,0,0,0,1,0.82,0.7727,0.52,0.1045,11,59,70,70,True
13175,2012-07-08,3,1,7,3,0,0,0,1,0.8,0.7727,0.59,0.1045,1,34,35,35,True
13176,2012-07-08,3,1,7,4,0,0,0,1,0.78,0.7576,0.66,0.1045,2,11,13,13,True
13177,2012-07-08,3,1,7,5,0,0,0,1,0.78,0.7424,0.62,0.0,1,5,6,6,True
13178,2012-07-08,3,1,7,6,0,0,0,1,0.78,0.7727,0.7,0.1343,5,16,21,21,True
13179,2012-07-08,3,1,7,7,0,0,0,1,0.8,0.803,0.66,0.0,19,33,52,52,True
13180,2012-07-08,3,1,7,8,0,0,0,1,0.84,0.803,0.53,0.1343,35,95,130,130,True
13181,2012-07-08,3,1,7,9,0,0,0,1,0.86,0.8182,0.5,0.1045,70,172,242,242,True
13182,2012-07-08,3,1,7,10,0,0,0,1,0.9,0.8636,0.45,0.0,85,234,319,319,True
13183,2012-07-08,3,1,7,11,0,0,0,1,0.92,0.8939,0.42,0.2985,114,269,383,383,True
13184,2012-07-08,3,1,7,12,0,0,0,1,0.92,0.8939,0.42,0.194,105,271,376,376,True
13185,2012-07-08,3,1,7,13,0,0,0,1,0.94,0.8788,0.38,0.2537,114,219,333,333,True
13186,2012-07-08,3,1,7,14,0,0,0,1,0.96,0.9091,0.36,0.1642,77,235,312,312,True
13187,2012-07-08,3,1,7,15,0,0,0,3,0.92,0.8939,0.42,0.2836,80,218,298,298,True
13188,2012-07-08,3,1,7,16,0,0,0,2,0.8,0.803,0.66,0.2239,65,226,291,291,True
13189,2012-07-08,3,1,7,17,0,0,0,1,0.78,0.7424,0.59,0.0,68,202,270,270,True
13190,2012-07-08,3,1,7,18,0,0,0,1,0.78,0.7424,0.62,0.1045,54,199,253,253,True
13191,2012-07-08,3,1,7,19,0,0,0,1,0.78,0.7424,0.62,0.1642,66,184,250,250,True
13192,2012-07-08,3,1,7,20,0,0,0,1,0.76,0.7273,0.7,0.0896,79,206,285,285,True
13193,2012-07-08,3,1,7,21,0,0,0,1,0.76,0.7273,0.7,0.1343,58,149,207,207,True
13194,2012-07-08,3,1,7,22,0,0,0,3,0.74,0.697,0.7,0.0896,12,110,122,122,True
13195,2012-07-08,3,1,7,23,0,0,0,3,0.68,0.6364,0.83,0.0896,25,98,123,123,True
13196,2012-07-09,3,1,7,0,0,1,1,2,0.68,0.6364,0.89,0.0896,6,33,39,39,True
13197,2012-07-09,3,1,7,1,0,1,1,3,0.7,0.6667,0.89,0.1045,5,13,18,18,True
13198,2012-07-09,3,1,7,2,0,1,1,3,0.7,0.6667,0.89,0.194,1,4,5,5,True
13199,2012-07-09,3,1,7,3,0,1,1,3,0.7,0.6667,0.89,0.194,0,5,5,5,True
13200,2012-07-09,3,1,7,4,0,1,1,3,0.66,0.5909,0.89,0.3881,1,1,2,2,True
13201,2012-07-09,3,1,7,5,0,1,1,2,0.66,0.6061,0.83,0.2239,1,27,28,28,True
13202,2012-07-09,3,1,7,6,0,1,1,3,0.64,0.5758,0.89,0.2537,6,86,92,92,True
13203,2012-07-09,3,1,7,7,0,1,1,3,0.66,0.6061,0.83,0.2239,7,223,230,230,True
13204,2012-07-09,3,1,7,8,0,1,1,2,0.66,0.6061,0.83,0.1642,26,429,455,455,True
13205,2012-07-09,3,1,7,9,0,1,1,2,0.66,0.6061,0.83,0.1642,38,325,363,363,True
13206,2012-07-09,3,1,7,10,0,1,1,2,0.66,0.6061,0.83,0.194,58,117,175,175,True
13207,2012-07-09,3,1,7,11,0,1,1,2,0.72,0.6818,0.62,0.1343,72,144,216,216,True
13208,2012-07-09,3,1,7,12,0,1,1,2,0.74,0.6818,0.58,0.1343,61,205,266,266,True
13209,2012-07-09,3,1,7,13,0,1,1,2,0.76,0.697,0.55,0.2537,67,188,255,255,True
13210,2012-07-09,3,1,7,14,0,1,1,2,0.74,0.6818,0.55,0.2537,58,184,242,242,True
13211,2012-07-09,3,1,7,15,0,1,1,2,0.76,0.6818,0.45,0.2239,66,214,280,280,True
13212,2012-07-09,3,1,7,16,0,1,1,1,0.78,0.697,0.4,0.2836,88,325,413,413,True
13213,2012-07-09,3,1,7,17,0,1,1,1,0.78,0.697,0.4,0.1642,108,499,607,607,True
13214,2012-07-09,3,1,7,18,0,1,1,1,0.76,0.6818,0.48,0.1343,82,499,581,581,True
13215,2012-07-09,3,1,7,19,0,1,1,1,0.74,0.6818,0.55,0.1642,88,499,587,587,True
13216,2012-07-09,3,1,7,20,0,1,1,2,0.74,0.6818,0.55,0.1045,69,378,447,447,True
13217,2012-07-09,3,1,7,21,0,1,1,2,0.74,0.6818,0.55,0.0896,33,298,331,331,True
13218,2012-07-09,3,1,7,22,0,1,1,2,0.72,0.6667,0.58,0.1045,35,189,224,224,True
13219,2012-07-09,3,1,7,23,0,1,1,2,0.7,0.6515,0.65,0.1045,22,109,131,131,True
13220,2012-07-10,3,1,7,0,0,2,1,1,0.7,0.6515,0.7,0.0896,16,53,69,69,True
13221,2012-07-10,3,1,7,1,0,2,1,1,0.7,0.6667,0.74,0.1343,0,15,15,15,True
13222,2012-07-10,3,1,7,2,0,2,1,1,0.7,0.6667,0.74,0.1343,1,15,16,16,True
13223,2012-07-10,3,1,7,3,0,2,1,1,0.68,0.6364,0.79,0.0,0,3,3,3,True
13224,2012-07-10,3,1,7,4,0,2,1,1,0.68,0.6364,0.79,0.1343,0,4,4,4,True
13225,2012-07-10,3,1,7,5,0,2,1,1,0.66,0.6061,0.83,0.1343,3,39,42,42,True
13226,2012-07-10,3,1,7,6,0,2,1,2,0.68,0.6364,0.79,0.1045,4,183,187,187,True
13227,2012-07-10,3,1,7,7,0,2,1,2,0.7,0.6667,0.74,0.1045,31,489,520,520,True
13228,2012-07-10,3,1,7,8,0,2,1,1,0.72,0.697,0.74,0.1343,34,499,533,533,True
13229,2012-07-10,3,1,7,9,0,2,1,1,0.74,0.697,0.66,0.1343,47,284,331,331,True
13230,2012-07-10,3,1,7,10,0,2,1,1,0.76,0.7121,0.62,0.194,56,134,190,190,True
13231,2012-07-10,3,1,7,11,0,2,1,1,0.8,0.7273,0.46,0.194,92,157,249,249,True
13232,2012-07-10,3,1,7,12,0,2,1,1,0.8,0.7121,0.41,0.1343,69,203,272,272,True
13233,2012-07-10,3,1,7,13,0,2,1,1,0.82,0.7273,0.38,0.194,77,203,280,280,True
13234,2012-07-10,3,1,7,14,0,2,1,1,0.82,0.7273,0.38,0.1642,71,171,242,242,True
13235,2012-07-10,3,1,7,15,0,2,1,1,0.8,0.7121,0.41,0.2239,77,188,265,265,True
13236,2012-07-10,3,1,7,16,0,2,1,1,0.8,0.7273,0.43,0.2239,89,346,435,435,True
13237,2012-07-10,3,1,7,17,0,2,1,1,0.78,0.7121,0.49,0.194,103,499,602,602,True
13238,2012-07-10,3,1,7,18,0,2,1,3,0.7,0.6667,0.74,0.2239,70,499,569,569,True
13239,2012-07-10,3,1,7,19,0,2,1,3,0.7,0.6667,0.74,0.2239,55,359,414,414,True
13240,2012-07-10,3,1,7,20,0,2,1,3,0.64,0.5758,0.83,0.2239,9,75,84,84,True
13241,2012-07-10,3,1,7,21,0,2,1,3,0.64,0.5758,0.89,0.1045,7,83,90,90,True
13242,2012-07-10,3,1,7,22,0,2,1,2,0.64,0.5758,0.83,0.1343,14,125,139,139,True
13243,2012-07-10,3,1,7,23,0,2,1,2,0.64,0.5758,0.89,0.1045,29,74,103,103,True
13244,2012-07-11,3,1,7,0,0,3,1,2,0.66,0.6061,0.83,0.1343,6,38,44,44,True
13245,2012-07-11,3,1,7,1,0,3,1,1,0.64,0.5758,0.89,0.0,3,11,14,14,True
13246,2012-07-11,3,1,7,2,0,3,1,1,0.64,0.5758,0.89,0.0,0,5,5,5,True
13247,2012-07-11,3,1,7,3,0,3,1,1,0.64,0.5758,0.89,0.1343,0,5,5,5,True
13248,2012-07-11,3,1,7,4,0,3,1,1,0.64,0.5758,0.89,0.1343,1,6,7,7,True
13249,2012-07-11,3,1,7,5,0,3,1,1,0.64,0.5758,0.89,0.0,5,36,41,41,True
13250,2012-07-11,3,1,7,6,0,3,1,1,0.64,0.5758,0.89,0.1343,17,168,185,185,True
13251,2012-07-11,3,1,7,7,0,3,1,2,0.66,0.6061,0.83,0.1045,26,471,497,497,True
13252,2012-07-11,3,1,7,8,0,3,1,2,0.68,0.6364,0.79,0.1642,30,499,529,529,True
13253,2012-07-11,3,1,7,9,0,3,1,2,0.7,0.6667,0.74,0.1343,30,298,328,328,True
13254,2012-07-11,3,1,7,10,0,3,1,2,0.72,0.6818,0.62,0.1343,47,148,195,195,True
13255,2012-07-11,3,1,7,11,0,3,1,2,0.76,0.7121,0.58,0.1343,56,173,229,229,True
13256,2012-07-11,3,1,7,12,0,3,1,2,0.78,0.697,0.43,0.0,69,223,292,292,True
13257,2012-07-11,3,1,7,13,0,3,1,2,0.8,0.7121,0.42,0.1642,65,208,273,273,True
13258,2012-07-11,3,1,7,14,0,3,1,1,0.8,0.7121,0.41,0.2239,66,175,241,241,True
13259,2012-07-11,3,1,7,15,0,3,1,1,0.8,0.7121,0.41,0.2537,56,220,276,276,True
13260,2012-07-11,3,1,7,16,0,3,1,1,0.8,0.7121,0.38,0.194,53,358,411,411,True
13261,2012-07-11,3,1,7,17,0,3,1,1,0.8,0.697,0.31,0.2239,90,499,589,589,True
13262,2012-07-11,3,1,7,18,0,3,1,1,0.78,0.6818,0.38,0.2537,79,499,578,578,True
13263,2012-07-11,3,1,7,19,0,3,1,1,0.74,0.6667,0.48,0.2239,73,499,572,572,True
13264,2012-07-11,3,1,7,20,0,3,1,1,0.74,0.6667,0.51,0.1642,73,410,483,483,True
13265,2012-07-11,3,1,7,21,0,3,1,1,0.72,0.6667,0.58,0.2239,69,322,391,391,True
13266,2012-07-11,3,1,7,22,0,3,1,1,0.72,0.6667,0.58,0.2537,41,203,244,244,True
13267,2012-07-11,3,1,7,23,0,3,1,2,0.7,0.6515,0.58,0.2537,20,132,152,152,True
13268,2012-07-12,3,1,7,0,0,4,1,2,0.68,0.6364,0.61,0.0,1,55,56,56,True
13269,2012-07-12,3,1,7,1,0,4,1,2,0.66,0.6212,0.61,0.0,0,21,21,21,True
13270,2012-07-12,3,1,7,2,0,4,1,2,0.66,0.6212,0.65,0.0896,0,9,9,9,True
13271,2012-07-12,3,1,7,3,0,4,1,1,0.64,0.6061,0.69,0.1045,0,10,10,10,True
13272,2012-07-12,3,1,7,4,0,4,1,1,0.64,0.6061,0.73,0.1045,0,5,5,5,True
13273,2012-07-12,3,1,7,5,0,4,1,1,0.62,0.5909,0.73,0.1045,4,40,44,44,True
13274,2012-07-12,3,1,7,6,0,4,1,1,0.64,0.6061,0.73,0.0896,7,171,178,178,True
13275,2012-07-12,3,1,7,7,0,4,1,1,0.64,0.6061,0.73,0.1343,32,480,512,512,True
13276,2012-07-12,3,1,7,8,0,4,1,1,0.68,0.6364,0.65,0.1343,49,499,548,548,True
13277,2012-07-12,3,1,7,9,0,4,1,1,0.72,0.6667,0.58,0.1045,42,285,327,327,True
13278,2012-07-12,3,1,7,10,0,4,1,1,0.74,0.6667,0.48,0.1642,69,145,214,214,True
13279,2012-07-12,3,1,7,11,0,4,1,1,0.76,0.6818,0.45,0.1045,49,166,215,215,True
13280,2012-07-12,3,1,7,12,0,4,1,1,0.78,0.6818,0.35,0.1343,71,221,292,292,True
13281,2012-07-12,3,1,7,13,0,4,1,1,0.8,0.697,0.33,0.2239,52,225,277,277,True
13282,2012-07-12,3,1,7,14,0,4,1,1,0.78,0.6818,0.33,0.2239,42,167,209,209,True
13283,2012-07-12,3,1,7,15,0,4,1,1,0.8,0.7121,0.36,0.194,63,208,271,271,True
13284,2012-07-12,3,1,7,16,0,4,1,1,0.8,0.7121,0.36,0.194,69,370,439,439,True
13285,2012-07-12,3,1,7,17,0,4,1,1,0.76,0.6818,0.43,0.2239,91,499,590,590,True
13286,2012-07-12,3,1,7,18,0,4,1,1,0.76,0.6818,0.45,0.1343,86,499,585,585,True
13287,2012-07-12,3,1,7,19,0,4,1,1,0.74,0.6667,0.48,0.2239,97,499,596,596,True
13288,2012-07-12,3,1,7,20,0,4,1,1,0.74,0.6667,0.48,0.2239,75,439,514,514,True
13289,2012-07-12,3,1,7,21,0,4,1,1,0.72,0.6667,0.48,0.2239,44,329,373,373,True
13290,2012-07-12,3,1,7,22,0,4,1,1,0.72,0.6667,0.51,0.1642,56,262,318,318,True
13291,2012-07-12,3,1,7,23,0,4,1,2,0.7,0.6515,0.51,0.2239,33,178,211,211,True
13292,2012-07-13,3,1,7,0,0,5,1,2,0.7,0.6515,0.54,0.1642,19,76,95,95,True
13293,2012-07-13,3,1,7,1,0,5,1,2,0.68,0.6364,0.54,0.1045,17,42,59,59,True
13294,2012-07-13,3,1,7,2,0,5,1,2,0.66,0.6212,0.61,0.0896,2,15,17,17,True
13295,2012-07-13,3,1,7,3,0,5,1,2,0.68,0.6364,0.61,0.0,2,7,9,9,True
13296,2012-07-13,3,1,7,4,0,5,1,2,0.66,0.6212,0.61,0.0,0,11,11,11,True
13297,2012-07-13,3,1,7,5,0,5,1,2,0.66,0.6364,0.56,0.0896,4,30,34,34,True
13298,2012-07-13,3,1,7,6,0,5,1,2,0.7,0.6515,0.54,0.0,7,120,127,127,True
13299,2012-07-13,3,1,7,7,0,5,1,2,0.7,0.6515,0.54,0.0,27,353,380,380,True
13300,2012-07-13,3,1,7,8,0,5,1,2,0.7,0.6515,0.54,0.0,53,499,552,552,True
13301,2012-07-13,3,1,7,9,0,5,1,2,0.72,0.6667,0.51,0.0,70,344,414,414,True
13302,2012-07-13,3,1,7,10,0,5,1,2,0.74,0.6667,0.48,0.0,78,190,268,268,True
13303,2012-07-13,3,1,7,11,0,5,1,2,0.76,0.6818,0.45,0.1343,68,220,288,288,True
13304,2012-07-13,3,1,7,12,0,5,1,2,0.76,0.6818,0.4,0.1045,114,254,368,368,True
13305,2012-07-13,3,1,7,13,0,5,1,2,0.8,0.7121,0.38,0.1343,100,274,374,374,True
13306,2012-07-13,3,1,7,14,0,5,1,2,0.8,0.7121,0.38,0.0,114,249,363,363,True
13307,2012-07-13,3,1,7,15,0,5,1,2,0.8,0.7121,0.36,0.1045,92,261,353,353,True
13308,2012-07-13,3,1,7,16,0,5,1,2,0.8,0.7121,0.36,0.2239,111,381,492,492,True
13309,2012-07-13,3,1,7,17,0,5,1,2,0.8,0.7121,0.36,0.1642,114,499,613,613,True
13310,2012-07-13,3,1,7,18,0,5,1,1,0.78,0.697,0.46,0.194,108,499,607,607,True
13311,2012-07-13,3,1,7,19,0,5,1,1,0.74,0.6667,0.51,0.1642,103,385,488,488,True
13312,2012-07-13,3,1,7,20,0,5,1,1,0.74,0.6667,0.48,0.1343,95,294,389,389,True
13313,2012-07-13,3,1,7,21,0,5,1,1,0.72,0.6667,0.54,0.0,76,223,299,299,True
13314,2012-07-13,3,1,7,22,0,5,1,1,0.74,0.6667,0.45,0.0,59,204,263,263,True
13315,2012-07-13,3,1,7,23,0,5,1,2,0.72,0.6515,0.45,0.1343,37,175,212,212,True
13316,2012-07-14,3,1,7,0,0,6,0,2,0.72,0.6667,0.48,0.0896,35,156,191,191,True
13317,2012-07-14,3,1,7,1,0,6,0,2,0.7,0.6515,0.51,0.1045,13,105,118,118,True
13318,2012-07-14,3,1,7,2,0,6,0,2,0.7,0.6515,0.54,0.1045,10,91,101,101,True
13319,2012-07-14,3,1,7,3,0,6,0,2,0.7,0.6515,0.54,0.1045,9,31,40,40,True
13320,2012-07-14,3,1,7,4,0,6,0,3,0.66,0.6212,0.61,0.1045,3,6,9,9,True
13321,2012-07-14,3,1,7,5,0,6,0,2,0.64,0.6061,0.73,0.1045,0,5,5,5,True
13322,2012-07-14,3,1,7,6,0,6,0,2,0.64,0.5909,0.78,0.0896,6,29,35,35,True
13323,2012-07-14,3,1,7,7,0,6,0,1,0.64,0.5909,0.78,0.2836,7,41,48,48,True
13324,2012-07-14,3,1,7,8,0,6,0,1,0.62,0.5909,0.78,0.2836,33,118,151,151,True
13325,2012-07-14,3,1,7,9,0,6,0,1,0.66,0.6212,0.74,0.194,82,200,282,282,True
13326,2012-07-14,3,1,7,10,0,6,0,2,0.72,0.6818,0.7,0.0896,114,278,392,392,True
13327,2012-07-14,3,1,7,11,0,6,0,2,0.72,0.6818,0.7,0.1045,114,296,410,410,True
13328,2012-07-14,3,1,7,12,0,6,0,2,0.74,0.697,0.66,0.0896,114,318,432,432,True
13329,2012-07-14,3,1,7,13,0,6,0,2,0.76,0.7121,0.62,0.0896,114,372,486,486,True
13330,2012-07-14,3,1,7,14,0,6,0,1,0.8,0.7576,0.55,0.1045,114,363,477,477,True
13331,2012-07-14,3,1,7,15,0,6,0,1,0.8,0.7576,0.55,0.1642,114,317,431,431,True
13332,2012-07-14,3,1,7,16,0,6,0,2,0.72,0.697,0.79,0.3582,114,340,454,454,True
13333,2012-07-14,3,1,7,17,0,6,0,3,0.7,0.6667,0.79,0.1642,114,259,373,373,True
13334,2012-07-14,3,1,7,18,0,6,0,1,0.72,0.697,0.79,0.1343,108,243,351,351,True
13335,2012-07-14,3,1,7,19,0,6,0,1,0.72,0.7121,0.84,0.0896,114,275,389,389,True
13336,2012-07-14,3,1,7,20,0,6,0,1,0.72,0.7121,0.84,0.0896,101,255,356,356,True
13337,2012-07-14,3,1,7,21,0,6,0,1,0.7,0.6667,0.84,0.2239,69,200,269,269,True
13338,2012-07-14,3,1,7,22,0,6,0,1,0.7,0.6667,0.79,0.194,65,160,225,225,True
13339,2012-07-14,3,1,7,23,0,6,0,2,0.68,0.6364,0.83,0.0896,55,156,211,211,True
13340,2012-07-15,3,1,7,0,0,0,0,1,0.68,0.6364,0.89,0.1642,40,147,187,187,True
13341,2012-07-15,3,1,7,1,0,0,0,2,0.68,0.6364,0.89,0.1343,49,119,168,168,True
13342,2012-07-15,3,1,7,2,0,0,0,2,0.68,0.6364,0.89,0.1642,29,86,115,115,True
13343,2012-07-15,3,1,7,3,0,0,0,2,0.68,0.6364,0.89,0.1642,15,42,57,57,True
13344,2012-07-15,3,1,7,4,0,0,0,2,0.68,0.6364,0.89,0.1045,8,11,19,19,True
13345,2012-07-15,3,1,7,5,0,0,0,1,0.68,0.6364,0.89,0.1343,2,7,9,9,True
13346,2012-07-15,3,1,7,6,0,0,0,1,0.68,0.6364,0.83,0.1343,6,9,15,15,True
13347,2012-07-15,3,1,7,7,0,0,0,1,0.7,0.6667,0.79,0.0896,17,30,47,47,True
13348,2012-07-15,3,1,7,8,0,0,0,2,0.7,0.6667,0.84,0.1343,37,96,133,133,True
13349,2012-07-15,3,1,7,9,0,0,0,2,0.72,0.697,0.79,0.0,58,163,221,221,True
13350,2012-07-15,3,1,7,10,0,0,0,1,0.76,0.7273,0.66,0.1343,114,241,355,355,True
13351,2012-07-15,3,1,7,11,0,0,0,1,0.82,0.7727,0.52,0.1642,114,281,395,395,True
13352,2012-07-15,3,1,7,12,0,0,0,1,0.84,0.7727,0.47,0.1045,114,336,450,450,True
13353,2012-07-15,3,1,7,13,0,0,0,1,0.86,0.7879,0.41,0.1045,114,309,423,423,True
13354,2012-07-15,3,1,7,14,0,0,0,1,0.9,0.8182,0.37,0.2537,114,314,428,428,True
13355,2012-07-15,3,1,7,15,0,0,0,1,0.86,0.803,0.47,0.1343,114,307,421,421,True
13356,2012-07-15,3,1,7,16,0,0,0,1,0.86,0.7879,0.41,0.2239,114,343,457,457,True
13357,2012-07-15,3,1,7,17,0,0,0,1,0.8,0.7727,0.59,0.4775,114,314,428,428,True
13358,2012-07-15,3,1,7,18,0,0,0,3,0.72,0.697,0.79,0.3582,84,228,312,312,True
13359,2012-07-15,3,1,7,19,0,0,0,1,0.72,0.7121,0.84,0.2239,109,203,312,312,True
13360,2012-07-15,3,1,7,20,0,0,0,1,0.72,0.697,0.79,0.2537,95,199,294,294,True
13361,2012-07-15,3,1,7,21,0,0,0,1,0.72,0.697,0.79,0.0896,59,164,223,223,True
13362,2012-07-15,3,1,7,22,0,0,0,1,0.72,0.697,0.74,0.1045,34,96,130,130,True
13363,2012-07-15,3,1,7,23,0,0,0,1,0.72,0.697,0.79,0.1343,25,66,91,91,True
13364,2012-07-16,3,1,7,0,0,1,1,3,0.72,0.697,0.79,0.1045,11,32,43,43,True
13365,2012-07-16,3,1,7,1,0,1,1,2,0.7,0.6667,0.74,0.194,1,10,11,11,True
13366,2012-07-16,3,1,7,2,0,1,1,1,0.7,0.6667,0.74,0.1045,4,11,15,15,True
13367,2012-07-16,3,1,7,3,0,1,1,1,0.68,0.6364,0.79,0.0896,2,4,6,6,True
13368,2012-07-16,3,1,7,4,0,1,1,1,0.68,0.6364,0.79,0.1045,1,11,12,12,True
13369,2012-07-16,3,1,7,5,0,1,1,1,0.66,0.6061,0.78,0.1045,10,40,50,50,True
13370,2012-07-16,3,1,7,6,0,1,1,1,0.68,0.6364,0.79,0.1343,8,132,140,140,True
13371,2012-07-16,3,1,7,7,0,1,1,1,0.72,0.6818,0.7,0.0896,24,459,483,483,True
13372,2012-07-16,3,1,7,8,0,1,1,1,0.74,0.697,0.66,0.1045,48,499,547,547,True
13373,2012-07-16,3,1,7,9,0,1,1,1,0.76,0.7121,0.62,0.1642,51,297,348,348,True
13374,2012-07-16,3,1,7,10,0,1,1,1,0.8,0.7727,0.59,0.0,69,117,186,186,True
13375,2012-07-16,3,1,7,11,0,1,1,1,0.84,0.803,0.53,0.2239,57,125,182,182,True
13376,2012-07-16,3,1,7,12,0,1,1,1,0.84,0.7879,0.49,0.1343,79,158,237,237,True
13377,2012-07-16,3,1,7,13,0,1,1,1,0.84,0.7879,0.49,0.2836,63,176,239,239,True
13378,2012-07-16,3,1,7,14,0,1,1,1,0.88,0.8182,0.42,0.1045,53,159,212,212,True
13379,2012-07-16,3,1,7,15,0,1,1,1,0.86,0.803,0.47,0.2537,61,176,237,237,True
13380,2012-07-16,3,1,7,16,0,1,1,3,0.76,0.7273,0.66,0.4775,77,309,386,386,True
13381,2012-07-16,3,1,7,17,0,1,1,3,0.76,0.7273,0.66,0.4775,86,499,585,585,True
13382,2012-07-16,3,1,7,18,0,1,1,1,0.84,0.803,0.53,0.0,97,499,596,596,True
13383,2012-07-16,3,1,7,19,0,1,1,1,0.8,0.7879,0.63,0.1343,92,499,591,591,True
13384,2012-07-16,3,1,7,20,0,1,1,1,0.8,0.7727,0.59,0.1343,66,388,454,454,True
13385,2012-07-16,3,1,7,21,0,1,1,1,0.76,0.7273,0.66,0.1343,45,283,328,328,True
13386,2012-07-16,3,1,7,22,0,1,1,1,0.76,0.7121,0.62,0.0896,56,228,284,284,True
13387,2012-07-16,3,1,7,23,0,1,1,1,0.74,0.7121,0.74,0.0896,27,139,166,166,True
13388,2012-07-17,3,1,7,0,0,2,1,1,0.72,0.7121,0.84,0.1045,10,43,53,53,True
13389,2012-07-17,3,1,7,1,0,2,1,1,0.74,0.697,0.7,0.0,4,21,25,25,True
13390,2012-07-17,3,1,7,2,0,2,1,1,0.72,0.6818,0.7,0.0896,1,6,7,7,True
13391,2012-07-17,3,1,7,3,0,2,1,1,0.72,0.6818,0.66,0.0,0,3,3,3,True
13392,2012-07-17,3,1,7,4,0,2,1,1,0.72,0.6818,0.62,0.0,0,7,7,7,True
13393,2012-07-17,3,1,7,5,0,2,1,1,0.68,0.6364,0.74,0.0896,7,31,38,38,True
13394,2012-07-17,3,1,7,6,0,2,1,1,0.72,0.6818,0.66,0.1045,16,197,213,213,True
13395,2012-07-17,3,1,7,7,0,2,1,2,0.74,0.697,0.7,0.0,26,499,525,525,True
13396,2012-07-17,3,1,7,8,0,2,1,2,0.8,0.7576,0.55,0.0,43,499,542,542,True
13397,2012-07-17,3,1,7,9,0,2,1,2,0.82,0.7727,0.49,0.2239,32,288,320,320,True
13398,2012-07-17,3,1,7,10,0,2,1,2,0.84,0.7879,0.49,0.194,37,122,159,159,True
13399,2012-07-17,3,1,7,11,0,2,1,2,0.86,0.803,0.47,0.0,60,146,206,206,True
13400,2012-07-17,3,1,7,12,0,2,1,2,0.9,0.8182,0.35,0.0,80,174,254,254,True
13401,2012-07-17,3,1,7,13,0,2,1,1,0.92,0.8182,0.31,0.194,53,168,221,221,True
13402,2012-07-17,3,1,7,14,0,2,1,1,0.94,0.8333,0.29,0.2537,54,160,214,214,True
13403,2012-07-17,3,1,7,15,0,2,1,1,0.92,0.8182,0.31,0.1642,57,187,244,244,True
13404,2012-07-17,3,1,7,16,0,2,1,1,0.92,0.8182,0.29,0.1642,64,317,381,381,True
13405,2012-07-17,3,1,7,17,0,2,1,1,0.92,0.8182,0.29,0.0,95,499,594,594,True
13406,2012-07-17,3,1,7,18,0,2,1,1,0.9,0.803,0.33,0.194,60,499,559,559,True
13407,2012-07-17,3,1,7,19,0,2,1,1,0.88,0.7879,0.35,0.2537,69,478,547,547,True
13408,2012-07-17,3,1,7,20,0,2,1,1,0.86,0.7576,0.34,0.1642,52,375,427,427,True
13409,2012-07-17,3,1,7,21,0,2,1,1,0.82,0.7727,0.52,0.1343,50,283,333,333,True
13410,2012-07-17,3,1,7,22,0,2,1,1,0.8,0.7576,0.55,0.2239,29,215,244,244,True
13411,2012-07-17,3,1,7,23,0,2,1,1,0.78,0.7424,0.59,0.194,22,139,161,161,True
13412,2012-07-18,3,1,7,0,0,3,1,1,0.76,0.7273,0.66,0.1642,8,45,53,53,True
13413,2012-07-18,3,1,7,1,0,3,1,1,0.76,0.7273,0.66,0.1045,2,14,16,16,True
13414,2012-07-18,3,1,7,2,0,3,1,1,0.74,0.697,0.66,0.1343,3,5,8,8,True
13415,2012-07-18,3,1,7,3,0,3,1,1,0.74,0.697,0.66,0.1343,2,2,4,4,True
13416,2012-07-18,3,1,7,4,0,3,1,1,0.72,0.6818,0.7,0.1343,0,6,6,6,True
13417,2012-07-18,3,1,7,5,0,3,1,1,0.72,0.6818,0.7,0.1642,5,41,46,46,True
13418,2012-07-18,3,1,7,6,0,3,1,1,0.72,0.6818,0.7,0.1642,10,152,162,162,True
13419,2012-07-18,3,1,7,7,0,3,1,1,0.74,0.697,0.66,0.1642,23,472,495,495,True
13420,2012-07-18,3,1,7,8,0,3,1,1,0.78,0.7424,0.62,0.1045,55,499,554,554,True
13421,2012-07-18,3,1,7,9,0,3,1,1,0.82,0.7879,0.56,0.0,44,253,297,297,True
13422,2012-07-18,3,1,7,10,0,3,1,1,0.9,0.8485,0.42,0.194,39,99,138,138,True
13423,2012-07-18,3,1,7,11,0,3,1,1,0.9,0.8485,0.42,0.0,47,136,183,183,True
13424,2012-07-18,3,1,7,12,0,3,1,1,0.92,0.8636,0.37,0.1343,36,166,202,202,True
13425,2012-07-18,3,1,7,13,0,3,1,1,0.94,0.8485,0.33,0.0,49,154,203,203,True
13426,2012-07-18,3,1,7,14,0,3,1,1,0.94,0.8788,0.38,0.3284,54,116,170,170,True
13427,2012-07-18,3,1,7,15,0,3,1,3,0.92,0.8485,0.35,0.3582,42,152,194,194,True
13428,2012-07-18,3,1,7,16,0,3,1,1,0.74,0.697,0.66,0.2537,34,190,224,224,True
13429,2012-07-18,3,1,7,17,0,3,1,1,0.74,0.697,0.7,0.2537,35,335,370,370,True
13430,2012-07-18,3,1,7,18,0,3,1,2,0.76,0.7121,0.62,0.1343,63,499,562,562,True
13431,2012-07-18,3,1,7,19,0,3,1,2,0.76,0.7121,0.62,0.1045,78,438,516,516,True
13432,2012-07-18,3,1,7,20,0,3,1,1,0.74,0.6818,0.62,0.0896,56,310,366,366,True
13433,2012-07-18,3,1,7,21,0,3,1,1,0.76,0.7121,0.62,0.0,53,266,319,319,True
13434,2012-07-18,3,1,7,22,0,3,1,1,0.76,0.7121,0.58,0.0896,42,246,288,288,True
13435,2012-07-18,3,1,7,23,0,3,1,1,0.76,0.7121,0.58,0.0896,19,112,131,131,True
13436,2012-07-19,3,1,7,0,0,4,1,1,0.74,0.697,0.66,0.0896,16,50,66,66,True
13437,2012-07-19,3,1,7,1,0,4,1,1,0.74,0.697,0.66,0.0896,6,19,25,25,True
13438,2012-07-19,3,1,7,2,0,4,1,1,0.72,0.6818,0.7,0.194,0,7,7,7,True
13439,2012-07-19,3,1,7,3,0,4,1,1,0.72,0.6818,0.7,0.1045,1,4,5,5,True
13440,2012-07-19,3,1,7,4,0,4,1,1,0.72,0.6818,0.7,0.1045,0,8,8,8,True
13441,2012-07-19,3,1,7,5,0,4,1,2,0.72,0.6818,0.7,0.1045,5,35,40,40,True
13442,2012-07-19,3,1,7,6,0,4,1,1,0.72,0.6818,0.66,0.1343,8,144,152,152,True
13443,2012-07-19,3,1,7,7,0,4,1,1,0.74,0.6818,0.58,0.2836,23,450,473,473,True
13444,2012-07-19,3,1,7,8,0,4,1,1,0.76,0.7121,0.58,0.2537,32,499,531,531,True
13445,2012-07-19,3,1,7,9,0,4,1,2,0.76,0.7121,0.58,0.2836,36,282,318,318,True
13446,2012-07-19,3,1,7,10,0,4,1,1,0.76,0.7121,0.58,0.194,41,157,198,198,True
13447,2012-07-19,3,1,7,11,0,4,1,1,0.8,0.7576,0.55,0.1045,54,162,216,216,True
13448,2012-07-19,3,1,7,12,0,4,1,1,0.84,0.7879,0.49,0.2836,59,215,274,274,True
13449,2012-07-19,3,1,7,13,0,4,1,1,0.84,0.7727,0.47,0.1343,74,180,254,254,True
13450,2012-07-19,3,1,7,14,0,4,1,1,0.86,0.7879,0.44,0.0896,46,151,197,197,True
13451,2012-07-19,3,1,7,15,0,4,1,1,0.84,0.7727,0.47,0.0896,66,226,292,292,True
13452,2012-07-19,3,1,7,16,0,4,1,1,0.84,0.7727,0.47,0.0896,70,288,358,358,True
13453,2012-07-19,3,1,7,17,0,4,1,1,0.86,0.7879,0.41,0.0,93,499,592,592,True
13454,2012-07-19,3,1,7,18,0,4,1,1,0.86,0.7879,0.41,0.194,93,499,592,592,True
13455,2012-07-19,3,1,7,19,0,4,1,1,0.84,0.7576,0.44,0.2537,53,480,533,533,True
13456,2012-07-19,3,1,7,20,0,4,1,1,0.82,0.7727,0.49,0.1642,65,440,505,505,True
13457,2012-07-19,3,1,7,21,0,4,1,3,0.66,0.5909,0.89,0.2537,38,294,332,332,True
13458,2012-07-19,3,1,7,22,0,4,1,3,0.66,0.5909,0.89,0.2537,6,62,68,68,True
13459,2012-07-19,3,1,7,23,0,4,1,3,0.66,0.5909,0.89,0.2239,3,62,65,65,True
13460,2012-07-20,3,1,7,0,0,5,1,3,0.66,0.5909,0.89,0.0896,2,32,34,34,True
13461,2012-07-20,3,1,7,1,0,5,1,1,0.66,0.5909,0.89,0.1343,2,9,11,11,True
13462,2012-07-20,3,1,7,2,0,5,1,2,0.66,0.5909,0.89,0.0896,5,14,19,19,True
13463,2012-07-20,3,1,7,3,0,5,1,2,0.66,0.5909,0.89,0.1045,7,29,36,36,True
13464,2012-07-20,3,1,7,4,0,5,1,2,0.66,0.5909,0.89,0.1642,3,6,9,9,True
13465,2012-07-20,3,1,7,5,0,5,1,2,0.66,0.5909,0.89,0.1343,2,40,42,42,True
13466,2012-07-20,3,1,7,6,0,5,1,2,0.66,0.5909,0.89,0.1642,3,123,126,126,True
13467,2012-07-20,3,1,7,7,0,5,1,2,0.66,0.5909,0.89,0.194,14,346,360,360,True
13468,2012-07-20,3,1,7,8,0,5,1,2,0.68,0.6364,0.83,0.1642,39,499,538,538,True
13469,2012-07-20,3,1,7,9,0,5,1,2,0.7,0.6667,0.79,0.1343,45,328,373,373,True
13470,2012-07-20,3,1,7,10,0,5,1,2,0.7,0.6667,0.79,0.1642,51,182,233,233,True
13471,2012-07-20,3,1,7,11,0,5,1,3,0.72,0.697,0.74,0.194,51,161,212,212,True
13472,2012-07-20,3,1,7,12,0,5,1,3,0.68,0.6364,0.83,0.1642,41,233,274,274,True
13473,2012-07-20,3,1,7,13,0,5,1,3,0.68,0.6364,0.83,0.1045,20,136,156,156,True
13474,2012-07-20,3,1,7,14,0,5,1,3,0.7,0.6667,0.84,0.1642,53,176,229,229,True
13475,2012-07-20,3,1,7,15,0,5,1,2,0.7,0.6667,0.84,0.2985,47,169,216,216,True
13476,2012-07-20,3,1,7,16,0,5,1,2,0.68,0.6364,0.83,0.3284,70,366,436,436,True
13477,2012-07-20,3,1,7,17,0,5,1,2,0.66,0.5909,0.89,0.4179,95,499,594,594,True
13478,2012-07-20,3,1,7,18,0,5,1,2,0.66,0.6061,0.78,0.3284,73,499,572,572,True
13479,2012-07-20,3,1,7,19,0,5,1,2,0.64,0.5758,0.83,0.2836,44,358,402,402,True
13480,2012-07-20,3,1,7,20,0,5,1,3,0.64,0.5758,0.83,0.3881,35,216,251,251,True
13481,2012-07-20,3,1,7,21,0,5,1,3,0.62,0.5758,0.83,0.3284,14,108,122,122,True
13482,2012-07-20,3,1,7,22,0,5,1,2,0.62,0.5758,0.83,0.194,13,122,135,135,True
13483,2012-07-20,3,1,7,23,0,5,1,2,0.62,0.5758,0.83,0.2836,18,148,166,166,True
13484,2012-07-21,3,1,7,0,0,6,0,3,0.62,0.5758,0.83,0.2836,11,92,103,103,True
13485,2012-07-21,3,1,7,1,0,6,0,2,0.62,0.5758,0.83,0.2537,10,62,72,72,True
13486,2012-07-21,3,1,7,2,0,6,0,3,0.6,0.5455,0.88,0.2836,5,55,60,60,True
13487,2012-07-21,3,1,7,3,0,6,0,3,0.6,0.5455,0.88,0.2537,7,18,25,25,True
13488,2012-07-21,3,1,7,4,0,6,0,3,0.58,0.5455,0.88,0.2836,11,5,16,16,True
13489,2012-07-21,3,1,7,5,0,6,0,3,0.58,0.5455,0.88,0.2537,7,10,17,17,True
13490,2012-07-21,3,1,7,6,0,6,0,3,0.58,0.5455,0.88,0.2537,3,12,15,15,True
13491,2012-07-21,3,1,7,7,0,6,0,2,0.58,0.5455,0.88,0.2537,8,29,37,37,True
13492,2012-07-21,3,1,7,8,0,6,0,2,0.58,0.5455,0.83,0.2537,18,94,112,112,True
13493,2012-07-21,3,1,7,9,0,6,0,2,0.58,0.5455,0.83,0.194,32,175,207,207,True
13494,2012-07-21,3,1,7,10,0,6,0,3,0.58,0.5455,0.88,0.2537,49,219,268,268,True
13495,2012-07-21,3,1,7,11,0,6,0,2,0.6,0.5606,0.83,0.2537,80,225,305,305,True
13496,2012-07-21,3,1,7,12,0,6,0,3,0.6,0.5606,0.83,0.2239,114,301,415,415,True
13497,2012-07-21,3,1,7,13,0,6,0,3,0.6,0.5606,0.83,0.1642,106,248,354,354,True
13498,2012-07-21,3,1,7,14,0,6,0,2,0.6,0.5455,0.88,0.2537,114,222,336,336,True
13499,2012-07-21,3,1,7,15,0,6,0,3,0.6,0.5455,0.88,0.2537,114,232,346,346,True
13500,2012-07-21,3,1,7,16,0,6,0,3,0.6,0.5455,0.88,0.194,114,196,310,310,True
13501,2012-07-21,3,1,7,17,0,6,0,3,0.6,0.5455,0.88,0.1642,92,149,241,241,True
13502,2012-07-21,3,1,7,18,0,6,0,2,0.6,0.5455,0.88,0.194,51,126,177,177,True
13503,2012-07-21,3,1,7,19,0,6,0,2,0.6,0.5455,0.88,0.1642,67,171,238,238,True
13504,2012-07-21,3,1,7,20,0,6,0,3,0.6,0.5455,0.88,0.1642,51,163,214,214,True
13505,2012-07-21,3,1,7,21,0,6,0,2,0.6,0.5455,0.88,0.1642,29,134,163,163,True
13506,2012-07-21,3,1,7,22,0,6,0,2,0.6,0.5455,0.88,0.1045,40,140,180,180,True
13507,2012-07-21,3,1,7,23,0,6,0,2,0.6,0.5455,0.88,0.0,32,117,149,149,True
13508,2012-07-22,3,1,7,0,0,0,0,2,0.6,0.5455,0.88,0.1045,17,96,113,113,True
13509,2012-07-22,3,1,7,1,0,0,0,2,0.6,0.5455,0.88,0.1642,31,99,130,130,True
13510,2012-07-22,3,1,7,2,0,0,0,2,0.6,0.5455,0.88,0.1045,32,90,122,122,True
13511,2012-07-22,3,1,7,3,0,0,0,2,0.6,0.5455,0.88,0.1045,13,30,43,43,True
13512,2012-07-22,3,1,7,4,0,0,0,1,0.6,0.5455,0.88,0.0,6,10,16,16,True
13513,2012-07-22,3,1,7,5,0,0,0,1,0.6,0.5455,0.88,0.0,0,6,6,6,True
13514,2012-07-22,3,1,7,6,0,0,0,2,0.62,0.5758,0.83,0.0896,5,14,19,19,True
13515,2012-07-22,3,1,7,7,0,0,0,2,0.62,0.5758,0.83,0.0,13,25,38,38,True
13516,2012-07-22,3,1,7,8,0,0,0,2,0.64,0.5909,0.78,0.0,31,122,153,153,True
13517,2012-07-22,3,1,7,9,0,0,0,2,0.66,0.6212,0.69,0.0,79,179,258,258,True
13518,2012-07-22,3,1,7,10,0,0,0,2,0.66,0.6212,0.74,0.0,114,265,379,379,True
13519,2012-07-22,3,1,7,11,0,0,0,2,0.66,0.6212,0.74,0.0,114,314,428,428,True
13520,2012-07-22,3,1,7,12,0,0,0,2,0.7,0.6515,0.7,0.1045,114,326,440,440,True
13521,2012-07-22,3,1,7,13,0,0,0,2,0.7,0.6515,0.65,0.0896,114,388,502,502,True
13522,2012-07-22,3,1,7,14,0,0,0,1,0.72,0.6818,0.66,0.1045,114,360,474,474,True
13523,2012-07-22,3,1,7,15,0,0,0,1,0.72,0.6818,0.66,0.1045,114,370,484,484,True
13524,2012-07-22,3,1,7,16,0,0,0,1,0.74,0.697,0.66,0.1045,114,383,497,497,True
13525,2012-07-22,3,1,7,17,0,0,0,1,0.74,0.697,0.66,0.2239,114,368,482,482,True
13526,2012-07-22,3,1,7,18,0,0,0,1,0.74,0.697,0.66,0.1642,114,342,456,456,True
13527,2012-07-22,3,1,7,19,0,0,0,1,0.72,0.6818,0.7,0.1642,114,342,456,456,True
13528,2012-07-22,3,1,7,20,0,0,0,1,0.7,0.6667,0.74,0.1642,114,254,368,368,True
13529,2012-07-22,3,1,7,21,0,0,0,1,0.7,0.6667,0.79,0.1045,88,257,345,345,True
13530,2012-07-22,3,1,7,22,0,0,0,1,0.7,0.6667,0.74,0.194,55,136,191,191,True
13531,2012-07-22,3,1,7,23,0,0,0,1,0.68,0.6364,0.79,0.1642,33,90,123,123,True
13532,2012-07-23,3,1,7,0,0,1,1,1,0.66,0.5909,0.89,0.0896,11,36,47,47,True
13533,2012-07-23,3,1,7,1,0,1,1,1,0.66,0.5909,0.89,0.194,7,20,27,27,True
13534,2012-07-23,3,1,7,2,0,1,1,2,0.66,0.5909,0.94,0.0896,3,14,17,17,True
13535,2012-07-23,3,1,7,3,0,1,1,2,0.66,0.5909,0.94,0.0896,0,2,2,2,True
13536,2012-07-23,3,1,7,4,0,1,1,2,0.66,0.5909,0.94,0.1343,0,8,8,8,True
13537,2012-07-23,3,1,7,5,0,1,1,2,0.66,0.5909,0.94,0.1343,3,48,51,51,True
13538,2012-07-23,3,1,7,6,0,1,1,2,0.68,0.6364,0.89,0.0896,9,148,157,157,True
13539,2012-07-23,3,1,7,7,0,1,1,1,0.7,0.6667,0.84,0.1343,17,404,421,421,True
13540,2012-07-23,3,1,7,8,0,1,1,1,0.72,0.697,0.79,0.1045,47,499,546,546,True
13541,2012-07-23,3,1,7,9,0,1,1,2,0.74,0.7121,0.74,0.1343,57,288,345,345,True
13542,2012-07-23,3,1,7,10,0,1,1,2,0.78,0.7424,0.62,0.0,63,137,200,200,True
13543,2012-07-23,3,1,7,11,0,1,1,2,0.8,0.7424,0.52,0.1642,69,129,198,198,True
13544,2012-07-23,3,1,7,12,0,1,1,2,0.8,0.7424,0.52,0.1642,109,205,314,314,True
13545,2012-07-23,3,1,7,13,0,1,1,2,0.8,0.7424,0.52,0.1045,64,176,240,240,True
13546,2012-07-23,3,1,7,14,0,1,1,2,0.78,0.7424,0.59,0.1642,82,189,271,271,True
13547,2012-07-23,3,1,7,15,0,1,1,1,0.8,0.7576,0.55,0.194,76,205,281,281,True
13548,2012-07-23,3,1,7,16,0,1,1,1,0.82,0.7727,0.52,0.1343,111,346,457,457,True
13549,2012-07-23,3,1,7,17,0,1,1,1,0.82,0.7727,0.52,0.1343,87,499,586,586,True
13550,2012-07-23,3,1,7,18,0,1,1,1,0.82,0.7576,0.46,0.1045,69,499,568,568,True
13551,2012-07-23,3,1,7,19,0,1,1,1,0.8,0.7424,0.52,0.2537,94,488,582,582,True
13552,2012-07-23,3,1,7,20,0,1,1,1,0.76,0.7121,0.62,0.1642,56,347,403,403,True
13553,2012-07-23,3,1,7,21,0,1,1,1,0.76,0.7121,0.62,0.194,45,251,296,296,True
13554,2012-07-23,3,1,7,22,0,1,1,1,0.74,0.6818,0.62,0.194,40,169,209,209,True
13555,2012-07-23,3,1,7,23,0,1,1,1,0.72,0.6818,0.66,0.1642,16,98,114,114,True
13556,2012-07-24,3,1,7,0,0,2,1,1,0.7,0.6667,0.74,0.1343,12,52,64,64,True
13557,2012-07-24,3,1,7,1,0,2,1,1,0.68,0.6364,0.79,0.1642,7,10,17,17,True
13558,2012-07-24,3,1,7,2,0,2,1,1,0.66,0.6061,0.83,0.1642,6,10,16,16,True
13559,2012-07-24,3,1,7,3,0,2,1,1,0.66,0.6061,0.83,0.1642,1,5,6,6,True
13560,2012-07-24,3,1,7,4,0,2,1,1,0.66,0.6061,0.83,0.0896,0,6,6,6,True
13561,2012-07-24,3,1,7,5,0,2,1,1,0.66,0.6061,0.83,0.1045,5,45,50,50,True
13562,2012-07-24,3,1,7,6,0,2,1,1,0.66,0.6061,0.83,0.1343,17,173,190,190,True
13563,2012-07-24,3,1,7,7,0,2,1,1,0.7,0.6667,0.74,0.1642,24,492,516,516,True
13564,2012-07-24,3,1,7,8,0,2,1,1,0.74,0.697,0.7,0.194,49,499,548,548,True
13565,2012-07-24,3,1,7,9,0,2,1,1,0.84,0.803,0.53,0.0,40,299,339,339,True
13566,2012-07-24,3,1,7,10,0,2,1,1,0.82,0.7879,0.56,0.2985,62,156,218,218,True
13567,2012-07-24,3,1,7,11,0,2,1,2,0.84,0.803,0.53,0.3284,45,156,201,201,True
13568,2012-07-24,3,1,7,12,0,2,1,2,0.82,0.7879,0.56,0.2239,60,169,229,229,True
13569,2012-07-24,3,1,7,13,0,2,1,2,0.84,0.803,0.53,0.2985,73,200,273,273,True
13570,2012-07-24,3,1,7,14,0,2,1,2,0.84,0.803,0.53,0.2239,48,196,244,244,True
13571,2012-07-24,3,1,7,15,0,2,1,1,0.82,0.7727,0.49,0.2985,73,212,285,285,True
13572,2012-07-24,3,1,7,16,0,2,1,1,0.8,0.7576,0.55,0.2985,86,369,455,455,True
13573,2012-07-24,3,1,7,17,0,2,1,1,0.8,0.7424,0.52,0.3284,94,499,593,593,True
13574,2012-07-24,3,1,7,18,0,2,1,1,0.76,0.7121,0.62,0.3284,110,499,609,609,True
13575,2012-07-24,3,1,7,19,0,2,1,1,0.76,0.7121,0.62,0.1642,109,499,608,608,True
13576,2012-07-24,3,1,7,20,0,2,1,1,0.74,0.697,0.66,0.1642,85,438,523,523,True
13577,2012-07-24,3,1,7,21,0,2,1,1,0.74,0.697,0.66,0.2239,53,325,378,378,True
13578,2012-07-24,3,1,7,22,0,2,1,1,0.74,0.697,0.66,0.2537,43,226,269,269,True
13579,2012-07-24,3,1,7,23,0,2,1,1,0.74,0.6818,0.58,0.3284,38,154,192,192,True
13580,2012-07-25,3,1,7,0,0,3,1,1,0.72,0.6667,0.58,0.2985,9,57,66,66,True
13581,2012-07-25,3,1,7,1,0,3,1,1,0.7,0.6515,0.58,0.194,2,26,28,28,True
13582,2012-07-25,3,1,7,2,0,3,1,1,0.68,0.6364,0.61,0.2239,1,11,12,12,True
13583,2012-07-25,3,1,7,3,0,3,1,1,0.66,0.6212,0.65,0.2239,1,11,12,12,True
13584,2012-07-25,3,1,7,4,0,3,1,1,0.64,0.6061,0.65,0.2239,0,4,4,4,True
13585,2012-07-25,3,1,7,5,0,3,1,1,0.64,0.6061,0.65,0.1642,5,54,59,59,True
13586,2012-07-25,3,1,7,6,0,3,1,1,0.64,0.6061,0.65,0.194,11,179,190,190,True
13587,2012-07-25,3,1,7,7,0,3,1,1,0.66,0.6212,0.5,0.3284,34,473,507,507,True
13588,2012-07-25,3,1,7,8,0,3,1,1,0.7,0.6364,0.42,0.2537,43,499,542,542,True
13589,2012-07-25,3,1,7,9,0,3,1,1,0.72,0.6515,0.37,0.2985,65,277,342,342,True
13590,2012-07-25,3,1,7,10,0,3,1,1,0.74,0.6515,0.37,0.0,68,163,231,231,True
13591,2012-07-25,3,1,7,11,0,3,1,1,0.76,0.6667,0.33,0.0,79,202,281,281,True
13592,2012-07-25,3,1,7,12,0,3,1,1,0.76,0.6667,0.33,0.0,77,233,310,310,True
13593,2012-07-25,3,1,7,13,0,3,1,1,0.78,0.6818,0.31,0.1642,81,231,312,312,True
13594,2012-07-25,3,1,7,14,0,3,1,1,0.8,0.697,0.29,0.1343,88,159,247,247,True
13595,2012-07-25,3,1,7,15,0,3,1,1,0.78,0.6818,0.31,0.0896,94,223,317,317,True
13596,2012-07-25,3,1,7,16,0,3,1,1,0.8,0.697,0.29,0.1642,91,393,484,484,True
13597,2012-07-25,3,1,7,17,0,3,1,1,0.8,0.697,0.31,0.0,114,499,613,613,True
13598,2012-07-25,3,1,7,18,0,3,1,1,0.8,0.697,0.27,0.1343,104,499,603,603,True
13599,2012-07-25,3,1,7,19,0,3,1,1,0.76,0.6667,0.33,0.1343,114,499,613,613,True
13600,2012-07-25,3,1,7,20,0,3,1,1,0.74,0.6515,0.4,0.1642,106,461,567,567,True
13601,2012-07-25,3,1,7,21,0,3,1,1,0.72,0.6515,0.45,0.1343,71,326,397,397,True
13602,2012-07-25,3,1,7,22,0,3,1,1,0.7,0.6515,0.58,0.1343,55,223,278,278,True
13603,2012-07-25,3,1,7,23,0,3,1,1,0.68,0.6364,0.57,0.2985,52,187,239,239,True
13604,2012-07-26,3,1,7,0,0,4,1,1,0.66,0.6212,0.65,0.194,27,65,92,92,True
13605,2012-07-26,3,1,7,1,0,4,1,1,0.66,0.6212,0.65,0.2239,6,23,29,29,True
13606,2012-07-26,3,1,7,2,0,4,1,1,0.66,0.6212,0.69,0.2537,5,16,21,21,True
13607,2012-07-26,3,1,7,3,0,4,1,1,0.66,0.6212,0.69,0.2239,0,8,8,8,True
13608,2012-07-26,3,1,7,4,0,4,1,1,0.66,0.6212,0.74,0.194,0,4,4,4,True
13609,2012-07-26,3,1,7,5,0,4,1,1,0.66,0.6212,0.74,0.194,2,40,42,42,True
13610,2012-07-26,3,1,7,6,0,4,1,1,0.66,0.6061,0.78,0.2537,16,165,181,181,True
13611,2012-07-26,3,1,7,7,0,4,1,1,0.7,0.6667,0.74,0.2537,17,478,495,495,True
13612,2012-07-26,3,1,7,8,0,4,1,2,0.7,0.6667,0.74,0.2537,49,499,548,548,True
13613,2012-07-26,3,1,7,9,0,4,1,2,0.72,0.6818,0.7,0.1343,55,289,344,344,True
13614,2012-07-26,3,1,7,10,0,4,1,1,0.74,0.697,0.7,0.2239,79,143,222,222,True
13615,2012-07-26,3,1,7,11,0,4,1,1,0.8,0.803,0.66,0.2239,69,143,212,212,True
13616,2012-07-26,3,1,7,12,0,4,1,1,0.84,0.8182,0.56,0.2537,73,206,279,279,True
13617,2012-07-26,3,1,7,13,0,4,1,1,0.86,0.8333,0.53,0.2985,53,189,242,242,True
13618,2012-07-26,3,1,7,14,0,4,1,1,0.9,0.8788,0.47,0.2537,62,151,213,213,True
13619,2012-07-26,3,1,7,15,0,4,1,1,0.92,0.8939,0.42,0.2985,65,173,238,238,True
13620,2012-07-26,3,1,7,16,0,4,1,1,0.94,0.8788,0.38,0.3881,62,312,374,374,True
13621,2012-07-26,3,1,7,17,0,4,1,1,0.9,0.8636,0.45,0.4179,110,499,609,609,True
13622,2012-07-26,3,1,7,18,0,4,1,1,0.92,0.8788,0.4,0.3582,73,499,572,572,True
13623,2012-07-26,3,1,7,19,0,4,1,1,0.9,0.8636,0.45,0.3284,80,499,579,579,True
13624,2012-07-26,3,1,7,20,0,4,1,1,0.86,0.8182,0.5,0.2537,47,399,446,446,True
13625,2012-07-26,3,1,7,21,0,4,1,1,0.8,0.7424,0.49,0.4775,35,236,271,271,True
13626,2012-07-26,3,1,7,22,0,4,1,1,0.8,0.7424,0.49,0.4775,33,201,234,234,True
13627,2012-07-26,3,1,7,23,0,4,1,1,0.72,0.6818,0.7,0.1343,18,127,145,145,True
13628,2012-07-27,3,1,7,0,0,5,1,1,0.72,0.6818,0.7,0.0,14,83,97,97,True
13629,2012-07-27,3,1,7,1,0,5,1,1,0.72,0.6818,0.7,0.1045,12,42,54,54,True
13630,2012-07-27,3,1,7,2,0,5,1,1,0.7,0.6667,0.79,0.1343,8,18,26,26,True
13631,2012-07-27,3,1,7,3,0,5,1,1,0.7,0.6667,0.74,0.1642,3,9,12,12,True
13632,2012-07-27,3,1,7,4,0,5,1,1,0.7,0.6667,0.79,0.0,3,5,8,8,True
13633,2012-07-27,3,1,7,5,0,5,1,1,0.7,0.6667,0.84,0.0,3,34,37,37,True
13634,2012-07-27,3,1,7,6,0,5,1,1,0.7,0.6667,0.79,0.0,10,129,139,139,True
13635,2012-07-27,3,1,7,7,0,5,1,1,0.72,0.6818,0.7,0.194,13,397,410,410,True
13636,2012-07-27,3,1,7,8,0,5,1,1,0.76,0.7273,0.66,0.0896,34,499,533,533,True
13637,2012-07-27,3,1,7,9,0,5,1,1,0.82,0.7727,0.49,0.2836,34,329,363,363,True
13638,2012-07-27,3,1,7,10,0,5,1,1,0.84,0.7727,0.47,0.0,85,146,231,231,True
13639,2012-07-27,3,1,7,11,0,5,1,1,0.84,0.7727,0.47,0.3284,67,184,251,251,True
13640,2012-07-27,3,1,7,12,0,5,1,1,0.84,0.7879,0.49,0.3582,92,207,299,299,True
13641,2012-07-27,3,1,7,13,0,5,1,1,0.84,0.7727,0.47,0.2836,83,231,314,314,True
13642,2012-07-27,3,1,7,14,0,5,1,1,0.86,0.803,0.47,0.2985,105,221,326,326,True
13643,2012-07-27,3,1,7,15,0,5,1,1,0.86,0.7879,0.41,0.2239,81,242,323,323,True
13644,2012-07-27,3,1,7,16,0,5,1,1,0.84,0.7727,0.47,0.2239,80,419,499,499,True
13645,2012-07-27,3,1,7,17,0,5,1,1,0.86,0.7879,0.41,0.2836,101,499,600,600,True
13646,2012-07-27,3,1,7,18,0,5,1,1,0.82,0.7576,0.46,0.1642,100,499,599,599,True
13647,2012-07-27,3,1,7,19,0,5,1,1,0.82,0.7727,0.52,0.194,93,423,516,516,True
13648,2012-07-27,3,1,7,20,0,5,1,1,0.78,0.7424,0.59,0.1045,85,269,354,354,True
13649,2012-07-27,3,1,7,21,0,5,1,1,0.78,0.7424,0.59,0.1045,71,189,260,260,True
13650,2012-07-27,3,1,7,22,0,5,1,1,0.78,0.7424,0.59,0.1343,48,151,199,199,True
13651,2012-07-27,3,1,7,23,0,5,1,1,0.76,0.7273,0.66,0.0,34,155,189,189,True
13652,2012-07-28,3,1,7,0,0,6,0,1,0.74,0.6818,0.62,0.1343,21,170,191,191,True
13653,2012-07-28,3,1,7,1,0,6,0,1,0.72,0.6818,0.7,0.0896,11,69,80,80,True
13654,2012-07-28,3,1,7,2,0,6,0,1,0.72,0.6818,0.7,0.0,14,76,90,90,True
13655,2012-07-28,3,1,7,3,0,6,0,1,0.72,0.6818,0.7,0.0,10,33,43,43,True
13656,2012-07-28,3,1,7,4,0,6,0,1,0.7,0.6667,0.79,0.194,1,10,11,11,True
13657,2012-07-28,3,1,7,5,0,6,0,1,0.68,0.6364,0.79,0.1642,4,10,14,14,True
13658,2012-07-28,3,1,7,6,0,6,0,1,0.7,0.6515,0.7,0.1045,10,40,50,50,True
13659,2012-07-28,3,1,7,7,0,6,0,1,0.72,0.6818,0.7,0.1343,18,58,76,76,True
13660,2012-07-28,3,1,7,8,0,6,0,1,0.74,0.697,0.66,0.1642,36,127,163,163,True
13661,2012-07-28,3,1,7,9,0,6,0,1,0.78,0.7424,0.59,0.1045,110,227,337,337,True
13662,2012-07-28,3,1,7,10,0,6,0,1,0.82,0.7727,0.52,0.2239,114,266,380,380,True
13663,2012-07-28,3,1,7,11,0,6,0,1,0.84,0.7424,0.39,0.2239,114,295,409,409,True
13664,2012-07-28,3,1,7,12,0,6,0,1,0.84,0.7576,0.41,0.2239,114,330,444,444,True
13665,2012-07-28,3,1,7,13,0,6,0,1,0.86,0.7879,0.41,0.2836,114,325,439,439,True
13666,2012-07-28,3,1,7,14,0,6,0,1,0.86,0.7727,0.39,0.2537,114,308,422,422,True
13667,2012-07-28,3,1,7,15,0,6,0,1,0.88,0.7727,0.32,0.2836,114,291,405,405,True
13668,2012-07-28,3,1,7,16,0,6,0,1,0.86,0.7727,0.39,0.2239,114,279,393,393,True
13669,2012-07-28,3,1,7,17,0,6,0,1,0.82,0.7576,0.46,0.194,114,280,394,394,True
13670,2012-07-28,3,1,7,18,0,6,0,1,0.82,0.7424,0.43,0.2836,114,330,444,444,True
13671,2012-07-28,3,1,7,19,0,6,0,1,0.68,0.6364,0.83,0.0,114,223,337,337,True
13672,2012-07-28,3,1,7,20,0,6,0,1,0.66,0.6061,0.83,0.2239,79,154,233,233,True
13673,2012-07-28,3,1,7,21,0,6,0,1,0.66,0.6061,0.78,0.0896,94,206,300,300,True
13674,2012-07-28,3,1,7,22,0,6,0,1,0.66,0.6061,0.78,0.0896,88,188,276,276,True
13675,2012-07-28,3,1,7,23,0,6,0,1,0.66,0.6061,0.83,0.0896,52,156,208,208,True
13676,2012-07-29,3,1,7,0,0,0,0,1,0.66,0.5909,0.89,0.1343,59,129,188,188,True
13677,2012-07-29,3,1,7,1,0,0,0,1,0.66,0.6061,0.83,0.1045,49,109,158,158,True
13678,2012-07-29,3,1,7,2,0,0,0,1,0.66,0.6212,0.74,0.1343,33,79,112,112,True
13679,2012-07-29,3,1,7,3,0,0,0,1,0.66,0.6212,0.69,0.2239,18,37,55,55,True
13680,2012-07-29,3,1,7,4,0,0,0,1,0.64,0.6061,0.69,0.194,2,11,13,13,True
13681,2012-07-29,3,1,7,5,0,0,0,1,0.62,0.5909,0.78,0.194,3,14,17,17,True
13682,2012-07-29,3,1,7,6,0,0,0,1,0.64,0.6061,0.73,0.1642,6,12,18,18,True
13683,2012-07-29,3,1,7,7,0,0,0,1,0.66,0.6212,0.69,0.2537,4,36,40,40,True
13684,2012-07-29,3,1,7,8,0,0,0,1,0.7,0.6515,0.65,0.2239,37,90,127,127,True
13685,2012-07-29,3,1,7,9,0,0,0,1,0.72,0.6818,0.62,0.2537,64,162,226,226,True
13686,2012-07-29,3,1,7,10,0,0,0,1,0.74,0.6818,0.62,0.0,114,258,372,372,True
13687,2012-07-29,3,1,7,11,0,0,0,1,0.76,0.697,0.55,0.2239,114,326,440,440,True
13688,2012-07-29,3,1,7,12,0,0,0,1,0.76,0.697,0.55,0.3284,114,357,471,471,True
13689,2012-07-29,3,1,7,13,0,0,0,1,0.8,0.7424,0.49,0.2239,114,302,416,416,True
13690,2012-07-29,3,1,7,14,0,0,0,1,0.8,0.7273,0.46,0.194,114,291,405,405,True
13691,2012-07-29,3,1,7,15,0,0,0,1,0.8,0.7273,0.43,0.1343,114,306,420,420,True
13692,2012-07-29,3,1,7,16,0,0,0,1,0.8,0.7273,0.43,0.1343,114,330,444,444,True
13693,2012-07-29,3,1,7,17,0,0,0,1,0.82,0.7424,0.41,0.1642,114,367,481,481,True
13694,2012-07-29,3,1,7,18,0,0,0,1,0.8,0.7121,0.41,0.2985,114,302,416,416,True
13695,2012-07-29,3,1,7,19,0,0,0,1,0.76,0.697,0.55,0.1642,114,300,414,414,True
13696,2012-07-29,3,1,7,20,0,0,0,1,0.74,0.697,0.66,0.1045,75,228,303,303,True
13697,2012-07-29,3,1,7,21,0,0,0,1,0.72,0.6818,0.7,0.1343,72,199,271,271,True
13698,2012-07-29,3,1,7,22,0,0,0,1,0.7,0.6515,0.7,0.1045,31,117,148,148,True
13699,2012-07-29,3,1,7,23,0,0,0,1,0.7,0.6515,0.7,0.0,18,82,100,100,True
13700,2012-07-30,3,1,7,0,0,1,1,1,0.7,0.6667,0.74,0.0896,12,46,58,58,True
13701,2012-07-30,3,1,7,1,0,1,1,1,0.7,0.6667,0.74,0.0,4,15,19,19,True
13702,2012-07-30,3,1,7,2,0,1,1,1,0.68,0.6364,0.74,0.0,2,6,8,8,True
13703,2012-07-30,3,1,7,3,0,1,1,1,0.66,0.6061,0.83,0.0,0,3,3,3,True
13704,2012-07-30,3,1,7,4,0,1,1,1,0.66,0.6061,0.83,0.0,0,5,5,5,True
13705,2012-07-30,3,1,7,5,0,1,1,1,0.66,0.6061,0.83,0.1045,4,43,47,47,True
13706,2012-07-30,3,1,7,6,0,1,1,1,0.66,0.6061,0.83,0.1642,6,155,161,161,True
13707,2012-07-30,3,1,7,7,0,1,1,1,0.7,0.6667,0.79,0.0896,14,455,469,469,True
13708,2012-07-30,3,1,7,8,0,1,1,2,0.72,0.697,0.74,0.1045,31,499,530,530,True
13709,2012-07-30,3,1,7,9,0,1,1,2,0.74,0.697,0.7,0.0,34,259,293,293,True
13710,2012-07-30,3,1,7,10,0,1,1,2,0.74,0.697,0.66,0.2239,54,135,189,189,True
13711,2012-07-30,3,1,7,11,0,1,1,2,0.78,0.7273,0.55,0.1343,69,146,215,215,True
13712,2012-07-30,3,1,7,12,0,1,1,2,0.76,0.7121,0.58,0.1045,77,201,278,278,True
13713,2012-07-30,3,1,7,13,0,1,1,1,0.8,0.7424,0.49,0.1642,57,169,226,226,True
13714,2012-07-30,3,1,7,14,0,1,1,1,0.8,0.7424,0.49,0.2239,87,167,254,254,True
13715,2012-07-30,3,1,7,15,0,1,1,1,0.8,0.7424,0.49,0.2537,51,185,236,236,True
13716,2012-07-30,3,1,7,16,0,1,1,1,0.8,0.7424,0.49,0.2836,88,337,425,425,True
13717,2012-07-30,3,1,7,17,0,1,1,1,0.76,0.697,0.55,0.3284,62,499,561,561,True
13718,2012-07-30,3,1,7,18,0,1,1,1,0.76,0.7121,0.58,0.4179,77,499,576,576,True
13719,2012-07-30,3,1,7,19,0,1,1,1,0.82,0.7727,0.52,0.1642,81,499,580,580,True
13720,2012-07-30,3,1,7,20,0,1,1,1,0.72,0.6818,0.7,0.2239,78,384,462,462,True
13721,2012-07-30,3,1,7,21,0,1,1,1,0.72,0.6818,0.7,0.194,71,251,322,322,True
13722,2012-07-30,3,1,7,22,0,1,1,2,0.7,0.6667,0.74,0.2239,47,183,230,230,True
13723,2012-07-30,3,1,7,23,0,1,1,1,0.7,0.6667,0.74,0.194,34,116,150,150,True
13724,2012-07-31,3,1,7,0,0,2,1,1,0.68,0.6364,0.79,0.1343,11,27,38,38,True
13725,2012-07-31,3,1,7,1,0,2,1,1,0.66,0.6061,0.83,0.1343,3,18,21,21,True
13726,2012-07-31,3,1,7,2,0,2,1,1,0.66,0.6061,0.83,0.1343,0,8,8,8,True
13727,2012-07-31,3,1,7,3,0,2,1,1,0.66,0.6061,0.83,0.0896,1,5,6,6,True
13728,2012-07-31,3,1,7,4,0,2,1,1,0.66,0.6061,0.83,0.0896,0,6,6,6,True
13729,2012-07-31,3,1,7,5,0,2,1,1,0.66,0.6061,0.83,0.1642,5,40,45,45,True
13730,2012-07-31,3,1,7,6,0,2,1,1,0.64,0.5758,0.89,0.1642,2,192,194,194,True
13731,2012-07-31,3,1,7,7,0,2,1,1,0.68,0.6364,0.83,0.2239,21,492,513,513,True
13732,2012-07-31,3,1,7,8,0,2,1,1,0.7,0.6667,0.79,0.1343,30,499,529,529,True
13733,2012-07-31,3,1,7,9,0,2,1,1,0.72,0.6818,0.7,0.1045,31,302,333,333,True
13734,2012-07-31,3,1,7,10,0,2,1,1,0.72,0.6818,0.66,0.0,73,154,227,227,True
13735,2012-07-31,3,1,7,11,0,2,1,1,0.76,0.7121,0.58,0.0,54,170,224,224,True
13736,2012-07-31,3,1,7,12,0,2,1,1,0.8,0.7273,0.46,0.0,50,198,248,248,True
13737,2012-07-31,3,1,7,13,0,2,1,1,0.8,0.7576,0.55,0.2836,69,219,288,288,True
13738,2012-07-31,3,1,7,14,0,2,1,1,0.8,0.7576,0.55,0.2836,72,188,260,260,True
13739,2012-07-31,3,1,7,15,0,2,1,1,0.76,0.7121,0.62,0.1343,29,115,144,144,True
13740,2012-07-31,3,1,7,16,0,2,1,1,0.76,0.7121,0.58,0.2239,66,336,402,402,True
13741,2012-07-31,3,1,7,17,0,2,1,1,0.78,0.7121,0.52,0.2239,94,499,593,593,True
13742,2012-07-31,3,1,7,18,0,2,1,1,0.76,0.697,0.55,0.2836,99,499,598,598,True
13743,2012-07-31,3,1,7,19,0,2,1,3,0.74,0.6818,0.62,0.3582,90,499,589,589,True
13744,2012-07-31,3,1,7,20,0,2,1,3,0.7,0.6515,0.7,0.194,55,397,452,452,True
13745,2012-07-31,3,1,7,21,0,2,1,1,0.68,0.6364,0.79,0.194,60,292,352,352,True
13746,2012-07-31,3,1,7,22,0,2,1,1,0.68,0.6364,0.74,0.2537,33,224,257,257,True
13747,2012-07-31,3,1,7,23,0,2,1,2,0.66,0.6061,0.83,0.1642,20,127,147,147,True
13748,2012-08-01,3,1,8,0,0,3,1,1,0.68,0.6364,0.79,0.1642,3,44,47,47,True
13749,2012-08-01,3,1,8,1,0,3,1,1,0.66,0.6061,0.83,0.0896,5,28,33,33,True
13750,2012-08-01,3,1,8,2,0,3,1,1,0.64,0.5758,0.83,0.1045,0,13,13,13,True
13751,2012-08-01,3,1,8,3,0,3,1,1,0.64,0.5758,0.83,0.1045,0,7,7,7,True
13752,2012-08-01,3,1,8,4,0,3,1,2,0.64,0.5909,0.78,0.1343,1,3,4,4,True
13753,2012-08-01,3,1,8,5,0,3,1,2,0.64,0.5909,0.78,0.1343,3,46,49,49,True
13754,2012-08-01,3,1,8,6,0,3,1,1,0.64,0.5909,0.78,0.1343,6,179,185,185,True
13755,2012-08-01,3,1,8,7,0,3,1,2,0.64,0.5758,0.83,0.1343,19,468,487,487,True
13756,2012-08-01,3,1,8,8,0,3,1,2,0.66,0.6061,0.78,0.194,32,499,531,531,True
13757,2012-08-01,3,1,8,9,0,3,1,2,0.68,0.6364,0.74,0.0896,34,316,350,350,True
13758,2012-08-01,3,1,8,10,0,3,1,1,0.72,0.6818,0.66,0.0896,61,175,236,236,True
13759,2012-08-01,3,1,8,11,0,3,1,1,0.76,0.7121,0.58,0.0896,54,180,234,234,True
13760,2012-08-01,3,1,8,12,0,3,1,1,0.8,0.7424,0.49,0.1045,75,209,284,284,True
13761,2012-08-01,3,1,8,13,0,3,1,1,0.8,0.7424,0.52,0.1642,59,221,280,280,True
13762,2012-08-01,3,1,8,14,0,3,1,1,0.82,0.7576,0.46,0.1642,88,175,263,263,True
13763,2012-08-01,3,1,8,15,0,3,1,1,0.82,0.7576,0.46,0.1642,89,206,295,295,True
13764,2012-08-01,3,1,8,16,0,3,1,1,0.8,0.7576,0.55,0.2836,93,386,479,479,True
13765,2012-08-01,3,1,8,17,0,3,1,1,0.8,0.7424,0.49,0.1642,103,499,602,602,True
13766,2012-08-01,3,1,8,18,0,3,1,3,0.76,0.7121,0.62,0.2239,105,499,604,604,True
13767,2012-08-01,3,1,8,19,0,3,1,1,0.74,0.697,0.66,0.2537,88,499,587,587,True
13768,2012-08-01,3,1,8,20,0,3,1,1,0.74,0.697,0.66,0.1642,65,448,513,513,True
13769,2012-08-01,3,1,8,21,0,3,1,1,0.72,0.6818,0.7,0.1343,36,284,320,320,True
13770,2012-08-01,3,1,8,22,0,3,1,1,0.72,0.6818,0.7,0.1045,37,251,288,288,True
13771,2012-08-01,3,1,8,23,0,3,1,1,0.7,0.6667,0.74,0.0,18,134,152,152,True
13772,2012-08-02,3,1,8,0,0,4,1,1,0.7,0.6667,0.74,0.0,8,55,63,63,True
13773,2012-08-02,3,1,8,1,0,4,1,1,0.68,0.6364,0.79,0.1045,6,36,42,42,True
13774,2012-08-02,3,1,8,2,0,4,1,1,0.66,0.6061,0.83,0.0896,3,8,11,11,True
13775,2012-08-02,3,1,8,3,0,4,1,1,0.66,0.6061,0.83,0.0,0,6,6,6,True
13776,2012-08-02,3,1,8,4,0,4,1,1,0.66,0.6061,0.83,0.0,0,9,9,9,True
13777,2012-08-02,3,1,8,5,0,4,1,1,0.66,0.5909,0.89,0.1343,4,37,41,41,True
13778,2012-08-02,3,1,8,6,0,4,1,1,0.66,0.6061,0.83,0.0,6,177,183,183,True
13779,2012-08-02,3,1,8,7,0,4,1,1,0.7,0.6667,0.79,0.0,21,452,473,473,True
13780,2012-08-02,3,1,8,8,0,4,1,1,0.72,0.697,0.74,0.1045,21,499,520,520,True
13781,2012-08-02,3,1,8,9,0,4,1,1,0.76,0.7273,0.66,0.1045,31,312,343,343,True
13782,2012-08-02,3,1,8,10,0,4,1,1,0.8,0.7576,0.55,0.0,51,130,181,181,True
13783,2012-08-02,3,1,8,11,0,4,1,1,0.82,0.7727,0.52,0.1045,59,167,226,226,True
13784,2012-08-02,3,1,8,12,0,4,1,1,0.84,0.7576,0.44,0.1343,56,230,286,286,True
13785,2012-08-02,3,1,8,13,0,4,1,1,0.86,0.7879,0.44,0.2239,98,212,310,310,True
13786,2012-08-02,3,1,8,14,0,4,1,1,0.86,0.7879,0.41,0.1343,54,171,225,225,True
13787,2012-08-02,3,1,8,15,0,4,1,1,0.78,0.7424,0.62,0.4627,68,202,270,270,True
13788,2012-08-02,3,1,8,16,0,4,1,1,0.82,0.7576,0.46,0.194,71,335,406,406,True
13789,2012-08-02,3,1,8,17,0,4,1,1,0.82,0.7727,0.52,0.2537,90,499,589,589,True
13790,2012-08-02,3,1,8,18,0,4,1,1,0.8,0.7727,0.59,0.2239,86,499,585,585,True
13791,2012-08-02,3,1,8,19,0,4,1,1,0.8,0.7879,0.63,0.1642,98,499,597,597,True
13792,2012-08-02,3,1,8,20,0,4,1,1,0.78,0.7576,0.66,0.0,51,376,427,427,True
13793,2012-08-02,3,1,8,21,0,4,1,1,0.76,0.7273,0.66,0.2239,41,301,342,342,True
13794,2012-08-02,3,1,8,22,0,4,1,1,0.74,0.697,0.7,0.194,35,227,262,262,True
13795,2012-08-02,3,1,8,23,0,4,1,1,0.72,0.6818,0.7,0.2537,25,152,177,177,True
13796,2012-08-03,3,1,8,0,0,5,1,1,0.72,0.6818,0.7,0.194,15,56,71,71,True
13797,2012-08-03,3,1,8,1,0,5,1,1,0.7,0.6667,0.74,0.194,11,32,43,43,True
13798,2012-08-03,3,1,8,2,0,5,1,1,0.68,0.6364,0.79,0.2239,0,14,14,14,True
13799,2012-08-03,3,1,8,3,0,5,1,1,0.68,0.6364,0.79,0.2239,1,5,6,6,True
13800,2012-08-03,3,1,8,4,0,5,1,1,0.66,0.6061,0.83,0.2537,1,11,12,12,True
13801,2012-08-03,3,1,8,5,0,5,1,1,0.66,0.6061,0.83,0.1642,2,35,37,37,True
13802,2012-08-03,3,1,8,6,0,5,1,1,0.66,0.6061,0.83,0.2239,5,158,163,163,True
13803,2012-08-03,3,1,8,7,0,5,1,1,0.7,0.6667,0.74,0.1045,25,396,421,421,True
13804,2012-08-03,3,1,8,8,0,5,1,1,0.72,0.6818,0.7,0.1343,32,499,531,531,True
13805,2012-08-03,3,1,8,9,0,5,1,2,0.74,0.697,0.66,0.1045,69,327,396,396,True
13806,2012-08-03,3,1,8,10,0,5,1,2,0.8,0.7424,0.52,0.194,82,167,249,249,True
13807,2012-08-03,3,1,8,11,0,5,1,2,0.84,0.7879,0.49,0.2836,77,186,263,263,True
13808,2012-08-03,3,1,8,12,0,5,1,2,0.86,0.8182,0.5,0.2985,95,243,338,338,True
13809,2012-08-03,3,1,8,13,0,5,1,2,0.86,0.803,0.47,0.2836,98,247,345,345,True
13810,2012-08-03,3,1,8,14,0,5,1,2,0.86,0.7879,0.44,0.2537,102,229,331,331,True
13811,2012-08-03,3,1,8,15,0,5,1,1,0.88,0.8182,0.42,0.2537,112,268,380,380,True
13812,2012-08-03,3,1,8,16,0,5,1,2,0.86,0.7879,0.41,0.2239,112,380,492,492,True
13813,2012-08-03,3,1,8,17,0,5,1,2,0.84,0.803,0.53,0.2836,95,499,594,594,True
13814,2012-08-03,3,1,8,18,0,5,1,2,0.82,0.803,0.59,0.2537,98,499,597,597,True
13815,2012-08-03,3,1,8,19,0,5,1,2,0.8,0.7879,0.63,0.2239,81,388,469,469,True
13816,2012-08-03,3,1,8,20,0,5,1,2,0.78,0.7576,0.66,0.2239,89,300,389,389,True
13817,2012-08-03,3,1,8,21,0,5,1,2,0.76,0.7273,0.66,0.194,54,224,278,278,True
13818,2012-08-03,3,1,8,22,0,5,1,1,0.76,0.7273,0.7,0.2537,46,156,202,202,True
13819,2012-08-03,3,1,8,23,0,5,1,1,0.74,0.7121,0.79,0.1343,26,170,196,196,True
13820,2012-08-04,3,1,8,0,0,6,0,1,0.74,0.7121,0.79,0.1642,24,137,161,161,True
13821,2012-08-04,3,1,8,1,0,6,0,1,0.72,0.7121,0.84,0.194,23,99,122,122,True
13822,2012-08-04,3,1,8,2,0,6,0,1,0.72,0.7121,0.84,0.1343,20,64,84,84,True
13823,2012-08-04,3,1,8,3,0,6,0,1,0.72,0.7121,0.84,0.1343,11,19,30,30,True
13824,2012-08-04,3,1,8,4,0,6,0,1,0.72,0.697,0.79,0.194,2,11,13,13,True
13825,2012-08-04,3,1,8,5,0,6,0,1,0.7,0.6667,0.84,0.2239,1,16,17,17,True
13826,2012-08-04,3,1,8,6,0,6,0,1,0.7,0.6667,0.84,0.2239,12,37,49,49,True
13827,2012-08-04,3,1,8,7,0,6,0,1,0.72,0.697,0.77,0.1642,18,49,67,67,True
13828,2012-08-04,3,1,8,8,0,6,0,1,0.74,0.7273,0.72,0.194,49,132,181,181,True
13829,2012-08-04,3,1,8,9,0,6,0,1,0.78,0.7576,0.65,0.2239,61,217,278,278,True
13830,2012-08-04,3,1,8,10,0,6,0,1,0.82,0.7727,0.57,0.194,108,288,396,396,True
13831,2012-08-04,3,1,8,11,0,6,0,1,0.86,0.803,0.47,0.2537,114,315,429,429,True
13832,2012-08-04,3,1,8,12,0,6,0,1,0.86,0.7879,0.4,0.3582,114,325,439,439,True
13833,2012-08-04,3,1,8,13,0,6,0,1,0.88,0.8182,0.42,0.2985,114,332,446,446,True
13834,2012-08-04,3,1,8,14,0,6,0,1,0.88,0.803,0.4,0.3881,114,289,403,403,True
13835,2012-08-04,3,1,8,15,0,6,0,1,0.88,0.8182,0.42,0.4179,114,284,398,398,True
13836,2012-08-04,3,1,8,16,0,6,0,1,0.9,0.8182,0.39,0.2985,114,253,367,367,True
13837,2012-08-04,3,1,8,17,0,6,0,1,0.88,0.7879,0.37,0.2985,114,313,427,427,True
13838,2012-08-04,3,1,8,18,0,6,0,1,0.86,0.7879,0.41,0.3284,114,321,435,435,True
13839,2012-08-04,3,1,8,19,0,6,0,1,0.82,0.7727,0.52,0.3582,114,264,378,378,True
13840,2012-08-04,3,1,8,20,0,6,0,1,0.82,0.7727,0.52,0.2985,114,195,309,309,True
13841,2012-08-04,3,1,8,21,0,6,0,1,0.8,0.7727,0.59,0.2537,96,193,289,289,True
13842,2012-08-04,3,1,8,22,0,6,0,1,0.76,0.7273,0.66,0.2836,104,165,269,269,True
13843,2012-08-04,3,1,8,23,0,6,0,1,0.76,0.7273,0.66,0.2985,61,161,222,222,True
13844,2012-08-05,3,1,8,0,0,0,0,1,0.74,0.697,0.7,0.2836,32,121,153,153,True
13845,2012-08-05,3,1,8,1,0,0,0,1,0.74,0.697,0.7,0.2537,8,79,87,87,True
13846,2012-08-05,3,1,8,2,0,0,0,1,0.74,0.697,0.7,0.2985,5,68,73,73,True
13847,2012-08-05,3,1,8,3,0,0,0,1,0.72,0.697,0.74,0.2537,9,32,41,41,True
13848,2012-08-05,3,1,8,4,0,0,0,1,0.72,0.697,0.74,0.2537,3,11,14,14,True
13849,2012-08-05,3,1,8,5,0,0,0,1,0.72,0.697,0.74,0.2537,1,18,19,19,True
13850,2012-08-05,3,1,8,6,0,0,0,1,0.72,0.697,0.79,0.2537,7,12,19,19,True
13851,2012-08-05,3,1,8,7,0,0,0,1,0.74,0.7121,0.74,0.2985,18,50,68,68,True
13852,2012-08-05,3,1,8,8,0,0,0,1,0.76,0.7273,0.66,0.3284,27,81,108,108,True
13853,2012-08-05,3,1,8,9,0,0,0,1,0.8,0.7727,0.59,0.3582,61,168,229,229,True
13854,2012-08-05,3,1,8,10,0,0,0,1,0.8,0.7727,0.59,0.4179,111,253,364,364,True
13855,2012-08-05,3,1,8,11,0,0,0,1,0.82,0.7879,0.56,0.4179,114,282,396,396,True
13856,2012-08-05,3,1,8,12,0,0,0,1,0.86,0.803,0.47,0.4775,114,330,444,444,True
13857,2012-08-05,3,1,8,13,0,0,0,1,0.88,0.8182,0.44,0.4627,114,315,429,429,True
13858,2012-08-05,3,1,8,14,0,0,0,1,0.9,0.8485,0.42,0.4627,114,365,479,479,True
13859,2012-08-05,3,1,8,15,0,0,0,1,0.9,0.8182,0.37,0.4775,114,286,400,400,True
13860,2012-08-05,3,1,8,16,0,0,0,1,0.82,0.7576,0.46,0.2537,114,278,392,392,True
13861,2012-08-05,3,1,8,17,0,0,0,1,0.82,0.7576,0.46,0.2537,114,260,374,374,True
13862,2012-08-05,3,1,8,18,0,0,0,3,0.7,0.6667,0.74,0.1343,75,154,229,229,True
13863,2012-08-05,3,1,8,19,0,0,0,1,0.7,0.6667,0.84,0.2239,46,139,185,185,True
13864,2012-08-05,3,1,8,20,0,0,0,1,0.7,0.6667,0.84,0.1045,53,140,193,193,True
13865,2012-08-05,3,1,8,21,0,0,0,1,0.72,0.697,0.79,0.1045,51,157,208,208,True
13866,2012-08-05,3,1,8,22,0,0,0,1,0.72,0.697,0.79,0.0896,57,100,157,157,True
13867,2012-08-05,3,1,8,23,0,0,0,2,0.72,0.697,0.79,0.1642,29,58,87,87,True
13868,2012-08-06,3,1,8,0,0,1,1,2,0.72,0.697,0.79,0.0,9,24,33,33,True
13869,2012-08-06,3,1,8,1,0,1,1,1,0.72,0.697,0.79,0.0896,1,10,11,11,True
13870,2012-08-06,3,1,8,2,0,1,1,2,0.72,0.697,0.79,0.1343,0,5,5,5,True
13871,2012-08-06,3,1,8,3,0,1,1,3,0.72,0.697,0.79,0.0896,0,5,5,5,True
13872,2012-08-06,3,1,8,4,0,1,1,2,0.72,0.697,0.74,0.1343,3,8,11,11,True
13873,2012-08-06,3,1,8,5,0,1,1,1,0.7,0.6667,0.79,0.194,2,23,25,25,True
13874,2012-08-06,3,1,8,6,0,1,1,2,0.7,0.6667,0.79,0.2239,4,137,141,141,True
13875,2012-08-06,3,1,8,7,0,1,1,3,0.72,0.6818,0.7,0.194,14,393,407,407,True
13876,2012-08-06,3,1,8,8,0,1,1,2,0.7,0.6667,0.79,0.0,27,499,526,526,True
13877,2012-08-06,3,1,8,9,0,1,1,3,0.7,0.6667,0.79,0.1642,28,248,276,276,True
13878,2012-08-06,3,1,8,10,0,1,1,1,0.74,0.697,0.7,0.2239,54,159,213,213,True
13879,2012-08-06,3,1,8,11,0,1,1,1,0.76,0.7273,0.66,0.1343,108,152,260,260,True
13880,2012-08-06,3,1,8,12,0,1,1,2,0.78,0.7273,0.55,0.0896,72,213,285,285,True
13881,2012-08-06,3,1,8,13,0,1,1,1,0.8,0.7424,0.49,0.2239,85,204,289,289,True
13882,2012-08-06,3,1,8,14,0,1,1,1,0.82,0.7576,0.46,0.0,99,188,287,287,True
13883,2012-08-06,3,1,8,15,0,1,1,1,0.82,0.7576,0.46,0.1343,91,183,274,274,True
13884,2012-08-06,3,1,8,16,0,1,1,1,0.84,0.7576,0.41,0.1045,88,363,451,451,True
13885,2012-08-06,3,1,8,17,0,1,1,1,0.82,0.7424,0.41,0.0,112,499,611,611,True
13886,2012-08-06,3,1,8,18,0,1,1,1,0.82,0.7424,0.41,0.1343,100,499,599,599,True
13887,2012-08-06,3,1,8,19,0,1,1,1,0.78,0.7424,0.59,0.194,109,499,608,608,True
13888,2012-08-06,3,1,8,20,0,1,1,1,0.76,0.7273,0.66,0.1642,89,368,457,457,True
13889,2012-08-06,3,1,8,21,0,1,1,1,0.74,0.697,0.7,0.194,72,245,317,317,True
13890,2012-08-06,3,1,8,22,0,1,1,1,0.74,0.697,0.7,0.0896,50,157,207,207,True
13891,2012-08-06,3,1,8,23,0,1,1,1,0.72,0.697,0.74,0.194,16,97,113,113,True
13892,2012-08-07,3,1,8,0,0,2,1,1,0.7,0.6667,0.84,0.194,15,32,47,47,True
13893,2012-08-07,3,1,8,1,0,2,1,1,0.7,0.6667,0.84,0.1343,2,16,18,18,True
13894,2012-08-07,3,1,8,2,0,2,1,1,0.7,0.6667,0.84,0.1343,6,7,13,13,True
13895,2012-08-07,3,1,8,3,0,2,1,1,0.7,0.6667,0.84,0.0,0,6,6,6,True
13896,2012-08-07,3,1,8,4,0,2,1,1,0.68,0.6364,0.83,0.1343,2,7,9,9,True
13897,2012-08-07,3,1,8,5,0,2,1,1,0.7,0.6667,0.79,0.1045,3,33,36,36,True
13898,2012-08-07,3,1,8,6,0,2,1,2,0.7,0.6667,0.79,0.194,3,176,179,179,True
13899,2012-08-07,3,1,8,7,0,2,1,2,0.7,0.6667,0.74,0.1343,21,481,502,502,True
13900,2012-08-07,3,1,8,8,0,2,1,2,0.7,0.6515,0.7,0.1642,41,499,540,540,True
13901,2012-08-07,3,1,8,9,0,2,1,2,0.7,0.6667,0.74,0.1343,44,283,327,327,True
13902,2012-08-07,3,1,8,10,0,2,1,2,0.74,0.697,0.7,0.1343,89,161,250,250,True
13903,2012-08-07,3,1,8,11,0,2,1,2,0.76,0.7273,0.66,0.0896,84,130,214,214,True
13904,2012-08-07,3,1,8,12,0,2,1,2,0.8,0.7576,0.55,0.1343,86,197,283,283,True
13905,2012-08-07,3,1,8,13,0,2,1,2,0.8,0.7424,0.52,0.194,68,185,253,253,True
13906,2012-08-07,3,1,8,14,0,2,1,2,0.82,0.7576,0.46,0.0,76,185,261,261,True
13907,2012-08-07,3,1,8,15,0,2,1,1,0.8,0.7424,0.52,0.0,100,206,306,306,True
13908,2012-08-07,3,1,8,16,0,2,1,3,0.76,0.7273,0.66,0.2836,101,344,445,445,True
13909,2012-08-07,3,1,8,17,0,2,1,2,0.78,0.7424,0.62,0.1343,114,499,613,613,True
13910,2012-08-07,3,1,8,18,0,2,1,2,0.76,0.7121,0.62,0.1642,103,499,602,602,True
13911,2012-08-07,3,1,8,19,0,2,1,2,0.76,0.7273,0.66,0.1045,104,499,603,603,True
13912,2012-08-07,3,1,8,20,0,2,1,2,0.74,0.697,0.7,0.1343,74,374,448,448,True
13913,2012-08-07,3,1,8,21,0,2,1,2,0.72,0.697,0.74,0.0,70,247,317,317,True
13914,2012-08-07,3,1,8,22,0,2,1,1,0.72,0.697,0.74,0.1045,43,181,224,224,True
13915,2012-08-07,3,1,8,23,0,2,1,1,0.72,0.697,0.79,0.0,18,120,138,138,True
13916,2012-08-08,3,1,8,0,0,3,1,1,0.7,0.6667,0.84,0.0,12,46,58,58,True
13917,2012-08-08,3,1,8,1,0,3,1,1,0.72,0.697,0.79,0.0,3,20,23,23,True
13918,2012-08-08,3,1,8,2,0,3,1,1,0.7,0.6667,0.84,0.0,1,5,6,6,True
13919,2012-08-08,3,1,8,3,0,3,1,1,0.7,0.6667,0.84,0.0,1,6,7,7,True
13920,2012-08-08,3,1,8,4,0,3,1,1,0.7,0.6667,0.84,0.0,1,6,7,7,True
13921,2012-08-08,3,1,8,5,0,3,1,2,0.68,0.6364,0.89,0.1642,3,40,43,43,True
13922,2012-08-08,3,1,8,6,0,3,1,2,0.7,0.6667,0.84,0.1642,4,169,173,173,True
13923,2012-08-08,3,1,8,7,0,3,1,2,0.7,0.6667,0.84,0.1642,24,458,482,482,True
13924,2012-08-08,3,1,8,8,0,3,1,2,0.74,0.7273,0.72,0.0896,48,499,547,547,True
13925,2012-08-08,3,1,8,9,0,3,1,2,0.76,0.7273,0.66,0.0,33,308,341,341,True
13926,2012-08-08,3,1,8,10,0,3,1,2,0.8,0.7424,0.52,0.1343,63,151,214,214,True
13927,2012-08-08,3,1,8,11,0,3,1,2,0.8,0.7424,0.52,0.0,80,159,239,239,True
13928,2012-08-08,3,1,8,12,0,3,1,2,0.8,0.7424,0.52,0.0,63,217,280,280,True
13929,2012-08-08,3,1,8,13,0,3,1,2,0.8,0.7424,0.52,0.0,101,212,313,313,True
13930,2012-08-08,3,1,8,14,0,3,1,2,0.8,0.7424,0.52,0.2537,63,173,236,236,True
13931,2012-08-08,3,1,8,15,0,3,1,2,0.84,0.7576,0.44,0.194,110,168,278,278,True
13932,2012-08-08,3,1,8,16,0,3,1,2,0.8,0.7424,0.49,0.2836,113,328,441,441,True
13933,2012-08-08,3,1,8,17,0,3,1,2,0.8,0.7576,0.55,0.2836,107,499,606,606,True
13934,2012-08-08,3,1,8,18,0,3,1,2,0.78,0.7273,0.55,0.1642,114,499,613,613,True
13935,2012-08-08,3,1,8,19,0,3,1,1,0.76,0.7273,0.66,0.2239,114,499,613,613,True
13936,2012-08-08,3,1,8,20,0,3,1,1,0.74,0.697,0.66,0.194,76,424,500,500,True
13937,2012-08-08,3,1,8,21,0,3,1,1,0.74,0.697,0.66,0.1045,70,311,381,381,True
13938,2012-08-08,3,1,8,22,0,3,1,1,0.72,0.697,0.74,0.1045,35,198,233,233,True
13939,2012-08-08,3,1,8,23,0,3,1,1,0.72,0.6818,0.7,0.1343,16,120,136,136,True
13940,2012-08-09,3,1,8,0,0,4,1,1,0.72,0.697,0.74,0.194,16,51,67,67,True
13941,2012-08-09,3,1,8,1,0,4,1,1,0.7,0.6667,0.79,0.1343,5,23,28,28,True
13942,2012-08-09,3,1,8,2,0,4,1,1,0.7,0.6667,0.84,0.0896,2,12,14,14,True
13943,2012-08-09,3,1,8,3,0,4,1,1,0.68,0.6364,0.83,0.0896,1,5,6,6,True
13944,2012-08-09,3,1,8,4,0,4,1,2,0.68,0.6364,0.89,0.1343,0,10,10,10,True
13945,2012-08-09,3,1,8,5,0,4,1,2,0.66,0.5909,0.94,0.0,4,37,41,41,True
13946,2012-08-09,3,1,8,6,0,4,1,1,0.66,0.6061,0.83,0.1642,5,162,167,167,True
13947,2012-08-09,3,1,8,7,0,4,1,2,0.7,0.6667,0.84,0.1642,24,451,475,475,True
13948,2012-08-09,3,1,8,8,0,4,1,1,0.72,0.697,0.74,0.1045,28,499,527,527,True
13949,2012-08-09,3,1,8,9,0,4,1,1,0.76,0.7273,0.66,0.1642,54,299,353,353,True
13950,2012-08-09,3,1,8,10,0,4,1,1,0.8,0.7576,0.55,0.2239,72,133,205,205,True
13951,2012-08-09,3,1,8,11,0,4,1,1,0.84,0.7576,0.44,0.0,94,166,260,260,True
13952,2012-08-09,3,1,8,12,0,4,1,1,0.84,0.7576,0.44,0.1045,85,192,277,277,True
13953,2012-08-09,3,1,8,13,0,4,1,1,0.86,0.7879,0.41,0.1045,80,201,281,281,True
13954,2012-08-09,3,1,8,14,0,4,1,1,0.88,0.7727,0.32,0.2239,86,161,247,247,True
13955,2012-08-09,3,1,8,15,0,4,1,1,0.88,0.7727,0.32,0.2239,63,204,267,267,True
13956,2012-08-09,3,1,8,16,0,4,1,1,0.86,0.7727,0.39,0.2537,97,320,417,417,True
13957,2012-08-09,3,1,8,17,0,4,1,1,0.86,0.7576,0.36,0.2537,111,499,610,610,True
13958,2012-08-09,3,1,8,18,0,4,1,2,0.82,0.7576,0.46,0.2537,78,499,577,577,True
13959,2012-08-09,3,1,8,19,0,4,1,1,0.8,0.7576,0.55,0.194,90,499,589,589,True
13960,2012-08-09,3,1,8,20,0,4,1,1,0.7,0.6515,0.54,0.2836,91,387,478,478,True
13961,2012-08-09,3,1,8,21,0,4,1,2,0.7,0.6515,0.58,0.1642,50,286,336,336,True
13962,2012-08-09,3,1,8,22,0,4,1,2,0.66,0.6212,0.69,0.2239,41,218,259,259,True
13963,2012-08-09,3,1,8,23,0,4,1,1,0.66,0.6212,0.74,0.0,19,137,156,156,True
13964,2012-08-10,3,1,8,0,0,5,1,1,0.7,0.6515,0.65,0.0896,17,68,85,85,True
13965,2012-08-10,3,1,8,1,0,5,1,1,0.7,0.6515,0.65,0.1045,6,35,41,41,True
13966,2012-08-10,3,1,8,2,0,5,1,1,0.7,0.6667,0.74,0.1642,6,14,20,20,True
13967,2012-08-10,3,1,8,3,0,5,1,2,0.72,0.697,0.79,0.194,3,6,9,9,True
13968,2012-08-10,3,1,8,4,0,5,1,3,0.7,0.6667,0.84,0.2836,0,7,7,7,True
13969,2012-08-10,3,1,8,5,0,5,1,3,0.7,0.6667,0.84,0.2836,4,29,33,33,True
13970,2012-08-10,3,1,8,6,0,5,1,3,0.64,0.5758,0.89,0.2985,3,41,44,44,True
13971,2012-08-10,3,1,8,7,0,5,1,3,0.64,0.5758,0.89,0.1045,5,128,133,133,True
13972,2012-08-10,3,1,8,8,0,5,1,3,0.62,0.5455,0.91,0.1642,7,112,119,119,True
13973,2012-08-10,3,1,8,9,0,5,1,2,0.64,0.5758,0.89,0.0,21,199,220,220,True
13974,2012-08-10,3,1,8,10,0,5,1,1,0.66,0.5909,0.89,0.1045,27,166,193,193,True
13975,2012-08-10,3,1,8,11,0,5,1,3,0.68,0.6364,0.79,0.1343,73,178,251,251,True
13976,2012-08-10,3,1,8,12,0,5,1,2,0.74,0.697,0.66,0.3582,75,240,315,315,True
13977,2012-08-10,3,1,8,13,0,5,1,2,0.76,0.7121,0.58,0.3582,66,224,290,290,True
13978,2012-08-10,3,1,8,14,0,5,1,1,0.76,0.7121,0.58,0.3582,71,236,307,307,True
13979,2012-08-10,3,1,8,15,0,5,1,1,0.8,0.7424,0.52,0.4478,100,224,324,324,True
13980,2012-08-10,3,1,8,16,0,5,1,1,0.78,0.7273,0.55,0.2985,96,371,467,467,True
13981,2012-08-10,3,1,8,17,0,5,1,1,0.8,0.7424,0.52,0.2836,111,499,610,610,True
13982,2012-08-10,3,1,8,18,0,5,1,1,0.76,0.7121,0.62,0.2985,88,499,587,587,True
13983,2012-08-10,3,1,8,19,0,5,1,1,0.76,0.7121,0.62,0.2836,98,394,492,492,True
13984,2012-08-10,3,1,8,20,0,5,1,1,0.74,0.697,0.66,0.2985,55,315,370,370,True
13985,2012-08-10,3,1,8,21,0,5,1,1,0.74,0.697,0.66,0.2537,50,236,286,286,True
13986,2012-08-10,3,1,8,22,0,5,1,1,0.72,0.697,0.74,0.2836,50,168,218,218,True
13987,2012-08-10,3,1,8,23,0,5,1,1,0.72,0.6818,0.7,0.2836,33,159,192,192,True
13988,2012-08-11,3,1,8,0,0,6,0,1,0.7,0.6515,0.7,0.2836,38,142,180,180,True
13989,2012-08-11,3,1,8,1,0,6,0,1,0.66,0.6212,0.74,0.2239,32,84,116,116,True
13990,2012-08-11,3,1,8,2,0,6,0,3,0.64,0.5909,0.78,0.194,19,66,85,85,True
13991,2012-08-11,3,1,8,3,0,6,0,3,0.62,0.5758,0.83,0.1642,2,19,21,21,True
13992,2012-08-11,3,1,8,4,0,6,0,1,0.62,0.5758,0.83,0.1045,3,7,10,10,True
13993,2012-08-11,3,1,8,5,0,6,0,1,0.62,0.5606,0.88,0.1045,2,9,11,11,True
13994,2012-08-11,3,1,8,6,0,6,0,2,0.62,0.5606,0.88,0.1045,5,18,23,23,True
13995,2012-08-11,3,1,8,7,0,6,0,1,0.64,0.5758,0.83,0.0896,8,54,62,62,True
13996,2012-08-11,3,1,8,8,0,6,0,1,0.66,0.6061,0.83,0.1045,30,132,162,162,True
13997,2012-08-11,3,1,8,9,0,6,0,1,0.68,0.6364,0.79,0.194,54,217,271,271,True
13998,2012-08-11,3,1,8,10,0,6,0,1,0.72,0.6818,0.62,0.0896,114,282,396,396,True
13999,2012-08-11,3,1,8,11,0,6,0,1,0.74,0.697,0.66,0.1642,114,296,410,410,True
14000,2012-08-11,3,1,8,12,0,6,0,1,0.76,0.7121,0.58,0.2239,114,332,446,446,True
14001,2012-08-11,3,1,8,13,0,6,0,1,0.8,0.7424,0.49,0.3582,114,341,455,455,True
14002,2012-08-11,3,1,8,14,0,6,0,1,0.8,0.7424,0.49,0.2985,114,290,404,404,True
14003,2012-08-11,3,1,8,15,0,6,0,1,0.8,0.7273,0.46,0.2836,114,316,430,430,True
14004,2012-08-11,3,1,8,16,0,6,0,1,0.8,0.7273,0.46,0.2985,114,304,418,418,True
14005,2012-08-11,3,1,8,17,0,6,0,3,0.74,0.697,0.66,0.3582,114,292,406,406,True
14006,2012-08-11,3,1,8,18,0,6,0,2,0.7,0.6667,0.74,0.2985,107,193,300,300,True
14007,2012-08-11,3,1,8,19,0,6,0,2,0.66,0.5909,0.89,0.1045,97,178,275,275,True
14008,2012-08-11,3,1,8,20,0,6,0,3,0.66,0.5909,0.89,0.4179,31,129,160,160,True
14009,2012-08-11,3,1,8,21,0,6,0,2,0.66,0.5909,0.89,0.1642,26,102,128,128,True
14010,2012-08-11,3,1,8,22,0,6,0,2,0.66,0.5909,0.89,0.1642,40,128,168,168,True
14011,2012-08-11,3,1,8,23,0,6,0,3,0.66,0.6061,0.78,0.1642,42,121,163,163,True
14012,2012-08-12,3,1,8,0,0,0,0,2,0.64,0.6061,0.73,0.1343,24,96,120,120,True
14013,2012-08-12,3,1,8,1,0,0,0,1,0.62,0.5909,0.78,0.1343,21,92,113,113,True
14014,2012-08-12,3,1,8,2,0,0,0,1,0.64,0.6061,0.69,0.1343,19,67,86,86,True
14015,2012-08-12,3,1,8,3,0,0,0,1,0.62,0.5909,0.73,0.0896,11,37,48,48,True
14016,2012-08-12,3,1,8,4,0,0,0,1,0.64,0.6061,0.69,0.0896,2,8,10,10,True
14017,2012-08-12,3,1,8,5,0,0,0,1,0.64,0.6212,0.61,0.194,1,9,10,10,True
14018,2012-08-12,3,1,8,6,0,0,0,1,0.64,0.6061,0.65,0.1642,2,14,16,16,True
14019,2012-08-12,3,1,8,7,0,0,0,1,0.64,0.6061,0.65,0.1343,9,30,39,39,True
14020,2012-08-12,3,1,8,8,0,0,0,1,0.66,0.6212,0.54,0.2239,35,84,119,119,True
14021,2012-08-12,3,1,8,9,0,0,0,1,0.7,0.6515,0.48,0.2239,64,153,217,217,True
14022,2012-08-12,3,1,8,10,0,0,0,1,0.7,0.6515,0.51,0.1642,88,240,328,328,True
14023,2012-08-12,3,1,8,11,0,0,0,1,0.74,0.6667,0.42,0.1642,114,282,396,396,True
14024,2012-08-12,3,1,8,12,0,0,0,1,0.74,0.6667,0.42,0.194,114,342,456,456,True
14025,2012-08-12,3,1,8,13,0,0,0,1,0.78,0.697,0.4,0.0,114,365,479,479,True
14026,2012-08-12,3,1,8,14,0,0,0,1,0.76,0.6818,0.4,0.194,114,366,480,480,True
14027,2012-08-12,3,1,8,15,0,0,0,1,0.76,0.6818,0.4,0.1343,114,342,456,456,True
14028,2012-08-12,3,1,8,16,0,0,0,1,0.76,0.6818,0.4,0.1045,114,300,414,414,True
14029,2012-08-12,3,1,8,17,0,0,0,1,0.8,0.697,0.33,0.0,114,319,433,433,True
14030,2012-08-12,3,1,8,18,0,0,0,1,0.78,0.6818,0.35,0.1045,114,327,441,441,True
14031,2012-08-12,3,1,8,19,0,0,0,1,0.74,0.6515,0.4,0.1343,114,317,431,431,True
14032,2012-08-12,3,1,8,20,0,0,0,1,0.72,0.6515,0.45,0.0,96,204,300,300,True
14033,2012-08-12,3,1,8,21,0,0,0,1,0.72,0.6667,0.51,0.0896,78,142,220,220,True
14034,2012-08-12,3,1,8,22,0,0,0,1,0.7,0.6515,0.58,0.1343,40,141,181,181,True
14035,2012-08-12,3,1,8,23,0,0,0,1,0.68,0.6364,0.61,0.0,25,85,110,110,True
14036,2012-08-13,3,1,8,0,0,1,1,1,0.66,0.6212,0.65,0.1045,14,33,47,47,True
14037,2012-08-13,3,1,8,1,0,1,1,1,0.66,0.6212,0.65,0.0896,3,11,14,14,True
14038,2012-08-13,3,1,8,2,0,1,1,1,0.64,0.6061,0.69,0.1045,1,8,9,9,True
14039,2012-08-13,3,1,8,3,0,1,1,1,0.64,0.6061,0.69,0.0,1,5,6,6,True
14040,2012-08-13,3,1,8,4,0,1,1,1,0.64,0.6061,0.69,0.1045,0,11,11,11,True
14041,2012-08-13,3,1,8,5,0,1,1,1,0.64,0.6061,0.69,0.1045,3,33,36,36,True
14042,2012-08-13,3,1,8,6,0,1,1,1,0.62,0.5909,0.73,0.0896,4,155,159,159,True
14043,2012-08-13,3,1,8,7,0,1,1,1,0.66,0.6212,0.65,0.1343,11,425,436,436,True
14044,2012-08-13,3,1,8,8,0,1,1,2,0.72,0.6667,0.51,0.0896,25,499,524,524,True
14045,2012-08-13,3,1,8,9,0,1,1,2,0.74,0.6667,0.45,0.0,40,265,305,305,True
14046,2012-08-13,3,1,8,10,0,1,1,2,0.76,0.6818,0.4,0.0,88,111,199,199,True
14047,2012-08-13,3,1,8,11,0,1,1,1,0.76,0.6818,0.4,0.0896,94,151,245,245,True
14048,2012-08-13,3,1,8,12,0,1,1,1,0.78,0.697,0.4,0.194,96,180,276,276,True
14049,2012-08-13,3,1,8,13,0,1,1,1,0.78,0.697,0.4,0.1642,79,175,254,254,True
14050,2012-08-13,3,1,8,14,0,1,1,1,0.8,0.697,0.33,0.1045,85,163,248,248,True
14051,2012-08-13,3,1,8,15,0,1,1,1,0.82,0.7273,0.34,0.2239,80,194,274,274,True
14052,2012-08-13,3,1,8,16,0,1,1,1,0.8,0.7121,0.36,0.0896,114,348,462,462,True
14053,2012-08-13,3,1,8,17,0,1,1,1,0.8,0.7121,0.36,0.1642,102,499,601,601,True
14054,2012-08-13,3,1,8,18,0,1,1,1,0.76,0.697,0.52,0.2836,103,499,602,602,True
14055,2012-08-13,3,1,8,19,0,1,1,1,0.74,0.6818,0.58,0.1642,88,467,555,555,True
14056,2012-08-13,3,1,8,20,0,1,1,1,0.74,0.6818,0.62,0.2239,58,374,432,432,True
14057,2012-08-13,3,1,8,21,0,1,1,1,0.72,0.6818,0.66,0.194,44,246,290,290,True
14058,2012-08-13,3,1,8,22,0,1,1,1,0.72,0.6818,0.62,0.3284,44,148,192,192,True
14059,2012-08-13,3,1,8,23,0,1,1,1,0.7,0.6515,0.7,0.2239,28,100,128,128,True
14060,2012-08-14,3,1,8,0,0,2,1,1,0.7,0.6667,0.74,0.2239,12,48,60,60,True
14061,2012-08-14,3,1,8,1,0,2,1,1,0.68,0.6364,0.79,0.2537,8,19,27,27,True
14062,2012-08-14,3,1,8,2,0,2,1,2,0.68,0.6364,0.83,0.194,2,9,11,11,True
14063,2012-08-14,3,1,8,3,0,2,1,2,0.68,0.6364,0.83,0.194,0,3,3,3,True
14064,2012-08-14,3,1,8,4,0,2,1,2,0.68,0.6364,0.83,0.194,0,5,5,5,True
14065,2012-08-14,3,1,8,5,0,2,1,2,0.68,0.6364,0.89,0.194,1,35,36,36,True
14066,2012-08-14,3,1,8,6,0,2,1,3,0.64,0.5758,0.83,0.194,1,63,64,64,True
14067,2012-08-14,3,1,8,7,0,2,1,2,0.66,0.6061,0.83,0.0896,1,178,179,179,True
14068,2012-08-14,3,1,8,8,0,2,1,2,0.66,0.5909,0.89,0.0896,27,499,526,526,True
14069,2012-08-14,3,1,8,9,0,2,1,2,0.7,0.6667,0.74,0.0,48,354,402,402,True
14070,2012-08-14,3,1,8,10,0,2,1,1,0.7,0.6667,0.79,0.1045,53,155,208,208,True
14071,2012-08-14,3,1,8,11,0,2,1,1,0.74,0.6818,0.62,0.0,69,127,196,196,True
14072,2012-08-14,3,1,8,12,0,2,1,1,0.78,0.7121,0.49,0.1343,93,207,300,300,True
14073,2012-08-14,3,1,8,13,0,2,1,1,0.8,0.7273,0.46,0.0896,83,203,286,286,True
14074,2012-08-14,3,1,8,14,0,2,1,1,0.82,0.7424,0.41,0.2239,80,175,255,255,True
14075,2012-08-14,3,1,8,15,0,2,1,1,0.82,0.7576,0.46,0.2239,84,199,283,283,True
14076,2012-08-14,3,1,8,16,0,2,1,1,0.82,0.7424,0.43,0.2239,95,363,458,458,True
14077,2012-08-14,3,1,8,17,0,2,1,3,0.76,0.7273,0.66,0.2537,78,499,577,577,True
14078,2012-08-14,3,1,8,18,0,2,1,1,0.76,0.7121,0.62,0.2836,97,499,596,596,True
14079,2012-08-14,3,1,8,19,0,2,1,1,0.76,0.7273,0.66,0.194,94,499,593,593,True
14080,2012-08-14,3,1,8,20,0,2,1,1,0.74,0.7121,0.74,0.2239,65,371,436,436,True
14081,2012-08-14,3,1,8,21,0,2,1,1,0.74,0.6818,0.62,0.2239,56,252,308,308,True
14082,2012-08-14,3,1,8,22,0,2,1,1,0.72,0.6818,0.66,0.0896,28,161,189,189,True
14083,2012-08-14,3,1,8,23,0,2,1,1,0.72,0.6818,0.66,0.1642,53,114,167,167,True
14084,2012-08-15,3,1,8,0,0,3,1,1,0.7,0.6515,0.61,0.194,8,52,60,60,True
14085,2012-08-15,3,1,8,1,0,3,1,1,0.7,0.6515,0.61,0.0,6,31,37,37,True
14086,2012-08-15,3,1,8,2,0,3,1,1,0.68,0.6364,0.65,0.0,1,7,8,8,True
14087,2012-08-15,3,1,8,3,0,3,1,1,0.66,0.6212,0.74,0.1045,1,10,11,11,True
14088,2012-08-15,3,1,8,4,0,3,1,1,0.64,0.5758,0.83,0.1045,0,4,4,4,True
14089,2012-08-15,3,1,8,5,0,3,1,1,0.64,0.5909,0.78,0.1045,4,35,39,39,True
14090,2012-08-15,3,1,8,6,0,3,1,1,0.64,0.5909,0.78,0.1045,12,160,172,172,True
14091,2012-08-15,3,1,8,7,0,3,1,2,0.66,0.6212,0.69,0.194,25,467,492,492,True
14092,2012-08-15,3,1,8,8,0,3,1,2,0.7,0.6515,0.65,0.2836,40,499,539,539,True
14093,2012-08-15,3,1,8,9,0,3,1,2,0.72,0.6818,0.62,0.194,57,310,367,367,True
14094,2012-08-15,3,1,8,10,0,3,1,2,0.72,0.6818,0.62,0.194,70,163,233,233,True
14095,2012-08-15,3,1,8,11,0,3,1,2,0.74,0.6818,0.58,0.194,80,155,235,235,True
14096,2012-08-15,3,1,8,12,0,3,1,1,0.74,0.6818,0.55,0.2239,77,230,307,307,True
14097,2012-08-15,3,1,8,13,0,3,1,2,0.78,0.7121,0.49,0.194,88,206,294,294,True
14098,2012-08-15,3,1,8,14,0,3,1,2,0.76,0.697,0.52,0.2985,94,161,255,255,True
14099,2012-08-15,3,1,8,15,0,3,1,1,0.76,0.697,0.52,0.2537,70,196,266,266,True
14100,2012-08-15,3,1,8,16,0,3,1,1,0.76,0.6818,0.48,0.194,91,340,431,431,True
14101,2012-08-15,3,1,8,17,0,3,1,1,0.74,0.6818,0.55,0.2836,102,499,601,601,True
14102,2012-08-15,3,1,8,18,0,3,1,1,0.74,0.6667,0.51,0.2239,80,499,579,579,True
14103,2012-08-15,3,1,8,19,0,3,1,1,0.7,0.6515,0.61,0.1343,114,499,613,613,True
14104,2012-08-15,3,1,8,20,0,3,1,1,0.7,0.6515,0.61,0.1343,72,355,427,427,True
14105,2012-08-15,3,1,8,21,0,3,1,1,0.7,0.6515,0.61,0.194,49,266,315,315,True
14106,2012-08-15,3,1,8,22,0,3,1,1,0.7,0.6515,0.61,0.1642,29,197,226,226,True
14107,2012-08-15,3,1,8,23,0,3,1,1,0.68,0.6364,0.65,0.1045,18,120,138,138,True
14108,2012-08-16,3,1,8,0,0,4,1,1,0.66,0.6212,0.69,0.0,13,63,76,76,True
14109,2012-08-16,3,1,8,1,0,4,1,1,0.64,0.6061,0.73,0.0,3,18,21,21,True
14110,2012-08-16,3,1,8,2,0,4,1,1,0.64,0.6061,0.69,0.194,0,15,15,15,True
14111,2012-08-16,3,1,8,3,0,4,1,1,0.62,0.5909,0.73,0.2537,0,4,4,4,True
14112,2012-08-16,3,1,8,4,0,4,1,1,0.62,0.5909,0.73,0.2239,2,3,5,5,True
14113,2012-08-16,3,1,8,5,0,4,1,1,0.6,0.5758,0.78,0.1642,7,30,37,37,True
14114,2012-08-16,3,1,8,6,0,4,1,1,0.6,0.5758,0.78,0.1642,3,162,165,165,True
14115,2012-08-16,3,1,8,7,0,4,1,1,0.64,0.6061,0.69,0.2239,16,448,464,464,True
14116,2012-08-16,3,1,8,8,0,4,1,1,0.68,0.6364,0.61,0.194,33,499,532,532,True
14117,2012-08-16,3,1,8,9,0,4,1,1,0.72,0.6667,0.54,0.1045,41,296,337,337,True
14118,2012-08-16,3,1,8,10,0,4,1,1,0.74,0.6667,0.48,0.1343,78,121,199,199,True
14119,2012-08-16,3,1,8,11,0,4,1,1,0.76,0.6667,0.37,0.0896,83,191,274,274,True
14120,2012-08-16,3,1,8,12,0,4,1,1,0.8,0.697,0.33,0.1045,96,247,343,343,True
14121,2012-08-16,3,1,8,13,0,4,1,1,0.8,0.697,0.31,0.2239,81,219,300,300,True
14122,2012-08-16,3,1,8,14,0,4,1,1,0.82,0.7121,0.32,0.0,72,176,248,248,True
14123,2012-08-16,3,1,8,15,0,4,1,1,0.8,0.697,0.33,0.2537,63,197,260,260,True
14124,2012-08-16,3,1,8,16,0,4,1,1,0.82,0.7121,0.32,0.2239,79,340,419,419,True
14125,2012-08-16,3,1,8,17,0,4,1,1,0.82,0.7273,0.34,0.194,114,499,613,613,True
14126,2012-08-16,3,1,8,18,0,4,1,1,0.8,0.7121,0.36,0.0,109,499,608,608,True
14127,2012-08-16,3,1,8,19,0,4,1,1,0.76,0.6818,0.4,0.1045,114,499,613,613,True
14128,2012-08-16,3,1,8,20,0,4,1,1,0.76,0.6818,0.4,0.0896,100,414,514,514,True
14129,2012-08-16,3,1,8,21,0,4,1,1,0.74,0.6667,0.48,0.194,83,273,356,356,True
14130,2012-08-16,3,1,8,22,0,4,1,1,0.72,0.6667,0.51,0.1642,69,185,254,254,True
14131,2012-08-16,3,1,8,23,0,4,1,1,0.7,0.6515,0.54,0.1045,58,168,226,226,True
14132,2012-08-17,3,1,8,0,0,5,1,1,0.68,0.2424,0.57,0.1642,21,67,88,88,True
14133,2012-08-17,3,1,8,1,0,5,1,1,0.66,0.2424,0.65,0.1045,16,38,54,54,True
14134,2012-08-17,3,1,8,2,0,5,1,1,0.66,0.2424,0.61,0.1343,4,15,19,19,True
14135,2012-08-17,3,1,8,3,0,5,1,1,0.64,0.2424,0.65,0.1045,0,6,6,6,True
14136,2012-08-17,3,1,8,4,0,5,1,1,0.64,0.2424,0.73,0.1642,0,9,9,9,True
14137,2012-08-17,3,1,8,5,0,5,1,1,0.64,0.2424,0.73,0.1045,2,34,36,36,True
14138,2012-08-17,3,1,8,6,0,5,1,1,0.62,0.2424,0.78,0.1343,6,151,157,157,True
14139,2012-08-17,3,1,8,7,0,5,1,1,0.64,0.2424,0.73,0.1045,11,368,379,379,True
14140,2012-08-17,3,1,8,8,0,5,1,1,0.68,0.2424,0.65,0.1343,43,499,542,542,True
14141,2012-08-17,3,1,8,9,0,5,1,1,0.7,0.2424,0.58,0.1045,58,320,378,378,True
14142,2012-08-17,3,1,8,10,0,5,1,1,0.74,0.2424,0.55,0.1642,82,149,231,231,True
14143,2012-08-17,3,1,8,11,0,5,1,1,0.76,0.2424,0.52,0.2836,98,205,303,303,True
14144,2012-08-17,3,1,8,12,0,5,1,1,0.82,0.2424,0.41,0.2239,110,255,365,365,True
14145,2012-08-17,3,1,8,13,0,5,1,1,0.84,0.2424,0.36,0.3881,103,254,357,357,True
14146,2012-08-17,3,1,8,14,0,5,1,1,0.86,0.2424,0.34,0.4179,114,200,314,314,True
14147,2012-08-17,3,1,8,15,0,5,1,1,0.86,0.2424,0.3,0.4627,114,256,370,370,True
14148,2012-08-17,3,1,8,16,0,5,1,2,0.84,0.2424,0.32,0.4478,114,372,486,486,True
14149,2012-08-17,3,1,8,17,0,5,1,1,0.82,0.2424,0.36,0.3284,114,499,613,613,True
14150,2012-08-17,3,1,8,18,0,5,1,2,0.82,0.2424,0.38,0.2537,108,499,607,607,True
14151,2012-08-17,3,1,8,19,0,5,1,2,0.74,0.2424,0.55,0.3881,88,403,491,491,True
14152,2012-08-17,3,1,8,20,0,5,1,2,0.72,0.2424,0.58,0.2239,97,262,359,359,True
14153,2012-08-17,3,1,8,21,0,5,1,2,0.68,0.2424,0.69,0.2985,57,198,255,255,True
14154,2012-08-17,3,1,8,22,0,5,1,3,0.66,0.2424,0.83,0.194,43,170,213,213,True
14155,2012-08-17,3,1,8,23,0,5,1,3,0.64,0.2424,0.83,0.2239,21,100,121,121,True
14156,2012-08-18,3,1,8,0,0,6,0,2,0.64,0.5758,0.83,0.2239,6,99,105,105,True
14157,2012-08-18,3,1,8,1,0,6,0,3,0.62,0.5455,0.94,0.1642,14,78,92,92,True
14158,2012-08-18,3,1,8,2,0,6,0,3,0.62,0.5606,0.88,0.1642,4,39,43,43,True
14159,2012-08-18,3,1,8,3,0,6,0,1,0.62,0.5606,0.88,0.194,7,23,30,30,True
14160,2012-08-18,3,1,8,4,0,6,0,1,0.62,0.5909,0.73,0.2239,5,8,13,13,True
14161,2012-08-18,3,1,8,5,0,6,0,1,0.6,0.5758,0.78,0.2537,2,7,9,9,True
14162,2012-08-18,3,1,8,6,0,6,0,1,0.6,0.5606,0.83,0.2239,4,23,27,27,True
14163,2012-08-18,3,1,8,7,0,6,0,1,0.6,0.5606,0.83,0.2239,12,52,64,64,True
14164,2012-08-18,3,1,8,8,0,6,0,1,0.64,0.6061,0.69,0.2537,28,161,189,189,True
14165,2012-08-18,3,1,8,9,0,6,0,1,0.66,0.6212,0.65,0.2836,81,211,292,292,True
14166,2012-08-18,3,1,8,10,0,6,0,1,0.7,0.6515,0.54,0.1642,114,314,428,428,True
14167,2012-08-18,3,1,8,11,0,6,0,1,0.72,0.6667,0.51,0.0,114,356,470,470,True
14168,2012-08-18,3,1,8,12,0,6,0,1,0.76,0.6667,0.37,0.194,114,388,502,502,True
14169,2012-08-18,3,1,8,13,0,6,0,1,0.74,0.6515,0.4,0.194,114,355,469,469,True
14170,2012-08-18,3,1,8,14,0,6,0,1,0.76,0.6667,0.37,0.2836,114,356,470,470,True
14171,2012-08-18,3,1,8,15,0,6,0,1,0.76,0.6667,0.37,0.2239,114,346,460,460,True
14172,2012-08-18,3,1,8,16,0,6,0,1,0.76,0.6667,0.37,0.2537,114,354,468,468,True
14173,2012-08-18,3,1,8,17,0,6,0,1,0.76,0.6667,0.37,0.2239,114,379,493,493,True
14174,2012-08-18,3,1,8,18,0,6,0,1,0.74,0.6515,0.37,0.1642,114,329,443,443,True
14175,2012-08-18,3,1,8,19,0,6,0,1,0.7,0.6364,0.45,0.1642,114,324,438,438,True
14176,2012-08-18,3,1,8,20,0,6,0,1,0.7,0.6364,0.45,0.1045,99,242,341,341,True
14177,2012-08-18,3,1,8,21,0,6,0,1,0.66,0.6212,0.61,0.0,90,248,338,338,True
14178,2012-08-18,3,1,8,22,0,6,0,1,0.66,0.6212,0.61,0.0,90,171,261,261,True
14179,2012-08-18,3,1,8,23,0,6,0,1,0.64,0.6061,0.65,0.0896,60,175,235,235,True
14180,2012-08-19,3,1,8,0,0,0,0,1,0.66,0.6212,0.57,0.0896,44,143,187,187,True
14181,2012-08-19,3,1,8,1,0,0,0,1,0.64,0.6061,0.65,0.0,29,102,131,131,True
14182,2012-08-19,3,1,8,2,0,0,0,2,0.62,0.6061,0.69,0.0896,16,103,119,119,True
14183,2012-08-19,3,1,8,3,0,0,0,2,0.62,0.6061,0.61,0.1642,21,34,55,55,True
14184,2012-08-19,3,1,8,4,0,0,0,2,0.62,0.6061,0.65,0.1642,4,22,26,26,True
14185,2012-08-19,3,1,8,5,0,0,0,2,0.6,0.5909,0.73,0.1343,3,8,11,11,True
14186,2012-08-19,3,1,8,6,0,0,0,2,0.62,0.6061,0.69,0.1045,5,15,20,20,True
14187,2012-08-19,3,1,8,7,0,0,0,2,0.62,0.6061,0.69,0.1343,12,29,41,41,True
14188,2012-08-19,3,1,8,8,0,0,0,2,0.64,0.6061,0.69,0.1045,34,90,124,124,True
14189,2012-08-19,3,1,8,9,0,0,0,2,0.66,0.6212,0.74,0.0,86,184,270,270,True
14190,2012-08-19,3,1,8,10,0,0,0,2,0.68,0.6364,0.69,0.0,114,287,401,401,True
14191,2012-08-19,3,1,8,11,0,0,0,3,0.64,0.5909,0.78,0.1642,83,189,272,272,True
14192,2012-08-19,3,1,8,12,0,0,0,3,0.64,0.6061,0.73,0.0,112,186,298,298,True
14193,2012-08-19,3,1,8,13,0,0,0,3,0.64,0.5758,0.83,0.1343,50,112,162,162,True
14194,2012-08-19,3,1,8,14,0,0,0,3,0.64,0.6061,0.73,0.0,41,108,149,149,True
14195,2012-08-19,3,1,8,15,0,0,0,2,0.64,0.6061,0.65,0.0,89,187,276,276,True
14196,2012-08-19,3,1,8,16,0,0,0,2,0.66,0.6212,0.65,0.0,97,259,356,356,True
14197,2012-08-19,3,1,8,17,0,0,0,2,0.64,0.5909,0.78,0.1045,76,267,343,343,True
14198,2012-08-19,3,1,8,18,0,0,0,2,0.64,0.5909,0.78,0.1045,86,291,377,377,True
14199,2012-08-19,3,1,8,19,0,0,0,2,0.64,0.6061,0.73,0.1343,72,269,341,341,True
14200,2012-08-19,3,1,8,20,0,0,0,2,0.64,0.6061,0.73,0.194,61,213,274,274,True
14201,2012-08-19,3,1,8,21,0,0,0,3,0.62,0.5909,0.78,0.0896,36,154,190,190,True
14202,2012-08-19,3,1,8,22,0,0,0,2,0.62,0.5909,0.78,0.1642,6,50,56,56,True
14203,2012-08-19,3,1,8,23,0,0,0,2,0.62,0.5909,0.73,0.0,7,39,46,46,True
14204,2012-08-20,3,1,8,0,0,1,1,2,0.6,0.5606,0.83,0.1045,1,25,26,26,True
14205,2012-08-20,3,1,8,1,0,1,1,1,0.6,0.5606,0.83,0.1642,0,10,10,10,True
14206,2012-08-20,3,1,8,2,0,1,1,1,0.6,0.5606,0.83,0.1642,0,5,5,5,True
14207,2012-08-20,3,1,8,3,0,1,1,1,0.6,0.5455,0.88,0.1045,0,3,3,3,True
14208,2012-08-20,3,1,8,4,0,1,1,2,0.6,0.5606,0.83,0.0896,0,7,7,7,True
14209,2012-08-20,3,1,8,5,0,1,1,2,0.6,0.5606,0.83,0.0,2,35,37,37,True
14210,2012-08-20,3,1,8,6,0,1,1,2,0.6,0.5758,0.78,0.1343,6,155,161,161,True
14211,2012-08-20,3,1,8,7,0,1,1,2,0.62,0.5909,0.78,0.1343,15,427,442,442,True
14212,2012-08-20,3,1,8,8,0,1,1,2,0.62,0.5909,0.73,0.1045,37,499,536,536,True
14213,2012-08-20,3,1,8,9,0,1,1,2,0.64,0.6061,0.69,0.0,55,302,357,357,True
14214,2012-08-20,3,1,8,10,0,1,1,2,0.64,0.6061,0.69,0.0896,69,124,193,193,True
14215,2012-08-20,3,1,8,11,0,1,1,1,0.66,0.6212,0.65,0.1045,90,151,241,241,True
14216,2012-08-20,3,1,8,12,0,1,1,2,0.66,0.6212,0.61,0.1045,66,216,282,282,True
14217,2012-08-20,3,1,8,13,0,1,1,1,0.7,0.6515,0.58,0.1343,97,194,291,291,True
14218,2012-08-20,3,1,8,14,0,1,1,1,0.72,0.6667,0.54,0.1642,87,188,275,275,True
14219,2012-08-20,3,1,8,15,0,1,1,1,0.72,0.6667,0.54,0.2537,102,207,309,309,True
14220,2012-08-20,3,1,8,16,0,1,1,1,0.72,0.6667,0.54,0.2537,103,357,460,460,True
14221,2012-08-20,3,1,8,17,0,1,1,1,0.7,0.6515,0.58,0.2836,83,499,582,582,True
14222,2012-08-20,3,1,8,18,0,1,1,2,0.62,0.5909,0.78,0.2537,89,499,588,588,True
14223,2012-08-20,3,1,8,19,0,1,1,2,0.62,0.5909,0.78,0.194,33,266,299,299,True
14224,2012-08-20,3,1,8,20,0,1,1,2,0.62,0.5758,0.83,0.2836,30,231,261,261,True
14225,2012-08-20,3,1,8,21,0,1,1,1,0.6,0.5606,0.83,0.0,26,219,245,245,True
14226,2012-08-20,3,1,8,22,0,1,1,2,0.6,0.5606,0.83,0.0,25,136,161,161,True
14227,2012-08-20,3,1,8,23,0,1,1,2,0.6,0.5606,0.83,0.0,10,92,102,102,True
14228,2012-08-21,3,1,8,0,0,2,1,2,0.6,0.5606,0.83,0.0896,7,52,59,59,True
14229,2012-08-21,3,1,8,1,0,2,1,2,0.6,0.5606,0.83,0.1343,11,22,33,33,True
14230,2012-08-21,3,1,8,2,0,2,1,2,0.58,0.5455,0.88,0.2836,1,7,8,8,True
14231,2012-08-21,3,1,8,3,0,2,1,1,0.56,0.5303,0.88,0.0,0,3,3,3,True
14232,2012-08-21,3,1,8,4,0,2,1,1,0.56,0.5303,0.88,0.0,0,4,4,4,True
14233,2012-08-21,3,1,8,5,0,2,1,1,0.56,0.5303,0.83,0.0896,4,30,34,34,True
14234,2012-08-21,3,1,8,6,0,2,1,1,0.56,0.5303,0.83,0.1045,5,164,169,169,True
14235,2012-08-21,3,1,8,7,0,2,1,1,0.6,0.5758,0.78,0.1045,19,499,518,518,True
14236,2012-08-21,3,1,8,8,0,2,1,1,0.6,0.5758,0.78,0.1343,27,499,526,526,True
14237,2012-08-21,3,1,8,9,0,2,1,1,0.64,0.6061,0.69,0.0,47,281,328,328,True
14238,2012-08-21,3,1,8,10,0,2,1,1,0.66,0.6212,0.61,0.1045,58,120,178,178,True
14239,2012-08-21,3,1,8,11,0,2,1,1,0.7,0.6515,0.54,0.0,61,195,256,256,True
14240,2012-08-21,3,1,8,12,0,2,1,1,0.72,0.6515,0.45,0.0,79,226,305,305,True
14241,2012-08-21,3,1,8,13,0,2,1,1,0.74,0.6515,0.4,0.0,76,255,331,331,True
14242,2012-08-21,3,1,8,14,0,2,1,1,0.76,0.6667,0.37,0.0896,110,192,302,302,True
14243,2012-08-21,3,1,8,15,0,2,1,1,0.76,0.6667,0.37,0.0,76,226,302,302,True
14244,2012-08-21,3,1,8,16,0,2,1,1,0.76,0.6667,0.37,0.0,109,358,467,467,True
14245,2012-08-21,3,1,8,17,0,2,1,1,0.74,0.6667,0.51,0.2836,92,499,591,591,True
14246,2012-08-21,3,1,8,18,0,2,1,1,0.72,0.6667,0.54,0.2239,93,499,592,592,True
14247,2012-08-21,3,1,8,19,0,2,1,3,0.62,0.5909,0.73,0.1045,56,420,476,476,True
14248,2012-08-21,3,1,8,20,0,2,1,1,0.64,0.6061,0.73,0.0,62,296,358,358,True
14249,2012-08-21,3,1,8,21,0,2,1,1,0.64,0.6061,0.73,0.0,41,239,280,280,True
14250,2012-08-21,3,1,8,22,0,2,1,1,0.64,0.5909,0.78,0.0,24,208,232,232,True
14251,2012-08-21,3,1,8,23,0,2,1,1,0.62,0.5758,0.83,0.0,23,113,136,136,True
14252,2012-08-22,3,1,8,0,0,3,1,1,0.62,0.5758,0.83,0.1045,9,46,55,55,True
14253,2012-08-22,3,1,8,1,0,3,1,1,0.62,0.5909,0.78,0.0,1,20,21,21,True
14254,2012-08-22,3,1,8,2,0,3,1,1,0.62,0.5909,0.78,0.0,7,10,17,17,True
14255,2012-08-22,3,1,8,3,0,3,1,1,0.62,0.5909,0.78,0.0,0,7,7,7,True
14256,2012-08-22,3,1,8,4,0,3,1,1,0.58,0.5455,0.83,0.1045,1,7,8,8,True
14257,2012-08-22,3,1,8,5,0,3,1,1,0.6,0.5758,0.78,0.0,2,38,40,40,True
14258,2012-08-22,3,1,8,6,0,3,1,1,0.62,0.5909,0.73,0.0,12,175,187,187,True
14259,2012-08-22,3,1,8,7,0,3,1,1,0.62,0.5909,0.78,0.0,16,499,515,515,True
14260,2012-08-22,3,1,8,8,0,3,1,1,0.64,0.6061,0.73,0.0896,37,499,536,536,True
14261,2012-08-22,3,1,8,9,0,3,1,1,0.68,0.6364,0.65,0.0,41,335,376,376,True
14262,2012-08-22,3,1,8,10,0,3,1,1,0.7,0.6515,0.61,0.0896,66,159,225,225,True
14263,2012-08-22,3,1,8,11,0,3,1,1,0.72,0.6667,0.58,0.0896,71,196,267,267,True
14264,2012-08-22,3,1,8,12,0,3,1,1,0.74,0.6667,0.51,0.0,59,253,312,312,True
14265,2012-08-22,3,1,8,13,0,3,1,1,0.76,0.6818,0.48,0.1045,74,242,316,316,True
14266,2012-08-22,3,1,8,14,0,3,1,1,0.76,0.6818,0.45,0.1045,82,184,266,266,True
14267,2012-08-22,3,1,8,15,0,3,1,1,0.76,0.6818,0.48,0.1343,94,222,316,316,True
14268,2012-08-22,3,1,8,16,0,3,1,3,0.74,0.6818,0.55,0.2239,102,358,460,460,True
14269,2012-08-22,3,1,8,17,0,3,1,3,0.74,0.6818,0.55,0.2239,72,499,571,571,True
14270,2012-08-22,3,1,8,18,0,3,1,3,0.66,0.6212,0.61,0.2239,91,499,590,590,True
14271,2012-08-22,3,1,8,19,0,3,1,2,0.66,0.6212,0.74,0.0,56,499,555,555,True
14272,2012-08-22,3,1,8,20,0,3,1,1,0.64,0.6061,0.73,0.194,59,332,391,391,True
14273,2012-08-22,3,1,8,21,0,3,1,1,0.64,0.6061,0.73,0.0,60,291,351,351,True
14274,2012-08-22,3,1,8,22,0,3,1,1,0.64,0.6061,0.73,0.0,55,226,281,281,True
14275,2012-08-22,3,1,8,23,0,3,1,1,0.64,0.5758,0.83,0.0,27,113,140,140,True
14276,2012-08-23,3,1,8,0,0,4,1,1,0.64,0.5909,0.78,0.0,9,51,60,60,True
14277,2012-08-23,3,1,8,1,0,4,1,1,0.62,0.5758,0.83,0.0,10,15,25,25,True
14278,2012-08-23,3,1,8,2,0,4,1,1,0.62,0.5758,0.83,0.0,9,11,20,20,True
14279,2012-08-23,3,1,8,3,0,4,1,1,0.62,0.5758,0.83,0.0896,3,6,9,9,True
14280,2012-08-23,3,1,8,4,0,4,1,1,0.62,0.5758,0.83,0.0,0,6,6,6,True
14281,2012-08-23,3,1,8,5,0,4,1,1,0.62,0.5758,0.83,0.0,1,36,37,37,True
14282,2012-08-23,3,1,8,6,0,4,1,2,0.6,0.5455,0.88,0.0896,14,178,192,192,True
14283,2012-08-23,3,1,8,7,0,4,1,2,0.62,0.5758,0.83,0.0896,18,463,481,481,True
14284,2012-08-23,3,1,8,8,0,4,1,2,0.66,0.6212,0.74,0.0896,45,499,544,544,True
14285,2012-08-23,3,1,8,9,0,4,1,2,0.7,0.6515,0.7,0.0,58,354,412,412,True
14286,2012-08-23,3,1,8,10,0,4,1,1,0.74,0.6818,0.58,0.0896,76,157,233,233,True
14287,2012-08-23,3,1,8,11,0,4,1,1,0.76,0.6818,0.48,0.0896,86,192,278,278,True
14288,2012-08-23,3,1,8,12,0,4,1,1,0.78,0.6818,0.38,0.0,97,235,332,332,True
14289,2012-08-23,3,1,8,13,0,4,1,1,0.82,0.7273,0.38,0.0896,93,253,346,346,True
14290,2012-08-23,3,1,8,14,0,4,1,1,0.78,0.697,0.46,0.2239,114,191,305,305,True
14291,2012-08-23,3,1,8,15,0,4,1,1,0.78,0.697,0.46,0.1343,104,201,305,305,True
14292,2012-08-23,3,1,8,16,0,4,1,1,0.76,0.6818,0.48,0.1642,114,344,458,458,True
14293,2012-08-23,3,1,8,17,0,4,1,1,0.76,0.6818,0.45,0.2239,111,499,610,610,True
14294,2012-08-23,3,1,8,18,0,4,1,1,0.74,0.6667,0.48,0.2239,114,499,613,613,True
14295,2012-08-23,3,1,8,19,0,4,1,1,0.72,0.6667,0.51,0.0896,96,499,595,595,True
14296,2012-08-23,3,1,8,20,0,4,1,1,0.7,0.6515,0.61,0.1045,70,404,474,474,True
14297,2012-08-23,3,1,8,21,0,4,1,1,0.7,0.6515,0.61,0.1343,53,276,329,329,True
14298,2012-08-23,3,1,8,22,0,4,1,2,0.68,0.6364,0.61,0.1045,21,177,198,198,True
14299,2012-08-23,3,1,8,23,0,4,1,2,0.66,0.6212,0.69,0.0,24,133,157,157,True
14300,2012-08-24,3,1,8,0,0,5,1,2,0.66,0.6212,0.69,0.0,27,84,111,111,True
14301,2012-08-24,3,1,8,1,0,5,1,2,0.64,0.6061,0.73,0.0,5,37,42,42,True
14302,2012-08-24,3,1,8,2,0,5,1,1,0.66,0.6212,0.69,0.0,1,15,16,16,True
14303,2012-08-24,3,1,8,3,0,5,1,1,0.64,0.6061,0.73,0.0,2,6,8,8,True
14304,2012-08-24,3,1,8,4,0,5,1,2,0.64,0.6061,0.73,0.0,2,6,8,8,True
14305,2012-08-24,3,1,8,5,0,5,1,1,0.64,0.5909,0.78,0.0,1,37,38,38,True
14306,2012-08-24,3,1,8,6,0,5,1,2,0.62,0.5758,0.83,0.0,9,142,151,151,True
14307,2012-08-24,3,1,8,7,0,5,1,2,0.64,0.5909,0.78,0.0,13,412,425,425,True
14308,2012-08-24,3,1,8,8,0,5,1,2,0.66,0.6212,0.74,0.0,41,499,540,540,True
14309,2012-08-24,3,1,8,9,0,5,1,2,0.72,0.6667,0.58,0.0,58,331,389,389,True
14310,2012-08-24,3,1,8,10,0,5,1,2,0.76,0.6818,0.48,0.0,78,184,262,262,True
14311,2012-08-24,3,1,8,11,0,5,1,2,0.76,0.6818,0.48,0.1045,69,212,281,281,True
14312,2012-08-24,3,1,8,12,0,5,1,2,0.76,0.6818,0.45,0.0896,95,276,371,371,True
14313,2012-08-24,3,1,8,13,0,5,1,2,0.8,0.7121,0.41,0.1045,79,272,351,351,True
14314,2012-08-24,3,1,8,14,0,5,1,1,0.78,0.697,0.43,0.1045,109,229,338,338,True
14315,2012-08-24,3,1,8,15,0,5,1,2,0.76,0.6818,0.48,0.1343,99,251,350,350,True
14316,2012-08-24,3,1,8,16,0,5,1,2,0.76,0.6818,0.48,0.1343,101,414,515,515,True
14317,2012-08-24,3,1,8,17,0,5,1,2,0.74,0.6667,0.51,0.2239,114,499,613,613,True
14318,2012-08-24,3,1,8,18,0,5,1,2,0.72,0.6818,0.62,0.194,109,499,608,608,True
14319,2012-08-24,3,1,8,19,0,5,1,2,0.72,0.6667,0.58,0.1642,106,430,536,536,True
14320,2012-08-24,3,1,8,20,0,5,1,2,0.7,0.6515,0.65,0.2239,66,297,363,363,True
14321,2012-08-24,3,1,8,21,0,5,1,2,0.7,0.6515,0.61,0.1642,58,248,306,306,True
14322,2012-08-24,3,1,8,22,0,5,1,2,0.7,0.6515,0.61,0.0,42,209,251,251,True
14323,2012-08-24,3,1,8,23,0,5,1,2,0.68,0.6364,0.69,0.0896,38,140,178,178,True
14324,2012-08-25,3,1,8,0,0,6,0,2,0.7,0.6515,0.61,0.0,21,114,135,135,True
14325,2012-08-25,3,1,8,1,0,6,0,2,0.68,0.6364,0.69,0.0,15,100,115,115,True
14326,2012-08-25,3,1,8,2,0,6,0,2,0.66,0.6212,0.74,0.0896,18,61,79,79,True
14327,2012-08-25,3,1,8,3,0,6,0,1,0.66,0.6212,0.69,0.0896,7,31,38,38,True
14328,2012-08-25,3,1,8,4,0,6,0,2,0.66,0.6212,0.69,0.1045,3,9,12,12,True
14329,2012-08-25,3,1,8,5,0,6,0,2,0.64,0.6061,0.73,0.1642,4,10,14,14,True
14330,2012-08-25,3,1,8,6,0,6,0,2,0.64,0.5909,0.78,0.1642,5,25,30,30,True
14331,2012-08-25,3,1,8,7,0,6,0,2,0.64,0.5909,0.78,0.194,14,88,102,102,True
14332,2012-08-25,3,1,8,8,0,6,0,2,0.66,0.6212,0.74,0.2537,29,133,162,162,True
14333,2012-08-25,3,1,8,9,0,6,0,2,0.68,0.6364,0.69,0.2836,60,228,288,288,True
14334,2012-08-25,3,1,8,10,0,6,0,2,0.7,0.6515,0.65,0.2985,114,294,408,408,True
14335,2012-08-25,3,1,8,11,0,6,0,2,0.72,0.6818,0.62,0.2836,114,314,428,428,True
14336,2012-08-25,3,1,8,12,0,6,0,3,0.72,0.6667,0.54,0.3881,114,367,481,481,True
14337,2012-08-25,3,1,8,13,0,6,0,2,0.72,0.6667,0.51,0.3582,114,331,445,445,True
14338,2012-08-25,3,1,8,14,0,6,0,3,0.66,0.6212,0.65,0.2537,114,332,446,446,True
14339,2012-08-25,3,1,8,15,0,6,0,2,0.64,0.6061,0.73,0.3284,79,154,233,233,True
14340,2012-08-25,3,1,8,16,0,6,0,2,0.66,0.6212,0.74,0.2985,114,260,374,374,True
14341,2012-08-25,3,1,8,17,0,6,0,2,0.66,0.6212,0.74,0.3284,114,271,385,385,True
14342,2012-08-25,3,1,8,18,0,6,0,2,0.66,0.6212,0.69,0.4627,114,261,375,375,True
14343,2012-08-25,3,1,8,19,0,6,0,2,0.64,0.5909,0.78,0.2985,97,257,354,354,True
14344,2012-08-25,3,1,8,20,0,6,0,3,0.62,0.5758,0.83,0.2537,65,176,241,241,True
14345,2012-08-25,3,1,8,21,0,6,0,1,0.62,0.5758,0.83,0.3582,60,148,208,208,True
14346,2012-08-25,3,1,8,22,0,6,0,1,0.62,0.5758,0.83,0.3582,46,136,182,182,True
14347,2012-08-25,3,1,8,23,0,6,0,2,0.62,0.5758,0.83,0.2537,34,124,158,158,True
14348,2012-08-26,3,1,8,0,0,0,0,1,0.64,0.5758,0.89,0.2537,23,111,134,134,True
14349,2012-08-26,3,1,8,1,0,0,0,1,0.64,0.5758,0.89,0.194,18,116,134,134,True
14350,2012-08-26,3,1,8,2,0,0,0,2,0.64,0.5758,0.89,0.2239,12,104,116,116,True
14351,2012-08-26,3,1,8,3,0,0,0,2,0.64,0.5758,0.89,0.2537,11,42,53,53,True
14352,2012-08-26,3,1,8,4,0,0,0,2,0.64,0.5758,0.89,0.194,5,11,16,16,True
14353,2012-08-26,3,1,8,5,0,0,0,1,0.64,0.5758,0.89,0.194,3,13,16,16,True
14354,2012-08-26,3,1,8,6,0,0,0,1,0.62,0.5606,0.88,0.2985,5,16,21,21,True
14355,2012-08-26,3,1,8,7,0,0,0,1,0.64,0.5758,0.89,0.194,11,23,34,34,True
14356,2012-08-26,3,1,8,8,0,0,0,1,0.68,0.6364,0.79,0.2836,21,112,133,133,True
14357,2012-08-26,3,1,8,9,0,0,0,1,0.68,0.6364,0.79,0.2537,67,196,263,263,True
14358,2012-08-26,3,1,8,10,0,0,0,1,0.74,0.697,0.66,0.3881,114,258,372,372,True
14359,2012-08-26,3,1,8,11,0,0,0,1,0.74,0.697,0.66,0.3582,114,332,446,446,True
14360,2012-08-26,3,1,8,12,0,0,0,3,0.72,0.697,0.74,0.3582,114,401,515,515,True
14361,2012-08-26,3,1,8,13,0,0,0,3,0.66,0.6061,0.78,0.4179,114,375,489,489,True
14362,2012-08-26,3,1,8,14,0,0,0,1,0.64,0.5758,0.89,0.1045,114,252,366,366,True
14363,2012-08-26,3,1,8,15,0,0,0,3,0.64,0.5758,0.89,0.2836,114,259,373,373,True
14364,2012-08-26,3,1,8,16,0,0,0,3,0.64,0.5758,0.89,0.2836,57,116,173,173,True
14365,2012-08-26,3,1,8,17,0,0,0,1,0.64,0.5758,0.89,0.2239,61,172,233,233,True
14366,2012-08-26,3,1,8,18,0,0,0,2,0.64,0.5758,0.89,0.0896,77,187,264,264,True
14367,2012-08-26,3,1,8,19,0,0,0,2,0.64,0.5758,0.89,0.1642,80,212,292,292,True
14368,2012-08-26,3,1,8,20,0,0,0,1,0.64,0.5758,0.89,0.1642,40,171,211,211,True
14369,2012-08-26,3,1,8,21,0,0,0,1,0.64,0.5758,0.83,0.1343,26,140,166,166,True
14370,2012-08-26,3,1,8,22,0,0,0,1,0.62,0.5606,0.88,0.0896,20,94,114,114,True
14371,2012-08-26,3,1,8,23,0,0,0,1,0.62,0.5758,0.83,0.0896,21,59,80,80,True
14372,2012-08-27,3,1,8,0,0,1,1,1,0.62,0.5758,0.83,0.0,4,28,32,32,True
14373,2012-08-27,3,1,8,1,0,1,1,1,0.62,0.5606,0.88,0.0896,3,4,7,7,True
14374,2012-08-27,3,1,8,2,0,1,1,1,0.62,0.5606,0.88,0.1343,0,8,8,8,True
14375,2012-08-27,3,1,8,3,0,1,1,1,0.62,0.5606,0.88,0.0896,1,3,4,4,True
14376,2012-08-27,3,1,8,4,0,1,1,1,0.62,0.5758,0.83,0.0,1,11,12,12,True
14377,2012-08-27,3,1,8,5,0,1,1,1,0.62,0.5606,0.88,0.0,4,32,36,36,True
14378,2012-08-27,3,1,8,6,0,1,1,1,0.62,0.5606,0.88,0.0,4,141,145,145,True
14379,2012-08-27,3,1,8,7,0,1,1,1,0.66,0.6061,0.83,0.0,15,418,433,433,True
14380,2012-08-27,3,1,8,8,0,1,1,1,0.66,0.6061,0.83,0.0896,29,499,528,528,True
14381,2012-08-27,3,1,8,9,0,1,1,1,0.66,0.6061,0.83,0.1045,40,302,342,342,True
14382,2012-08-27,3,1,8,10,0,1,1,1,0.72,0.697,0.74,0.1343,63,143,206,206,True
14383,2012-08-27,3,1,8,11,0,1,1,1,0.74,0.697,0.66,0.194,47,182,229,229,True
14384,2012-08-27,3,1,8,12,0,1,1,1,0.76,0.7121,0.62,0.0,69,214,283,283,True
14385,2012-08-27,3,1,8,13,0,1,1,1,0.76,0.7121,0.57,0.1642,77,211,288,288,True
14386,2012-08-27,3,1,8,14,0,1,1,1,0.8,0.7424,0.49,0.0896,66,180,246,246,True
14387,2012-08-27,3,1,8,15,0,1,1,1,0.8,0.7576,0.55,0.2985,77,205,282,282,True
14388,2012-08-27,3,1,8,16,0,1,1,1,0.8,0.7576,0.55,0.2537,77,367,444,444,True
14389,2012-08-27,3,1,8,17,0,1,1,1,0.8,0.7273,0.46,0.2239,101,499,600,600,True
14390,2012-08-27,3,1,8,18,0,1,1,1,0.78,0.7121,0.52,0.2537,83,499,582,582,True
14391,2012-08-27,3,1,8,19,0,1,1,1,0.74,0.697,0.7,0.2239,74,499,573,573,True
14392,2012-08-27,3,1,8,20,0,1,1,1,0.74,0.697,0.7,0.194,50,366,416,416,True
14393,2012-08-27,3,1,8,21,0,1,1,1,0.72,0.697,0.74,0.194,39,239,278,278,True
14394,2012-08-27,3,1,8,22,0,1,1,1,0.7,0.6667,0.84,0.194,30,131,161,161,True
14395,2012-08-27,3,1,8,23,0,1,1,1,0.7,0.6667,0.84,0.1642,35,79,114,114,True
14396,2012-08-28,3,1,8,0,0,2,1,1,0.7,0.6667,0.84,0.2537,9,29,38,38,True
14397,2012-08-28,3,1,8,1,0,2,1,1,0.68,0.6364,0.89,0.194,4,17,21,21,True
14398,2012-08-28,3,1,8,2,0,2,1,1,0.68,0.6364,0.83,0.2537,2,13,15,15,True
14399,2012-08-28,3,1,8,3,0,2,1,1,0.66,0.5909,0.89,0.1343,0,4,4,4,True
14400,2012-08-28,3,1,8,4,0,2,1,1,0.66,0.6061,0.83,0.1343,2,6,8,8,True
14401,2012-08-28,3,1,8,5,0,2,1,2,0.66,0.6061,0.83,0.0896,3,39,42,42,True
14402,2012-08-28,3,1,8,6,0,2,1,2,0.66,0.5909,0.89,0.1045,3,144,147,147,True
14403,2012-08-28,3,1,8,7,0,2,1,2,0.66,0.6061,0.83,0.1045,14,255,269,269,True
14404,2012-08-28,3,1,8,8,0,2,1,2,0.66,0.6212,0.85,0.1045,25,499,524,524,True
14405,2012-08-28,3,1,8,9,0,2,1,2,0.7,0.6667,0.79,0.1642,44,351,395,395,True
14406,2012-08-28,3,1,8,10,0,2,1,1,0.74,0.6818,0.62,0.2537,39,165,204,204,True
14407,2012-08-28,3,1,8,11,0,2,1,1,0.78,0.7273,0.55,0.2537,47,171,218,218,True
14408,2012-08-28,3,1,8,12,0,2,1,1,0.8,0.7424,0.49,0.2836,56,241,297,297,True
14409,2012-08-28,3,1,8,13,0,2,1,1,0.82,0.7424,0.43,0.2985,56,232,288,288,True
14410,2012-08-28,3,1,8,14,0,2,1,1,0.84,0.7424,0.38,0.3284,72,179,251,251,True
14411,2012-08-28,3,1,8,15,0,2,1,1,0.82,0.7273,0.34,0.2985,59,258,317,317,True
14412,2012-08-28,3,1,8,16,0,2,1,1,0.82,0.7121,0.33,0.3284,84,396,480,480,True
14413,2012-08-28,3,1,8,17,0,2,1,1,0.8,0.697,0.35,0.3881,90,499,589,589,True
14414,2012-08-28,3,1,8,18,0,2,1,1,0.78,0.697,0.4,0.2537,82,499,581,581,True
14415,2012-08-28,3,1,8,19,0,2,1,1,0.74,0.6667,0.45,0.1642,82,499,581,581,True
14416,2012-08-28,3,1,8,20,0,2,1,1,0.72,0.6667,0.48,0.1045,87,348,435,435,True
14417,2012-08-28,3,1,8,21,0,2,1,1,0.72,0.6667,0.48,0.0896,38,276,314,314,True
14418,2012-08-28,3,1,8,22,0,2,1,1,0.7,0.6515,0.54,0.0,20,196,216,216,True
14419,2012-08-28,3,1,8,23,0,2,1,1,0.68,0.6364,0.57,0.0,17,92,109,109,True
14420,2012-08-29,3,1,8,0,0,3,1,1,0.66,0.6212,0.69,0.0,8,39,47,47,True
14421,2012-08-29,3,1,8,1,0,3,1,1,0.64,0.6061,0.69,0.1343,2,12,14,14,True
14422,2012-08-29,3,1,8,2,0,3,1,1,0.62,0.5909,0.73,0.1343,2,4,6,6,True
14423,2012-08-29,3,1,8,3,0,3,1,1,0.62,0.5909,0.73,0.1045,0,9,9,9,True
14424,2012-08-29,3,1,8,4,0,3,1,1,0.6,0.5909,0.73,0.2239,2,8,10,10,True
14425,2012-08-29,3,1,8,5,0,3,1,1,0.6,0.5909,0.73,0.194,3,37,40,40,True
14426,2012-08-29,3,1,8,6,0,3,1,1,0.6,0.5909,0.73,0.194,6,175,181,181,True
14427,2012-08-29,3,1,8,7,0,3,1,1,0.64,0.6061,0.65,0.0896,23,499,522,522,True
14428,2012-08-29,3,1,8,8,0,3,1,1,0.66,0.6212,0.61,0.1642,28,499,527,527,True
14429,2012-08-29,3,1,8,9,0,3,1,1,0.7,0.6515,0.51,0.194,40,308,348,348,True
14430,2012-08-29,3,1,8,10,0,3,1,1,0.72,0.6667,0.48,0.1642,34,144,178,178,True
14431,2012-08-29,3,1,8,11,0,3,1,1,0.72,0.6515,0.45,0.0,67,186,253,253,True
14432,2012-08-29,3,1,8,12,0,3,1,1,0.76,0.6818,0.4,0.0,79,281,360,360,True
14433,2012-08-29,3,1,8,13,0,3,1,1,0.74,0.6667,0.42,0.0,68,232,300,300,True
14434,2012-08-29,3,1,8,14,0,3,1,1,0.76,0.6818,0.4,0.0896,87,214,301,301,True
14435,2012-08-29,3,1,8,15,0,3,1,1,0.76,0.6818,0.4,0.194,96,242,338,338,True
14436,2012-08-29,3,1,8,16,0,3,1,1,0.76,0.6667,0.37,0.1343,104,389,493,493,True
14437,2012-08-29,3,1,8,17,0,3,1,1,0.78,0.6818,0.35,0.2239,108,499,607,607,True
14438,2012-08-29,3,1,8,18,0,3,1,1,0.74,0.6667,0.42,0.1642,114,499,613,613,True
14439,2012-08-29,3,1,8,19,0,3,1,1,0.7,0.6515,0.54,0.194,114,499,613,613,True
14440,2012-08-29,3,1,8,20,0,3,1,1,0.68,0.6364,0.57,0.0,49,378,427,427,True
14441,2012-08-29,3,1,8,21,0,3,1,1,0.66,0.6212,0.54,0.1045,48,265,313,313,True
14442,2012-08-29,3,1,8,22,0,3,1,1,0.66,0.6212,0.54,0.0,50,185,235,235,True
14443,2012-08-29,3,1,8,23,0,3,1,1,0.66,0.6212,0.57,0.0,34,123,157,157,True
14444,2012-08-30,3,1,8,0,0,4,1,1,0.64,0.6061,0.69,0.0,14,51,65,65,True
14445,2012-08-30,3,1,8,1,0,4,1,1,0.64,0.6061,0.65,0.0,6,17,23,23,True
14446,2012-08-30,3,1,8,2,0,4,1,1,0.62,0.5909,0.73,0.0,3,14,17,17,True
14447,2012-08-30,3,1,8,3,0,4,1,1,0.62,0.5909,0.73,0.0,0,5,5,5,True
14448,2012-08-30,3,1,8,4,0,4,1,1,0.62,0.5909,0.73,0.0,4,4,8,8,True
14449,2012-08-30,3,1,8,5,0,4,1,1,0.62,0.5909,0.73,0.0,2,33,35,35,True
14450,2012-08-30,3,1,8,6,0,4,1,1,0.6,0.5606,0.83,0.1642,8,155,163,163,True
14451,2012-08-30,3,1,8,7,0,4,1,1,0.64,0.6061,0.73,0.0,31,499,530,530,True
14452,2012-08-30,3,1,8,8,0,4,1,1,0.66,0.6212,0.65,0.0,53,499,552,552,True
14453,2012-08-30,3,1,8,9,0,4,1,1,0.7,0.6515,0.58,0.0,57,339,396,396,True
14454,2012-08-30,3,1,8,10,0,4,1,1,0.72,0.6667,0.54,0.0,73,161,234,234,True
14455,2012-08-30,3,1,8,11,0,4,1,1,0.76,0.6818,0.4,0.0896,85,191,276,276,True
14456,2012-08-30,3,1,8,12,0,4,1,1,0.76,0.6818,0.45,0.1343,73,221,294,294,True
14457,2012-08-30,3,1,8,13,0,4,1,1,0.76,0.6818,0.48,0.1045,76,214,290,290,True
14458,2012-08-30,3,1,8,14,0,4,1,1,0.76,0.6818,0.48,0.1343,74,199,273,273,True
14459,2012-08-30,3,1,8,15,0,4,1,1,0.8,0.7273,0.46,0.1642,99,239,338,338,True
14460,2012-08-30,3,1,8,16,0,4,1,1,0.8,0.7273,0.43,0.1642,77,405,482,482,True
14461,2012-08-30,3,1,8,17,0,4,1,1,0.82,0.7273,0.34,0.2239,93,499,592,592,True
14462,2012-08-30,3,1,8,18,0,4,1,1,0.8,0.7121,0.38,0.1343,109,499,608,608,True
14463,2012-08-30,3,1,8,19,0,4,1,1,0.76,0.6818,0.48,0.1343,78,499,577,577,True
14464,2012-08-30,3,1,8,20,0,4,1,1,0.74,0.6818,0.58,0.1642,68,403,471,471,True
14465,2012-08-30,3,1,8,21,0,4,1,1,0.72,0.6818,0.66,0.1343,32,275,307,307,True
14466,2012-08-30,3,1,8,22,0,4,1,1,0.7,0.6515,0.7,0.0,38,253,291,291,True
14467,2012-08-30,3,1,8,23,0,4,1,1,0.7,0.6667,0.74,0.1045,19,133,152,152,True
14468,2012-08-31,3,1,8,0,0,5,1,1,0.68,0.6364,0.83,0.1642,13,69,82,82,True
14469,2012-08-31,3,1,8,1,0,5,1,1,0.68,0.6364,0.83,0.1642,8,24,32,32,True
14470,2012-08-31,3,1,8,2,0,5,1,1,0.66,0.5909,0.89,0.1343,9,11,20,20,True
14471,2012-08-31,3,1,8,3,0,5,1,1,0.66,0.5909,0.89,0.1045,3,2,5,5,True
14472,2012-08-31,3,1,8,4,0,5,1,1,0.64,0.5758,0.89,0.1343,0,7,7,7,True
14473,2012-08-31,3,1,8,5,0,5,1,1,0.64,0.5758,0.89,0.1642,2,27,29,29,True
14474,2012-08-31,3,1,8,6,0,5,1,2,0.64,0.5758,0.89,0.1642,7,101,108,108,True
14475,2012-08-31,3,1,8,7,0,5,1,2,0.64,0.5758,0.89,0.0896,21,400,421,421,True
14476,2012-08-31,3,1,8,8,0,5,1,2,0.7,0.6667,0.74,0.0,36,499,535,535,True
14477,2012-08-31,3,1,8,9,0,5,1,1,0.74,0.697,0.7,0.0,61,337,398,398,True
14478,2012-08-31,3,1,8,10,0,5,1,1,0.76,0.7121,0.62,0.0896,59,197,256,256,True
14479,2012-08-31,3,1,8,11,0,5,1,1,0.86,0.7424,0.28,0.2985,88,221,309,309,True
14480,2012-08-31,3,1,8,12,0,5,1,1,0.86,0.7424,0.26,0.2537,114,290,404,404,True
14481,2012-08-31,3,1,8,13,0,5,1,1,0.88,0.7576,0.27,0.3284,97,271,368,368,True
14482,2012-08-31,3,1,8,14,0,5,1,1,0.9,0.7727,0.25,0.2239,112,324,436,436,True
14483,2012-08-31,3,1,8,15,0,5,1,1,0.9,0.7879,0.27,0.2985,109,417,526,526,True
14484,2012-08-31,3,1,8,16,0,5,1,1,0.9,0.7879,0.27,0.2537,111,417,528,528,True
14485,2012-08-31,3,1,8,17,0,5,1,1,0.88,0.7727,0.32,0.1642,114,488,602,602,True
14486,2012-08-31,3,1,8,18,0,5,1,1,0.86,0.7576,0.36,0.2537,87,459,546,546,True
14487,2012-08-31,3,1,8,19,0,5,1,1,0.8,0.7424,0.49,0.1343,91,361,452,452,True
14488,2012-08-31,3,1,8,20,0,5,1,1,0.8,0.7424,0.49,0.1343,102,254,356,356,True
14489,2012-08-31,3,1,8,21,0,5,1,1,0.76,0.7121,0.58,0.194,71,232,303,303,True
14490,2012-08-31,3,1,8,22,0,5,1,1,0.76,0.7121,0.58,0.194,65,212,277,277,True
14491,2012-08-31,3,1,8,23,0,5,1,1,0.74,0.6818,0.62,0.1045,32,142,174,174,True
14492,2012-09-01,3,1,9,0,0,6,0,1,0.74,0.6818,0.62,0.1045,22,146,168,168,True
14493,2012-09-01,3,1,9,1,0,6,0,1,0.72,0.697,0.74,0.1343,11,68,79,79,True
14494,2012-09-01,3,1,9,2,0,6,0,1,0.7,0.6515,0.7,0.1642,8,61,69,69,True
14495,2012-09-01,3,1,9,3,0,6,0,1,0.7,0.6515,0.7,0.1045,6,29,35,35,True
14496,2012-09-01,3,1,9,4,0,6,0,1,0.7,0.6515,0.7,0.0,3,9,12,12,True
14497,2012-09-01,3,1,9,5,0,6,0,1,0.68,0.6364,0.79,0.0,2,20,22,22,True
14498,2012-09-01,3,1,9,6,0,6,0,1,0.68,0.6364,0.79,0.0,13,23,36,36,True
14499,2012-09-01,3,1,9,7,0,6,0,2,0.74,0.6818,0.58,0.1343,8,58,66,66,True
14500,2012-09-01,3,1,9,8,0,6,0,2,0.76,0.7121,0.58,0.2537,28,134,162,162,True
14501,2012-09-01,3,1,9,9,0,6,0,2,0.76,0.7121,0.58,0.194,62,175,237,237,True
14502,2012-09-01,3,1,9,10,0,6,0,2,0.78,0.7273,0.55,0.194,114,289,403,403,True
14503,2012-09-01,3,1,9,11,0,6,0,2,0.8,0.7576,0.55,0.2239,114,273,387,387,True
14504,2012-09-01,3,1,9,12,0,6,0,2,0.8,0.7576,0.55,0.1642,114,284,398,398,True
14505,2012-09-01,3,1,9,13,0,6,0,2,0.82,0.7727,0.52,0.0896,114,267,381,381,True
14506,2012-09-01,3,1,9,14,0,6,0,2,0.86,0.7879,0.44,0.1642,114,274,388,388,True
14507,2012-09-01,3,1,9,15,0,6,0,2,0.86,0.7879,0.44,0.2836,114,306,420,420,True
14508,2012-09-01,3,1,9,16,0,6,0,2,0.84,0.7879,0.49,0.1642,114,253,367,367,True
14509,2012-09-01,3,1,9,17,0,6,0,2,0.82,0.7727,0.52,0.0,114,258,372,372,True
14510,2012-09-01,3,1,9,18,0,6,0,2,0.82,0.7727,0.52,0.0,114,258,372,372,True
14511,2012-09-01,3,1,9,19,0,6,0,3,0.78,0.7424,0.62,0.0,114,235,349,349,True
14512,2012-09-01,3,1,9,20,0,6,0,3,0.76,0.7273,0.67,0.2537,67,140,207,207,True
14513,2012-09-01,3,1,9,21,0,6,0,3,0.64,0.5758,0.89,0.0,21,83,104,104,True
14514,2012-09-01,3,1,9,22,0,6,0,2,0.66,0.5909,0.89,0.0,21,57,78,78,True
14515,2012-09-01,3,1,9,23,0,6,0,1,0.66,0.5909,0.89,0.0896,57,88,145,145,True
14516,2012-09-02,3,1,9,0,0,0,0,2,0.66,0.5909,0.89,0.0896,27,72,99,99,True
14517,2012-09-02,3,1,9,1,0,0,0,1,0.66,0.5909,0.89,0.0,15,58,73,73,True
14518,2012-09-02,3,1,9,2,0,0,0,1,0.66,0.5909,0.89,0.0,28,56,84,84,True
14519,2012-09-02,3,1,9,3,0,0,0,1,0.66,0.5909,0.89,0.0896,9,33,42,42,True
14520,2012-09-02,3,1,9,4,0,0,0,1,0.66,0.5909,0.89,0.0,7,15,22,22,True
14521,2012-09-02,3,1,9,5,0,0,0,1,0.66,0.5909,0.89,0.0,2,10,12,12,True
14522,2012-09-02,3,1,9,6,0,0,0,2,0.66,0.5909,0.89,0.0,2,13,15,15,True
14523,2012-09-02,3,1,9,7,0,0,0,1,0.66,0.5909,0.94,0.0896,13,29,42,42,True
14524,2012-09-02,3,1,9,8,0,0,0,1,0.68,0.6364,0.89,0.0896,30,99,129,129,True
14525,2012-09-02,3,1,9,9,0,0,0,2,0.7,0.6667,0.84,0.0,88,144,232,232,True
14526,2012-09-02,3,1,9,10,0,0,0,2,0.72,0.697,0.79,0.0,114,230,344,344,True
14527,2012-09-02,3,1,9,11,0,0,0,2,0.74,0.697,0.7,0.0,114,263,377,377,True
14528,2012-09-02,3,1,9,12,0,0,0,3,0.74,0.697,0.7,0.0,114,297,411,411,True
14529,2012-09-02,3,1,9,13,0,0,0,3,0.72,0.697,0.74,0.0896,114,230,344,344,True
14530,2012-09-02,3,1,9,14,0,0,0,3,0.72,0.697,0.79,0.0896,114,208,322,322,True
14531,2012-09-02,3,1,9,15,0,0,0,3,0.74,0.7121,0.74,0.1343,114,176,290,290,True
14532,2012-09-02,3,1,9,16,0,0,0,1,0.74,0.697,0.7,0.0,114,252,366,366,True
14533,2012-09-02,3,1,9,17,0,0,0,1,0.76,0.7273,0.66,0.0896,114,284,398,398,True
14534,2012-09-02,3,1,9,18,0,0,0,1,0.74,0.7121,0.74,0.0,114,273,387,387,True
14535,2012-09-02,3,1,9,19,0,0,0,2,0.7,0.6667,0.84,0.2239,114,152,266,266,True
14536,2012-09-02,3,1,9,20,0,0,0,2,0.7,0.6667,0.84,0.1642,63,41,104,104,True
14537,2012-09-02,3,1,9,21,0,0,0,1,0.7,0.6515,0.7,0.1642,79,92,171,171,True
14538,2012-09-02,3,1,9,22,0,0,0,3,0.68,0.6364,0.83,0.1343,66,100,166,166,True
14539,2012-09-02,3,1,9,23,0,0,0,3,0.66,0.5909,0.89,0.0896,53,70,123,123,True
14540,2012-09-03,3,1,9,0,1,1,0,2,0.66,0.5909,0.94,0.0,42,62,104,104,True
14541,2012-09-03,3,1,9,1,1,1,0,2,0.68,0.6364,0.89,0.1642,18,37,55,55,True
14542,2012-09-03,3,1,9,2,1,1,0,1,0.66,0.5909,0.89,0.1045,10,30,40,40,True
14543,2012-09-03,3,1,9,3,1,1,0,1,0.66,0.5909,0.89,0.1343,6,22,28,28,True
14544,2012-09-03,3,1,9,4,1,1,0,1,0.66,0.5909,0.89,0.0896,6,5,11,11,True
14545,2012-09-03,3,1,9,5,1,1,0,1,0.66,0.5909,0.89,0.0,1,3,4,4,True
14546,2012-09-03,3,1,9,6,1,1,0,1,0.66,0.5909,0.94,0.0,3,12,15,15,True
14547,2012-09-03,3,1,9,7,1,1,0,1,0.68,0.6364,0.85,0.0,6,37,43,43,True
14548,2012-09-03,3,1,9,8,1,1,0,2,0.7,0.6667,0.84,0.1045,36,91,127,127,True
14549,2012-09-03,3,1,9,9,1,1,0,2,0.7,0.6667,0.84,0.1343,71,158,229,229,True
14550,2012-09-03,3,1,9,10,1,1,0,2,0.74,0.7121,0.74,0.2239,114,224,338,338,True
14551,2012-09-03,3,1,9,11,1,1,0,2,0.74,0.697,0.7,0.2836,114,272,386,386,True
14552,2012-09-03,3,1,9,12,1,1,0,2,0.76,0.7121,0.62,0.2985,114,352,466,466,True
14553,2012-09-03,3,1,9,13,1,1,0,2,0.76,0.7273,0.66,0.2537,114,357,471,471,True
14554,2012-09-03,3,1,9,14,1,1,0,1,0.74,0.697,0.7,0.2985,114,349,463,463,True
14555,2012-09-03,3,1,9,15,1,1,0,1,0.74,0.697,0.7,0.2239,114,281,395,395,True
14556,2012-09-03,3,1,9,16,1,1,0,1,0.74,0.697,0.7,0.2239,114,335,449,449,True
14557,2012-09-03,3,1,9,17,1,1,0,1,0.74,0.697,0.7,0.1343,114,317,431,431,True
14558,2012-09-03,3,1,9,18,1,1,0,1,0.74,0.697,0.66,0.1642,114,337,451,451,True
14559,2012-09-03,3,1,9,19,1,1,0,1,0.72,0.697,0.74,0.194,73,301,374,374,True
14560,2012-09-03,3,1,9,20,1,1,0,1,0.72,0.6818,0.76,0.1045,78,183,261,261,True
14561,2012-09-03,3,1,9,21,1,1,0,1,0.72,0.6818,0.76,0.1045,42,142,184,184,True
14562,2012-09-03,3,1,9,22,1,1,0,2,0.7,0.6667,0.84,0.1343,17,104,121,121,True
14563,2012-09-03,3,1,9,23,1,1,0,2,0.7,0.6667,0.84,0.2537,12,58,70,70,True
14564,2012-09-04,3,1,9,0,0,2,1,2,0.7,0.6667,0.84,0.2537,10,19,29,29,True
14565,2012-09-04,3,1,9,1,0,2,1,1,0.68,0.6364,0.82,0.1343,15,9,24,24,True
14566,2012-09-04,3,1,9,2,0,2,1,1,0.68,0.6364,0.82,0.1343,1,4,5,5,True
14567,2012-09-04,3,1,9,3,0,2,1,2,0.66,0.5909,0.89,0.0896,1,9,10,10,True
14568,2012-09-04,3,1,9,4,0,2,1,2,0.66,0.5909,0.89,0.0,0,8,8,8,True
14569,2012-09-04,3,1,9,5,0,2,1,2,0.66,0.5909,0.89,0.0,1,37,38,38,True
14570,2012-09-04,3,1,9,6,0,2,1,2,0.68,0.6364,0.89,0.1045,7,165,172,172,True
14571,2012-09-04,3,1,9,7,0,2,1,2,0.68,0.6364,0.89,0.1045,13,480,493,493,True
14572,2012-09-04,3,1,9,8,0,2,1,1,0.7,0.6667,0.84,0.1642,15,499,514,514,True
14573,2012-09-04,3,1,9,9,0,2,1,2,0.72,0.697,0.79,0.2239,30,293,323,323,True
14574,2012-09-04,3,1,9,10,0,2,1,2,0.72,0.697,0.74,0.2537,42,130,172,172,True
14575,2012-09-04,3,1,9,11,0,2,1,2,0.74,0.697,0.7,0.2836,39,159,198,198,True
14576,2012-09-04,3,1,9,12,0,2,1,1,0.76,0.7273,0.7,0.2836,54,233,287,287,True
14577,2012-09-04,3,1,9,13,0,2,1,1,0.8,0.7576,0.55,0.4478,72,203,275,275,True
14578,2012-09-04,3,1,9,14,0,2,1,1,0.8,0.7576,0.55,0.4179,72,202,274,274,True
14579,2012-09-04,3,1,9,15,0,2,1,1,0.8,0.7727,0.59,0.4627,68,224,292,292,True
14580,2012-09-04,3,1,9,16,0,2,1,1,0.76,0.7273,0.7,0.4179,61,397,458,458,True
14581,2012-09-04,3,1,9,17,0,2,1,1,0.76,0.7273,0.7,0.3582,110,499,609,609,True
14582,2012-09-04,3,1,9,18,0,2,1,1,0.76,0.7424,0.75,0.2239,94,499,593,593,True
14583,2012-09-04,3,1,9,19,0,2,1,1,0.76,0.7273,0.7,0.2239,50,499,549,549,True
14584,2012-09-04,3,1,9,20,0,2,1,1,0.74,0.697,0.7,0.2537,47,338,385,385,True
14585,2012-09-04,3,1,9,21,0,2,1,1,0.74,0.7121,0.74,0.2537,28,240,268,268,True
14586,2012-09-04,3,1,9,22,0,2,1,1,0.74,0.697,0.7,0.2836,25,154,179,179,True
14587,2012-09-04,3,1,9,23,0,2,1,1,0.72,0.697,0.74,0.2985,12,83,95,95,True
14588,2012-09-05,3,1,9,0,0,3,1,1,0.72,0.697,0.74,0.2537,10,27,37,37,True
14589,2012-09-05,3,1,9,1,0,3,1,1,0.7,0.6667,0.84,0.194,2,11,13,13,True
14590,2012-09-05,3,1,9,2,0,3,1,1,0.7,0.6667,0.84,0.194,0,9,9,9,True
14591,2012-09-05,3,1,9,3,0,3,1,1,0.7,0.6667,0.79,0.2836,0,4,4,4,True
14592,2012-09-05,3,1,9,4,0,3,1,1,0.7,0.6667,0.79,0.2836,2,3,5,5,True
14593,2012-09-05,3,1,9,5,0,3,1,2,0.7,0.6667,0.79,0.2985,1,39,40,40,True
14594,2012-09-05,3,1,9,6,0,3,1,1,0.7,0.6667,0.79,0.2836,7,203,210,210,True
14595,2012-09-05,3,1,9,7,0,3,1,2,0.7,0.6667,0.79,0.2537,11,489,500,500,True
14596,2012-09-05,3,1,9,8,0,3,1,1,0.72,0.697,0.74,0.194,33,499,532,532,True
14597,2012-09-05,3,1,9,9,0,3,1,1,0.74,0.697,0.7,0.2537,27,263,290,290,True
14598,2012-09-05,3,1,9,10,0,3,1,2,0.76,0.7273,0.7,0.1642,54,181,235,235,True
14599,2012-09-05,3,1,9,11,0,3,1,2,0.78,0.7424,0.62,0.1642,61,156,217,217,True
14600,2012-09-05,3,1,9,12,0,3,1,1,0.78,0.7727,0.7,0.1045,49,217,266,266,True
14601,2012-09-05,3,1,9,13,0,3,1,1,0.8,0.7879,0.63,0.1642,50,184,234,234,True
14602,2012-09-05,3,1,9,14,0,3,1,1,0.82,0.7879,0.56,0.1045,34,177,211,211,True
14603,2012-09-05,3,1,9,15,0,3,1,1,0.78,0.7727,0.7,0.194,41,204,245,245,True
14604,2012-09-05,3,1,9,16,0,3,1,1,0.76,0.7273,0.7,0.2537,86,344,430,430,True
14605,2012-09-05,3,1,9,17,0,3,1,1,0.76,0.7273,0.66,0.2537,83,499,582,582,True
14606,2012-09-05,3,1,9,18,0,3,1,1,0.76,0.7424,0.75,0.194,82,499,581,581,True
14607,2012-09-05,3,1,9,19,0,3,1,1,0.74,0.697,0.7,0.1642,64,499,563,563,True
14608,2012-09-05,3,1,9,20,0,3,1,1,0.72,0.7121,0.84,0.1642,55,357,412,412,True
14609,2012-09-05,3,1,9,21,0,3,1,1,0.72,0.697,0.79,0.0,18,278,296,296,True
14610,2012-09-05,3,1,9,22,0,3,1,1,0.72,0.697,0.79,0.0,38,181,219,219,True
14611,2012-09-05,3,1,9,23,0,3,1,1,0.7,0.6667,0.84,0.0896,24,126,150,150,True
14612,2012-09-06,3,1,9,0,0,4,1,2,0.7,0.6667,0.84,0.0896,30,35,65,65,True
14613,2012-09-06,3,1,9,1,0,4,1,2,0.7,0.6667,0.84,0.0,2,16,18,18,True
14614,2012-09-06,3,1,9,2,0,4,1,1,0.72,0.697,0.79,0.0,1,7,8,8,True
14615,2012-09-06,3,1,9,3,0,4,1,1,0.7,0.6667,0.84,0.1045,0,9,9,9,True
14616,2012-09-06,3,1,9,4,0,4,1,2,0.7,0.6667,0.84,0.0896,0,8,8,8,True
14617,2012-09-06,3,1,9,5,0,4,1,2,0.7,0.6667,0.84,0.194,3,35,38,38,True
14618,2012-09-06,3,1,9,6,0,4,1,2,0.7,0.6667,0.84,0.0896,11,189,200,200,True
14619,2012-09-06,3,1,9,7,0,4,1,2,0.7,0.6667,0.84,0.1045,21,461,482,482,True
14620,2012-09-06,3,1,9,8,0,4,1,3,0.7,0.6667,0.79,0.0,24,499,523,523,True
14621,2012-09-06,3,1,9,9,0,4,1,3,0.66,0.5909,0.94,0.1343,8,115,123,123,True
14622,2012-09-06,3,1,9,10,0,4,1,3,0.66,0.5909,0.94,0.1343,9,40,49,49,True
14623,2012-09-06,3,1,9,11,0,4,1,3,0.7,0.6667,0.84,0.1642,10,52,62,62,True
14624,2012-09-06,3,1,9,12,0,4,1,2,0.72,0.697,0.79,0.2239,11,126,137,137,True
14625,2012-09-06,3,1,9,13,0,4,1,2,0.72,0.697,0.79,0.1045,39,152,191,191,True
14626,2012-09-06,3,1,9,14,0,4,1,1,0.74,0.7121,0.74,0.0896,38,178,216,216,True
14627,2012-09-06,3,1,9,15,0,4,1,1,0.74,0.697,0.66,0.194,42,228,270,270,True
14628,2012-09-06,3,1,9,16,0,4,1,1,0.74,0.697,0.7,0.2239,42,374,416,416,True
14629,2012-09-06,3,1,9,17,0,4,1,1,0.74,0.697,0.7,0.2537,67,499,566,566,True
14630,2012-09-06,3,1,9,18,0,4,1,1,0.72,0.6818,0.7,0.2537,74,499,573,573,True
14631,2012-09-06,3,1,9,19,0,4,1,1,0.68,0.6364,0.74,0.2537,54,499,553,553,True
14632,2012-09-06,3,1,9,20,0,4,1,1,0.66,0.6061,0.78,0.2239,50,356,406,406,True
14633,2012-09-06,3,1,9,21,0,4,1,1,0.64,0.5758,0.89,0.1642,32,240,272,272,True
14634,2012-09-06,3,1,9,22,0,4,1,1,0.64,0.5758,0.89,0.1642,24,193,217,217,True
14635,2012-09-06,3,1,9,23,0,4,1,1,0.64,0.5758,0.89,0.1642,19,150,169,169,True
14636,2012-09-07,3,1,9,0,0,5,1,1,0.64,0.5758,0.89,0.1343,17,79,96,96,True
14637,2012-09-07,3,1,9,1,0,5,1,1,0.62,0.5606,0.88,0.1045,10,19,29,29,True
14638,2012-09-07,3,1,9,2,0,5,1,1,0.62,0.5758,0.83,0.0896,1,10,11,11,True
14639,2012-09-07,3,1,9,3,0,5,1,1,0.62,0.5758,0.83,0.0896,0,9,9,9,True
14640,2012-09-07,3,1,9,4,0,5,1,1,0.62,0.5606,0.88,0.0,1,7,8,8,True
14641,2012-09-07,3,1,9,5,0,5,1,1,0.62,0.5606,0.88,0.0,1,39,40,40,True
14642,2012-09-07,3,1,9,6,0,5,1,1,0.62,0.5606,0.88,0.1045,5,135,140,140,True
14643,2012-09-07,3,1,9,7,0,5,1,1,0.64,0.5758,0.89,0.1045,21,465,486,486,True
14644,2012-09-07,3,1,9,8,0,5,1,1,0.66,0.6061,0.83,0.1045,29,499,528,528,True
14645,2012-09-07,3,1,9,9,0,5,1,1,0.7,0.6667,0.79,0.1343,33,311,344,344,True
14646,2012-09-07,3,1,9,10,0,5,1,1,0.72,0.697,0.74,0.1343,53,171,224,224,True
14647,2012-09-07,3,1,9,11,0,5,1,1,0.76,0.7121,0.62,0.1343,81,215,296,296,True
14648,2012-09-07,3,1,9,12,0,5,1,1,0.78,0.7424,0.59,0.1642,76,247,323,323,True
14649,2012-09-07,3,1,9,13,0,5,1,1,0.8,0.7727,0.59,0.2537,71,283,354,354,True
14650,2012-09-07,3,1,9,14,0,5,1,1,0.8,0.7727,0.59,0.2537,66,187,253,253,True
14651,2012-09-07,3,1,9,15,0,5,1,1,0.8,0.7576,0.55,0.2537,66,265,331,331,True
14652,2012-09-07,3,1,9,16,0,5,1,1,0.8,0.7576,0.55,0.2836,75,395,470,470,True
14653,2012-09-07,3,1,9,17,0,5,1,1,0.78,0.7424,0.59,0.3284,88,499,587,587,True
14654,2012-09-07,3,1,9,18,0,5,1,1,0.76,0.7121,0.62,0.2985,95,499,594,594,True
14655,2012-09-07,3,1,9,19,0,5,1,1,0.74,0.6818,0.62,0.2836,70,498,568,568,True
14656,2012-09-07,3,1,9,20,0,5,1,1,0.72,0.6818,0.66,0.2239,51,340,391,391,True
14657,2012-09-07,3,1,9,21,0,5,1,1,0.7,0.6667,0.74,0.1642,55,246,301,301,True
14658,2012-09-07,3,1,9,22,0,5,1,1,0.7,0.6667,0.74,0.2239,52,247,299,299,True
14659,2012-09-07,3,1,9,23,0,5,1,1,0.66,0.5909,0.89,0.2537,28,220,248,248,True
14660,2012-09-08,3,1,9,0,0,6,0,1,0.66,0.5909,0.89,0.2537,20,130,150,150,True
14661,2012-09-08,3,1,9,1,0,6,0,2,0.66,0.5909,0.89,0.2836,10,107,117,117,True
14662,2012-09-08,3,1,9,2,0,6,0,1,0.66,0.5909,0.89,0.3284,9,68,77,77,True
14663,2012-09-08,3,1,9,3,0,6,0,2,0.66,0.5909,0.89,0.2239,3,40,43,43,True
14664,2012-09-08,3,1,9,4,0,6,0,2,0.66,0.5909,0.94,0.2239,3,8,11,11,True
14665,2012-09-08,3,1,9,5,0,6,0,2,0.66,0.5909,0.94,0.2537,2,13,15,15,True
14666,2012-09-08,3,1,9,6,0,6,0,2,0.66,0.5909,0.89,0.2836,8,26,34,34,True
14667,2012-09-08,3,1,9,7,0,6,0,1,0.66,0.5909,0.89,0.2836,11,71,82,82,True
14668,2012-09-08,3,1,9,8,0,6,0,1,0.7,0.6667,0.79,0.3284,33,197,230,230,True
14669,2012-09-08,3,1,9,9,0,6,0,1,0.7,0.6667,0.74,0.3881,87,261,348,348,True
14670,2012-09-08,3,1,9,10,0,6,0,1,0.74,0.697,0.7,0.3881,100,322,422,422,True
14671,2012-09-08,3,1,9,11,0,6,0,1,0.76,0.7121,0.62,0.4478,114,405,519,519,True
14672,2012-09-08,3,1,9,12,0,6,0,1,0.8,0.7576,0.55,0.4775,114,474,588,588,True
14673,2012-09-08,3,1,9,13,0,6,0,1,0.82,0.7727,0.52,0.4775,114,435,549,549,True
14674,2012-09-08,3,1,9,14,0,6,0,1,0.82,0.7727,0.52,0.4478,114,366,480,480,True
14675,2012-09-08,3,1,9,15,0,6,0,3,0.56,0.5303,0.88,0.2537,114,337,451,451,True
14676,2012-09-08,3,1,9,16,0,6,0,3,0.56,0.5303,0.88,0.194,19,95,114,114,True
14677,2012-09-08,3,1,9,17,0,6,0,3,0.58,0.5455,0.83,0.194,52,119,171,171,True
14678,2012-09-08,3,1,9,18,0,6,0,3,0.58,0.5455,0.83,0.1343,27,140,167,167,True
14679,2012-09-08,3,1,9,19,0,6,0,3,0.58,0.5455,0.88,0.1045,28,187,215,215,True
14680,2012-09-08,3,1,9,20,0,6,0,2,0.58,0.5455,0.88,0.0896,28,166,194,194,True
14681,2012-09-08,3,1,9,21,0,6,0,2,0.6,0.5606,0.83,0.1642,26,155,181,181,True
14682,2012-09-08,3,1,9,22,0,6,0,2,0.58,0.5455,0.78,0.2985,18,176,194,194,True
14683,2012-09-08,3,1,9,23,0,6,0,2,0.58,0.5455,0.73,0.1642,12,121,133,133,True
14684,2012-09-09,3,1,9,0,0,0,0,2,0.56,0.5303,0.73,0.194,18,106,124,124,True
14685,2012-09-09,3,1,9,1,0,0,0,1,0.56,0.5303,0.73,0.2239,20,104,124,124,True
14686,2012-09-09,3,1,9,2,0,0,0,1,0.54,0.5152,0.77,0.2836,15,81,96,96,True
14687,2012-09-09,3,1,9,3,0,0,0,1,0.54,0.5152,0.73,0.2239,14,32,46,46,True
14688,2012-09-09,3,1,9,4,0,0,0,1,0.52,0.5,0.77,0.2537,12,16,28,28,True
14689,2012-09-09,3,1,9,5,0,0,0,1,0.52,0.5,0.77,0.194,16,39,55,55,True
14690,2012-09-09,3,1,9,6,0,0,0,1,0.52,0.5,0.77,0.194,11,24,35,35,True
14691,2012-09-09,3,1,9,7,0,0,0,1,0.54,0.5152,0.73,0.1642,20,50,70,70,True
14692,2012-09-09,3,1,9,8,0,0,0,1,0.58,0.5455,0.68,0.2239,27,143,170,170,True
14693,2012-09-09,3,1,9,9,0,0,0,1,0.62,0.6061,0.61,0.2537,85,214,299,299,True
14694,2012-09-09,3,1,9,10,0,0,0,1,0.64,0.6212,0.57,0.2985,114,323,437,437,True
14695,2012-09-09,3,1,9,11,0,0,0,1,0.66,0.6212,0.47,0.2537,114,391,505,505,True
14696,2012-09-09,3,1,9,12,0,0,0,1,0.66,0.6212,0.47,0.0,114,499,613,613,True
14697,2012-09-09,3,1,9,13,0,0,0,1,0.68,0.6364,0.39,0.0,114,491,605,605,True
14698,2012-09-09,3,1,9,14,0,0,0,1,0.72,0.6515,0.3,0.2836,114,415,529,529,True
14699,2012-09-09,3,1,9,15,0,0,0,1,0.72,0.6515,0.32,0.2537,114,412,526,526,True
14700,2012-09-09,3,1,9,16,0,0,0,1,0.68,0.6364,0.36,0.2836,114,473,587,587,True
14701,2012-09-09,3,1,9,17,0,0,0,1,0.7,0.6364,0.37,0.2537,114,458,572,572,True
14702,2012-09-09,3,1,9,18,0,0,0,1,0.66,0.6212,0.36,0.2537,114,404,518,518,True
14703,2012-09-09,3,1,9,19,0,0,0,1,0.66,0.6212,0.36,0.2537,114,362,476,476,True
14704,2012-09-09,3,1,9,20,0,0,0,1,0.62,0.6212,0.41,0.2836,91,265,356,356,True
14705,2012-09-09,3,1,9,21,0,0,0,1,0.6,0.6212,0.46,0.2239,57,149,206,206,True
14706,2012-09-09,3,1,9,22,0,0,0,1,0.58,0.5455,0.49,0.2537,64,125,189,189,True
14707,2012-09-09,3,1,9,23,0,0,0,1,0.56,0.5303,0.52,0.2836,22,70,92,92,True
14708,2012-09-10,3,1,9,0,0,1,1,1,0.56,0.5303,0.52,0.2836,6,35,41,41,True
14709,2012-09-10,3,1,9,1,0,1,1,1,0.54,0.5152,0.6,0.194,7,11,18,18,True
14710,2012-09-10,3,1,9,2,0,1,1,1,0.54,0.5152,0.6,0.3582,11,6,17,17,True
14711,2012-09-10,3,1,9,3,0,1,1,1,0.52,0.5,0.68,0.2836,5,7,12,12,True
14712,2012-09-10,3,1,9,4,0,1,1,1,0.52,0.5,0.68,0.2836,1,4,5,5,True
14713,2012-09-10,3,1,9,5,0,1,1,1,0.5,0.4848,0.72,0.2537,4,36,40,40,True
14714,2012-09-10,3,1,9,6,0,1,1,1,0.5,0.4848,0.72,0.1343,8,172,180,180,True
14715,2012-09-10,3,1,9,7,0,1,1,1,0.52,0.5,0.68,0.2239,20,427,447,447,True
14716,2012-09-10,3,1,9,8,0,1,1,1,0.56,0.5303,0.6,0.2836,33,499,532,532,True
14717,2012-09-10,3,1,9,9,0,1,1,1,0.6,0.6212,0.53,0.2985,40,321,361,361,True
14718,2012-09-10,3,1,9,10,0,1,1,1,0.62,0.6212,0.5,0.2836,42,168,210,210,True
14719,2012-09-10,3,1,9,11,0,1,1,1,0.62,0.6212,0.43,0.2985,69,167,236,236,True
14720,2012-09-10,3,1,9,12,0,1,1,1,0.64,0.6212,0.44,0.3881,76,256,332,332,True
14721,2012-09-10,3,1,9,13,0,1,1,1,0.64,0.6212,0.38,0.2239,72,251,323,323,True
14722,2012-09-10,3,1,9,14,0,1,1,1,0.66,0.6212,0.36,0.2836,107,233,340,340,True
14723,2012-09-10,3,1,9,15,0,1,1,1,0.66,0.6212,0.31,0.3881,114,231,345,345,True
14724,2012-09-10,3,1,9,16,0,1,1,1,0.66,0.6212,0.34,0.3284,108,380,488,488,True
14725,2012-09-10,3,1,9,17,0,1,1,1,0.66,0.6212,0.34,0.3284,114,499,613,613,True
14726,2012-09-10,3,1,9,18,0,1,1,1,0.62,0.6212,0.35,0.2985,111,499,610,610,True
14727,2012-09-10,3,1,9,19,0,1,1,1,0.62,0.6212,0.38,0.2985,71,499,570,570,True
14728,2012-09-10,3,1,9,20,0,1,1,1,0.6,0.6212,0.4,0.194,34,356,390,390,True
14729,2012-09-10,3,1,9,21,0,1,1,1,0.56,0.5303,0.49,0.1642,29,256,285,285,True
14730,2012-09-10,3,1,9,22,0,1,1,1,0.54,0.5152,0.52,0.1343,15,144,159,159,True
14731,2012-09-10,3,1,9,23,0,1,1,1,0.54,0.5152,0.52,0.0,7,86,93,93,True
14732,2012-09-11,3,1,9,0,0,2,1,1,0.52,0.5,0.59,0.1045,5,27,32,32,True
14733,2012-09-11,3,1,9,1,0,2,1,1,0.5,0.4848,0.63,0.0,0,10,10,10,True
14734,2012-09-11,3,1,9,2,0,2,1,1,0.48,0.4697,0.77,0.1642,1,5,6,6,True
14735,2012-09-11,3,1,9,3,0,2,1,1,0.48,0.4697,0.67,0.1343,1,7,8,8,True
14736,2012-09-11,3,1,9,4,0,2,1,1,0.48,0.4697,0.72,0.1045,1,8,9,9,True
14737,2012-09-11,3,1,9,5,0,2,1,1,0.46,0.4545,0.72,0.0896,3,41,44,44,True
14738,2012-09-11,3,1,9,6,0,2,1,1,0.46,0.4545,0.77,0.1045,11,200,211,211,True
14739,2012-09-11,3,1,9,7,0,2,1,1,0.5,0.4848,0.72,0.1045,24,499,523,523,True
14740,2012-09-11,3,1,9,8,0,2,1,1,0.54,0.5152,0.68,0.0896,48,499,547,547,True
14741,2012-09-11,3,1,9,9,0,2,1,1,0.6,0.6212,0.49,0.0,35,323,358,358,True
14742,2012-09-11,3,1,9,10,0,2,1,1,0.62,0.6212,0.38,0.0,54,142,196,196,True
14743,2012-09-11,3,1,9,11,0,2,1,1,0.64,0.6212,0.33,0.0896,60,187,247,247,True
14744,2012-09-11,3,1,9,12,0,2,1,1,0.64,0.6212,0.33,0.0,62,254,316,316,True
14745,2012-09-11,3,1,9,13,0,2,1,1,0.66,0.6212,0.29,0.0896,72,256,328,328,True
14746,2012-09-11,3,1,9,14,0,2,1,1,0.68,0.6212,0.3,0.0896,74,181,255,255,True
14747,2012-09-11,3,1,9,15,0,2,1,1,0.7,0.6364,0.28,0.1045,73,253,326,326,True
14748,2012-09-11,3,1,9,16,0,2,1,1,0.7,0.6364,0.28,0.1343,99,437,536,536,True
14749,2012-09-11,3,1,9,17,0,2,1,1,0.7,0.6364,0.28,0.0,114,499,613,613,True
14750,2012-09-11,3,1,9,18,0,2,1,1,0.64,0.6212,0.36,0.1642,110,499,609,609,True
14751,2012-09-11,3,1,9,19,0,2,1,1,0.62,0.6212,0.41,0.194,56,499,555,555,True
14752,2012-09-11,3,1,9,20,0,2,1,1,0.58,0.5455,0.56,0.1343,40,421,461,461,True
14753,2012-09-11,3,1,9,21,0,2,1,1,0.56,0.5303,0.6,0.1045,28,282,310,310,True
14754,2012-09-11,3,1,9,22,0,2,1,1,0.56,0.5303,0.64,0.1045,27,189,216,216,True
14755,2012-09-11,3,1,9,23,0,2,1,1,0.54,0.5152,0.68,0.1045,18,91,109,109,True
14756,2012-09-12,3,1,9,0,0,3,1,1,0.52,0.5,0.72,0.1045,8,41,49,49,True
14757,2012-09-12,3,1,9,1,0,3,1,1,0.52,0.5,0.72,0.1045,2,19,21,21,True
14758,2012-09-12,3,1,9,2,0,3,1,1,0.52,0.5,0.72,0.0896,2,9,11,11,True
14759,2012-09-12,3,1,9,3,0,3,1,1,0.5,0.4848,0.77,0.0896,0,7,7,7,True
14760,2012-09-12,3,1,9,4,0,3,1,1,0.5,0.4848,0.72,0.0896,0,5,5,5,True
14761,2012-09-12,3,1,9,5,0,3,1,1,0.5,0.4848,0.72,0.0896,4,44,48,48,True
14762,2012-09-12,3,1,9,6,0,3,1,1,0.5,0.4848,0.72,0.0896,6,199,205,205,True
14763,2012-09-12,3,1,9,7,0,3,1,1,0.52,0.5,0.72,0.0,24,499,523,523,True
14764,2012-09-12,3,1,9,8,0,3,1,1,0.56,0.5303,0.64,0.1045,43,499,542,542,True
14765,2012-09-12,3,1,9,9,0,3,1,1,0.6,0.6061,0.64,0.1343,50,278,328,328,True
14766,2012-09-12,3,1,9,10,0,3,1,1,0.62,0.6061,0.61,0.1343,57,148,205,205,True
14767,2012-09-12,3,1,9,11,0,3,1,1,0.66,0.6212,0.5,0.194,51,181,232,232,True
14768,2012-09-12,3,1,9,12,0,3,1,1,0.68,0.6364,0.36,0.1343,88,264,352,352,True
14769,2012-09-12,3,1,9,13,0,3,1,1,0.7,0.6364,0.34,0.1343,85,238,323,323,True
14770,2012-09-12,3,1,9,14,0,3,1,1,0.7,0.6364,0.37,0.1642,78,200,278,278,True
14771,2012-09-12,3,1,9,15,0,3,1,1,0.72,0.6515,0.37,0.1343,75,243,318,318,True
14772,2012-09-12,3,1,9,16,0,3,1,1,0.72,0.6515,0.37,0.1642,90,419,509,509,True
14773,2012-09-12,3,1,9,17,0,3,1,1,0.7,0.6364,0.41,0.2985,114,499,613,613,True
14774,2012-09-12,3,1,9,18,0,3,1,1,0.66,0.6212,0.44,0.2537,91,499,590,590,True
14775,2012-09-12,3,1,9,19,0,3,1,1,0.64,0.6212,0.5,0.194,78,499,577,577,True
14776,2012-09-12,3,1,9,20,0,3,1,1,0.62,0.6212,0.57,0.1343,38,432,470,470,True
14777,2012-09-12,3,1,9,21,0,3,1,1,0.6,0.6061,0.6,0.1343,27,279,306,306,True
14778,2012-09-12,3,1,9,22,0,3,1,1,0.56,0.5303,0.64,0.0896,23,189,212,212,True
14779,2012-09-12,3,1,9,23,0,3,1,1,0.56,0.5303,0.68,0.1045,16,111,127,127,True
14780,2012-09-13,3,1,9,0,0,4,1,1,0.56,0.5303,0.73,0.0896,11,46,57,57,True
14781,2012-09-13,3,1,9,1,0,4,1,1,0.54,0.5152,0.77,0.0896,6,22,28,28,True
14782,2012-09-13,3,1,9,2,0,4,1,1,0.54,0.5152,0.77,0.0,0,9,9,9,True
14783,2012-09-13,3,1,9,3,0,4,1,1,0.52,0.5,0.83,0.0,2,9,11,11,True
14784,2012-09-13,3,1,9,4,0,4,1,1,0.52,0.5,0.83,0.0,0,6,6,6,True
14785,2012-09-13,3,1,9,5,0,4,1,1,0.52,0.5,0.83,0.0,3,54,57,57,True
14786,2012-09-13,3,1,9,6,0,4,1,1,0.5,0.4848,0.82,0.0,9,186,195,195,True
14787,2012-09-13,3,1,9,7,0,4,1,1,0.54,0.5152,0.77,0.0,22,499,521,521,True
14788,2012-09-13,3,1,9,8,0,4,1,1,0.56,0.5303,0.73,0.0,33,499,532,532,True
14789,2012-09-13,3,1,9,9,0,4,1,1,0.6,0.6061,0.64,0.0896,46,292,338,338,True
14790,2012-09-13,3,1,9,10,0,4,1,1,0.64,0.6212,0.61,0.0896,63,149,212,212,True
14791,2012-09-13,3,1,9,11,0,4,1,1,0.66,0.6212,0.5,0.1642,71,183,254,254,True
14792,2012-09-13,3,1,9,12,0,4,1,1,0.68,0.6364,0.44,0.1045,57,240,297,297,True
14793,2012-09-13,3,1,9,13,0,4,1,1,0.7,0.6364,0.42,0.0,60,223,283,283,True
14794,2012-09-13,3,1,9,14,0,4,1,1,0.72,0.6515,0.39,0.1343,60,214,274,274,True
14795,2012-09-13,3,1,9,15,0,4,1,1,0.72,0.6515,0.42,0.1045,99,253,352,352,True
14796,2012-09-13,3,1,9,16,0,4,1,1,0.72,0.6515,0.39,0.0896,85,406,491,491,True
14797,2012-09-13,3,1,9,17,0,4,1,1,0.72,0.6515,0.42,0.194,97,499,596,596,True
14798,2012-09-13,3,1,9,18,0,4,1,1,0.68,0.6364,0.57,0.2537,108,499,607,607,True
14799,2012-09-13,3,1,9,19,0,4,1,1,0.64,0.6061,0.65,0.1343,80,499,579,579,True
14800,2012-09-13,3,1,9,20,0,4,1,1,0.62,0.6061,0.69,0.1045,55,408,463,463,True
14801,2012-09-13,3,1,9,21,0,4,1,1,0.62,0.6061,0.65,0.1045,26,291,317,317,True
14802,2012-09-13,3,1,9,22,0,4,1,1,0.6,0.5909,0.69,0.1343,28,223,251,251,True
14803,2012-09-13,3,1,9,23,0,4,1,1,0.58,0.5455,0.73,0.1045,33,137,170,170,True
14804,2012-09-14,3,1,9,0,0,5,1,1,0.56,0.5303,0.73,0.0896,24,63,87,87,True
14805,2012-09-14,3,1,9,1,0,5,1,1,0.56,0.5303,0.73,0.0896,6,35,41,41,True
14806,2012-09-14,3,1,9,2,0,5,1,1,0.56,0.5303,0.73,0.0,7,23,30,30,True
14807,2012-09-14,3,1,9,3,0,5,1,1,0.54,0.5152,0.77,0.0,5,9,14,14,True
14808,2012-09-14,3,1,9,4,0,5,1,1,0.54,0.5152,0.77,0.0,1,11,12,12,True
14809,2012-09-14,3,1,9,5,0,5,1,1,0.54,0.5152,0.83,0.0,1,40,41,41,True
14810,2012-09-14,3,1,9,6,0,5,1,1,0.54,0.5152,0.88,0.0,8,144,152,152,True
14811,2012-09-14,3,1,9,7,0,5,1,2,0.56,0.5303,0.88,0.0,17,437,454,454,True
14812,2012-09-14,3,1,9,8,0,5,1,2,0.6,0.5758,0.78,0.1642,51,499,550,550,True
14813,2012-09-14,3,1,9,9,0,5,1,2,0.62,0.5909,0.78,0.1642,46,301,347,347,True
14814,2012-09-14,3,1,9,10,0,5,1,2,0.68,0.6364,0.65,0.0,75,171,246,246,True
14815,2012-09-14,3,1,9,11,0,5,1,2,0.68,0.6364,0.61,0.1045,84,196,280,280,True
14816,2012-09-14,3,1,9,12,0,5,1,2,0.7,0.6515,0.54,0.194,114,290,404,404,True
14817,2012-09-14,3,1,9,13,0,5,1,2,0.7,0.6515,0.54,0.194,107,301,408,408,True
14818,2012-09-14,3,1,9,14,0,5,1,2,0.72,0.6515,0.45,0.1642,113,258,371,371,True
14819,2012-09-14,3,1,9,15,0,5,1,2,0.72,0.6667,0.48,0.1343,94,273,367,367,True
14820,2012-09-14,3,1,9,16,0,5,1,2,0.72,0.6667,0.51,0.0,109,454,563,563,True
14821,2012-09-14,3,1,9,17,0,5,1,1,0.72,0.6667,0.51,0.194,114,499,613,613,True
14822,2012-09-14,3,1,9,18,0,5,1,1,0.72,0.6515,0.45,0.2239,114,499,613,613,True
14823,2012-09-14,3,1,9,19,0,5,1,1,0.68,0.6364,0.57,0.1642,83,496,579,579,True
14824,2012-09-14,3,1,9,20,0,5,1,1,0.66,0.6212,0.61,0.1045,67,337,404,404,True
14825,2012-09-14,3,1,9,21,0,5,1,1,0.64,0.6061,0.73,0.2239,42,270,312,312,True
14826,2012-09-14,3,1,9,22,0,5,1,1,0.62,0.5758,0.83,0.194,40,189,229,229,True
14827,2012-09-14,3,1,9,23,0,5,1,1,0.62,0.5909,0.78,0.0896,27,168,195,195,True
14828,2012-09-15,3,1,9,0,0,6,0,1,0.6,0.5606,0.83,0.1045,38,169,207,207,True
14829,2012-09-15,3,1,9,1,0,6,0,1,0.6,0.5909,0.73,0.0,8,101,109,109,True
14830,2012-09-15,3,1,9,2,0,6,0,1,0.58,0.5455,0.78,0.1045,18,75,93,93,True
14831,2012-09-15,3,1,9,3,0,6,0,1,0.6,0.5909,0.73,0.2537,6,31,37,37,True
14832,2012-09-15,3,1,9,4,0,6,0,2,0.6,0.5909,0.69,0.3582,3,3,6,6,True
14833,2012-09-15,3,1,9,5,0,6,0,1,0.58,0.5455,0.6,0.4775,1,15,16,16,True
14834,2012-09-15,3,1,9,6,0,6,0,1,0.54,0.5152,0.49,0.4179,6,27,33,33,True
14835,2012-09-15,3,1,9,7,0,6,0,1,0.54,0.5152,0.52,0.2836,10,63,73,73,True
14836,2012-09-15,3,1,9,8,0,6,0,1,0.56,0.5303,0.49,0.4179,43,169,212,212,True
14837,2012-09-15,3,1,9,9,0,6,0,1,0.6,0.6212,0.43,0.4179,79,263,342,342,True
14838,2012-09-15,3,1,9,10,0,6,0,1,0.62,0.6212,0.41,0.3881,114,323,437,437,True
14839,2012-09-15,3,1,9,11,0,6,0,1,0.64,0.6212,0.38,0.3881,114,399,513,513,True
14840,2012-09-15,3,1,9,12,0,6,0,1,0.66,0.6212,0.36,0.3582,114,419,533,533,True
14841,2012-09-15,3,1,9,13,0,6,0,1,0.68,0.6364,0.36,0.194,114,377,491,491,True
14842,2012-09-15,3,1,9,14,0,6,0,1,0.68,0.6364,0.34,0.3284,114,390,504,504,True
14843,2012-09-15,3,1,9,15,0,6,0,2,0.68,0.6364,0.34,0.2836,114,342,456,456,True
14844,2012-09-15,3,1,9,16,0,6,0,2,0.66,0.6212,0.36,0.2239,114,433,547,547,True
14845,2012-09-15,3,1,9,17,0,6,0,2,0.66,0.6212,0.36,0.2537,114,434,548,548,True
14846,2012-09-15,3,1,9,18,0,6,0,2,0.64,0.6212,0.36,0.2836,114,382,496,496,True
14847,2012-09-15,3,1,9,19,0,6,0,1,0.62,0.6212,0.41,0.1642,114,309,423,423,True
14848,2012-09-15,3,1,9,20,0,6,0,1,0.6,0.6212,0.43,0.0896,89,241,330,330,True
14849,2012-09-15,3,1,9,21,0,6,0,1,0.56,0.5303,0.52,0.1045,86,210,296,296,True
14850,2012-09-15,3,1,9,22,0,6,0,1,0.56,0.5303,0.52,0.0,82,197,279,279,True
14851,2012-09-15,3,1,9,23,0,6,0,1,0.54,0.5152,0.6,0.0,47,182,229,229,True
14852,2012-09-16,3,1,9,0,0,0,0,1,0.54,0.5152,0.64,0.0,28,123,151,151,True
14853,2012-09-16,3,1,9,1,0,0,0,1,0.54,0.5152,0.64,0.0,35,82,117,117,True
14854,2012-09-16,3,1,9,2,0,0,0,1,0.52,0.5,0.63,0.0,27,62,89,89,True
14855,2012-09-16,3,1,9,3,0,0,0,1,0.5,0.4848,0.68,0.0,10,38,48,48,True
14856,2012-09-16,3,1,9,4,0,0,0,1,0.5,0.4848,0.72,0.0,2,6,8,8,True
14857,2012-09-16,3,1,9,5,0,0,0,1,0.5,0.4848,0.72,0.0,3,10,13,13,True
14858,2012-09-16,3,1,9,6,0,0,0,1,0.5,0.4848,0.72,0.0,9,26,35,35,True
14859,2012-09-16,3,1,9,7,0,0,0,1,0.5,0.4848,0.77,0.1045,28,43,71,71,True
14860,2012-09-16,3,1,9,8,0,0,0,1,0.54,0.5152,0.64,0.1642,34,94,128,128,True
14861,2012-09-16,3,1,9,9,0,0,0,1,0.58,0.5455,0.6,0.1343,70,226,296,296,True
14862,2012-09-16,3,1,9,10,0,0,0,1,0.62,0.6212,0.5,0.1045,114,330,444,444,True
14863,2012-09-16,3,1,9,11,0,0,0,1,0.64,0.6212,0.47,0.1642,114,376,490,490,True
14864,2012-09-16,3,1,9,12,0,0,0,1,0.66,0.6212,0.44,0.1642,114,468,582,582,True
14865,2012-09-16,3,1,9,13,0,0,0,1,0.64,0.6212,0.41,0.1642,114,454,568,568,True
14866,2012-09-16,3,1,9,14,0,0,0,1,0.66,0.6212,0.39,0.1343,114,410,524,524,True
14867,2012-09-16,3,1,9,15,0,0,0,1,0.64,0.6212,0.41,0.1642,114,342,456,456,True
14868,2012-09-16,3,1,9,16,0,0,0,1,0.64,0.6212,0.44,0.1642,114,402,516,516,True
14869,2012-09-16,3,1,9,17,0,0,0,1,0.66,0.6212,0.41,0.0,114,393,507,507,True
14870,2012-09-16,3,1,9,18,0,0,0,1,0.62,0.6212,0.5,0.1642,114,361,475,475,True
14871,2012-09-16,3,1,9,19,0,0,0,1,0.62,0.6212,0.5,0.1343,91,312,403,403,True
14872,2012-09-16,3,1,9,20,0,0,0,1,0.6,0.6212,0.53,0.1045,57,267,324,324,True
14873,2012-09-16,3,1,9,21,0,0,0,1,0.6,0.6212,0.56,0.1045,43,148,191,191,True
14874,2012-09-16,3,1,9,22,0,0,0,1,0.56,0.5303,0.68,0.0896,18,109,127,127,True
14875,2012-09-16,3,1,9,23,0,0,0,1,0.54,0.5152,0.68,0.1045,9,85,94,94,True
14876,2012-09-17,3,1,9,0,0,1,1,1,0.54,0.5152,0.68,0.1642,14,31,45,45,True
14877,2012-09-17,3,1,9,1,0,1,1,1,0.52,0.5,0.72,0.0896,9,12,21,21,True
14878,2012-09-17,3,1,9,2,0,1,1,1,0.52,0.5,0.72,0.0,5,8,13,13,True
14879,2012-09-17,3,1,9,3,0,1,1,1,0.5,0.4848,0.77,0.0896,0,7,7,7,True
14880,2012-09-17,3,1,9,4,0,1,1,1,0.5,0.4848,0.77,0.0,2,9,11,11,True
14881,2012-09-17,3,1,9,5,0,1,1,1,0.48,0.4697,0.82,0.0896,1,44,45,45,True
14882,2012-09-17,3,1,9,6,0,1,1,1,0.48,0.4697,0.82,0.0,7,157,164,164,True
14883,2012-09-17,3,1,9,7,0,1,1,1,0.52,0.5,0.77,0.0,18,474,492,492,True
14884,2012-09-17,3,1,9,8,0,1,1,1,0.54,0.5152,0.77,0.0896,36,499,535,535,True
14885,2012-09-17,3,1,9,9,0,1,1,1,0.58,0.5455,0.68,0.1343,34,265,299,299,True
14886,2012-09-17,3,1,9,10,0,1,1,2,0.62,0.6061,0.65,0.194,73,129,202,202,True
14887,2012-09-17,3,1,9,11,0,1,1,2,0.62,0.6061,0.69,0.2239,61,191,252,252,True
14888,2012-09-17,3,1,9,12,0,1,1,2,0.62,0.6061,0.69,0.194,62,233,295,295,True
14889,2012-09-17,3,1,9,13,0,1,1,1,0.64,0.6061,0.65,0.2537,112,231,343,343,True
14890,2012-09-17,3,1,9,14,0,1,1,2,0.64,0.6061,0.65,0.2537,114,203,317,317,True
14891,2012-09-17,3,1,9,15,0,1,1,2,0.64,0.6061,0.65,0.2537,82,256,338,338,True
14892,2012-09-17,3,1,9,16,0,1,1,2,0.64,0.6061,0.69,0.2537,74,379,453,453,True
14893,2012-09-17,3,1,9,17,0,1,1,2,0.64,0.6061,0.65,0.2239,102,499,601,601,True
14894,2012-09-17,3,1,9,18,0,1,1,2,0.62,0.5909,0.73,0.1642,66,499,565,565,True
14895,2012-09-17,3,1,9,19,0,1,1,2,0.62,0.5909,0.73,0.1045,51,435,486,486,True
14896,2012-09-17,3,1,9,20,0,1,1,2,0.62,0.5909,0.73,0.1343,32,308,340,340,True
14897,2012-09-17,3,1,9,21,0,1,1,3,0.62,0.5758,0.83,0.2239,28,205,233,233,True
14898,2012-09-17,3,1,9,22,0,1,1,3,0.62,0.5758,0.83,0.2537,20,109,129,129,True
14899,2012-09-17,3,1,9,23,0,1,1,3,0.6,0.5152,0.94,0.2537,4,66,70,70,True
14900,2012-09-18,3,1,9,0,0,2,1,3,0.6,0.5152,0.94,0.2537,2,11,13,13,True
14901,2012-09-18,3,1,9,1,0,2,1,3,0.6,0.5152,0.94,0.194,0,5,5,5,True
14902,2012-09-18,3,1,9,2,0,2,1,3,0.6,0.5152,0.94,0.194,0,4,4,4,True
14903,2012-09-18,3,1,9,3,0,2,1,2,0.62,0.5455,0.94,0.2836,0,6,6,6,True
14904,2012-09-18,3,1,9,4,0,2,1,2,0.62,0.5455,0.94,0.3582,2,5,7,7,True
14905,2012-09-18,3,1,9,5,0,2,1,2,0.64,0.5758,0.89,0.3284,3,45,48,48,True
14906,2012-09-18,3,1,9,6,0,2,1,2,0.64,0.5758,0.89,0.3284,4,163,167,167,True
14907,2012-09-18,3,1,9,7,0,2,1,2,0.64,0.5758,0.89,0.4478,13,343,356,356,True
14908,2012-09-18,3,1,9,8,0,2,1,2,0.66,0.6061,0.83,0.4775,32,499,531,531,True
14909,2012-09-18,3,1,9,9,0,2,1,2,0.66,0.6061,0.83,0.4775,27,266,293,293,True
14910,2012-09-18,3,1,9,10,0,2,1,3,0.68,0.6364,0.79,0.4775,30,130,160,160,True
14911,2012-09-18,3,1,9,11,0,2,1,2,0.68,0.6364,0.79,0.4775,36,115,151,151,True
14912,2012-09-18,3,1,9,12,0,2,1,3,0.68,0.6364,0.83,0.4478,16,72,88,88,True
14913,2012-09-18,3,1,9,13,0,2,1,2,0.7,0.6667,0.74,0.4775,17,97,114,114,True
14914,2012-09-18,3,1,9,14,0,2,1,3,0.6,0.5152,0.94,0.4627,27,116,143,143,True
14915,2012-09-18,3,1,9,15,0,2,1,3,0.6,0.5455,0.88,0.2537,1,35,36,36,True
14916,2012-09-18,3,1,9,16,0,2,1,3,0.6,0.5455,0.88,0.2985,19,122,141,141,True
14917,2012-09-18,3,1,9,17,0,2,1,3,0.6,0.5455,0.88,0.194,36,302,338,338,True
14918,2012-09-18,3,1,9,18,0,2,1,2,0.6,0.5455,0.88,0.1642,19,262,281,281,True
14919,2012-09-18,3,1,9,19,0,2,1,2,0.6,0.5455,0.88,0.2985,22,302,324,324,True
14920,2012-09-18,3,1,9,20,0,2,1,2,0.6,0.5455,0.88,0.194,19,271,290,290,True
14921,2012-09-18,3,1,9,21,0,2,1,2,0.6,0.5455,0.88,0.194,21,186,207,207,True
14922,2012-09-18,3,1,9,22,0,2,1,3,0.58,0.5455,0.83,0.4627,14,137,151,151,True
14923,2012-09-18,3,1,9,23,0,2,1,2,0.56,0.5303,0.83,0.2239,11,67,78,78,True
14924,2012-09-19,3,1,9,0,0,3,1,2,0.56,0.5303,0.68,0.2836,3,23,26,26,True
14925,2012-09-19,3,1,9,1,0,3,1,2,0.54,0.5152,0.68,0.2537,0,12,12,12,True
14926,2012-09-19,3,1,9,2,0,3,1,2,0.54,0.5152,0.64,0.3284,0,3,3,3,True
14927,2012-09-19,3,1,9,3,0,3,1,2,0.52,0.5,0.63,0.2537,1,4,5,5,True
14928,2012-09-19,3,1,9,4,0,3,1,2,0.52,0.5,0.68,0.3582,0,10,10,10,True
14929,2012-09-19,3,1,9,5,0,3,1,2,0.52,0.5,0.68,0.2836,2,54,56,56,True
14930,2012-09-19,3,1,9,6,0,3,1,1,0.52,0.5,0.63,0.2537,6,166,172,172,True
14931,2012-09-19,3,1,9,7,0,3,1,1,0.52,0.5,0.63,0.2239,16,499,515,515,True
14932,2012-09-19,3,1,9,8,0,3,1,1,0.52,0.5,0.59,0.2239,39,499,538,538,True
14933,2012-09-19,3,1,9,9,0,3,1,1,0.54,0.5152,0.6,0.2537,26,336,362,362,True
14934,2012-09-19,3,1,9,10,0,3,1,1,0.56,0.5303,0.52,0.194,23,169,192,192,True
14935,2012-09-19,3,1,9,11,0,3,1,1,0.6,0.6212,0.43,0.2537,44,203,247,247,True
14936,2012-09-19,3,1,9,12,0,3,1,1,0.6,0.6212,0.43,0.2537,53,260,313,313,True
14937,2012-09-19,3,1,9,13,0,3,1,1,0.6,0.6212,0.4,0.2537,55,234,289,289,True
14938,2012-09-19,3,1,9,14,0,3,1,1,0.62,0.6212,0.38,0.2537,59,227,286,286,True
14939,2012-09-19,3,1,9,15,0,3,1,1,0.62,0.6212,0.35,0.0,57,254,311,311,True
14940,2012-09-19,3,1,9,16,0,3,1,1,0.62,0.6212,0.35,0.0,69,397,466,466,True
14941,2012-09-19,3,1,9,17,0,3,1,1,0.6,0.6212,0.38,0.2239,74,499,573,573,True
14942,2012-09-19,3,1,9,18,0,3,1,1,0.58,0.5455,0.4,0.2836,85,499,584,584,True
14943,2012-09-19,3,1,9,19,0,3,1,1,0.56,0.5303,0.43,0.2239,72,499,571,571,True
14944,2012-09-19,3,1,9,20,0,3,1,1,0.52,0.5,0.48,0.1642,31,378,409,409,True
14945,2012-09-19,3,1,9,21,0,3,1,1,0.5,0.4848,0.59,0.1642,25,324,349,349,True
14946,2012-09-19,3,1,9,22,0,3,1,1,0.5,0.4848,0.63,0.0896,31,198,229,229,True
14947,2012-09-19,3,1,9,23,0,3,1,1,0.48,0.4697,0.67,0.0896,17,106,123,123,True
14948,2012-09-20,3,1,9,0,0,4,1,1,0.5,0.4848,0.63,0.0,12,46,58,58,True
14949,2012-09-20,3,1,9,1,0,4,1,1,0.46,0.4545,0.72,0.1045,4,14,18,18,True
14950,2012-09-20,3,1,9,2,0,4,1,1,0.46,0.4545,0.72,0.0896,2,9,11,11,True
14951,2012-09-20,3,1,9,3,0,4,1,1,0.44,0.4394,0.77,0.0,0,6,6,6,True
14952,2012-09-20,3,1,9,4,0,4,1,1,0.44,0.4394,0.77,0.1045,0,6,6,6,True
14953,2012-09-20,3,1,9,5,0,4,1,1,0.44,0.4394,0.77,0.1045,4,52,56,56,True
14954,2012-09-20,3,1,9,6,0,4,1,1,0.44,0.4394,0.77,0.0,9,161,170,170,True
14955,2012-09-20,3,1,9,7,0,4,1,1,0.46,0.4545,0.82,0.1045,20,499,519,519,True
14956,2012-09-20,3,1,9,8,0,4,1,1,0.5,0.4848,0.68,0.0896,44,499,543,543,True
14957,2012-09-20,3,1,9,9,0,4,1,1,0.56,0.5303,0.6,0.0896,25,330,355,355,True
14958,2012-09-20,3,1,9,10,0,4,1,1,0.58,0.5455,0.53,0.0896,33,157,190,190,True
14959,2012-09-20,3,1,9,11,0,4,1,1,0.62,0.6212,0.43,0.0,37,206,243,243,True
14960,2012-09-20,3,1,9,12,0,4,1,1,0.62,0.6212,0.43,0.1343,57,233,290,290,True
14961,2012-09-20,3,1,9,13,0,4,1,1,0.64,0.6212,0.44,0.1343,68,268,336,336,True
14962,2012-09-20,3,1,9,14,0,4,1,1,0.64,0.6212,0.47,0.194,76,222,298,298,True
14963,2012-09-20,3,1,9,15,0,4,1,1,0.66,0.6212,0.47,0.194,60,231,291,291,True
14964,2012-09-20,3,1,9,16,0,4,1,1,0.64,0.6212,0.47,0.1642,72,385,457,457,True
14965,2012-09-20,3,1,9,17,0,4,1,1,0.64,0.6212,0.5,0.2239,91,499,590,590,True
14966,2012-09-20,3,1,9,18,0,4,1,1,0.6,0.6212,0.56,0.2537,114,499,613,613,True
14967,2012-09-20,3,1,9,19,0,4,1,1,0.58,0.5455,0.6,0.2239,69,499,568,568,True
14968,2012-09-20,3,1,9,20,0,4,1,1,0.56,0.5303,0.64,0.1343,57,360,417,417,True
14969,2012-09-20,3,1,9,21,0,4,1,1,0.56,0.5303,0.64,0.194,28,246,274,274,True
14970,2012-09-20,3,1,9,22,0,4,1,1,0.54,0.5152,0.73,0.1045,35,252,287,287,True
14971,2012-09-20,3,1,9,23,0,4,1,1,0.54,0.5152,0.68,0.1045,17,137,154,154,True
14972,2012-09-21,3,1,9,0,0,5,1,1,0.54,0.5152,0.68,0.0,13,53,66,66,True
14973,2012-09-21,3,1,9,1,0,5,1,1,0.52,0.5,0.72,0.0,11,38,49,49,True
14974,2012-09-21,3,1,9,2,0,5,1,1,0.52,0.5,0.72,0.0,6,8,14,14,True
14975,2012-09-21,3,1,9,3,0,5,1,1,0.5,0.4848,0.77,0.0896,1,11,12,12,True
14976,2012-09-21,3,1,9,4,0,5,1,1,0.5,0.4848,0.77,0.0,1,9,10,10,True
14977,2012-09-21,3,1,9,5,0,5,1,1,0.5,0.4848,0.82,0.0,2,47,49,49,True
14978,2012-09-21,3,1,9,6,0,5,1,1,0.5,0.4848,0.77,0.0896,19,146,165,165,True
14979,2012-09-21,3,1,9,7,0,5,1,1,0.52,0.5,0.77,0.0,35,468,503,503,True
14980,2012-09-21,3,1,9,8,0,5,1,1,0.54,0.5152,0.73,0.1343,31,499,530,530,True
14981,2012-09-21,3,1,9,9,0,5,1,1,0.58,0.5455,0.68,0.1343,35,348,383,383,True
14982,2012-09-21,3,1,9,10,0,5,1,1,0.62,0.6061,0.61,0.2239,44,181,225,225,True
14983,2012-09-21,3,1,9,11,0,5,1,1,0.66,0.6212,0.57,0.2239,79,242,321,321,True
14984,2012-09-21,3,1,9,12,0,5,1,1,0.68,0.6364,0.57,0.1642,84,305,389,389,True
14985,2012-09-21,3,1,9,13,0,5,1,1,0.7,0.6515,0.54,0.1642,105,316,421,421,True
14986,2012-09-21,3,1,9,14,0,5,1,1,0.7,0.6515,0.54,0.2985,113,299,412,412,True
14987,2012-09-21,3,1,9,15,0,5,1,1,0.7,0.6515,0.54,0.2239,90,333,423,423,True
14988,2012-09-21,3,1,9,16,0,5,1,1,0.7,0.6515,0.54,0.194,103,464,567,567,True
14989,2012-09-21,3,1,9,17,0,5,1,1,0.68,0.6364,0.57,0.2836,107,499,606,606,True
14990,2012-09-21,3,1,9,18,0,5,1,1,0.66,0.6212,0.61,0.2537,106,499,605,605,True
14991,2012-09-21,3,1,9,19,0,5,1,1,0.64,0.6061,0.65,0.2537,95,493,588,588,True
14992,2012-09-21,3,1,9,20,0,5,1,1,0.62,0.6061,0.69,0.194,54,315,369,369,True
14993,2012-09-21,3,1,9,21,0,5,1,1,0.6,0.5909,0.73,0.2537,46,266,312,312,True
14994,2012-09-21,3,1,9,22,0,5,1,1,0.6,0.5909,0.73,0.194,47,248,295,295,True
14995,2012-09-21,3,1,9,23,0,5,1,1,0.6,0.5909,0.73,0.3284,23,163,186,186,True
14996,2012-09-22,3,1,9,0,0,6,0,1,0.6,0.5909,0.73,0.2836,32,140,172,172,True
14997,2012-09-22,3,1,9,1,0,6,0,1,0.58,0.5455,0.83,0.2985,18,106,124,124,True
14998,2012-09-22,3,1,9,2,0,6,0,1,0.56,0.5303,0.88,0.2537,10,73,83,83,True
14999,2012-09-22,3,1,9,3,0,6,0,1,0.56,0.5303,0.83,0.2836,6,39,45,45,True
15000,2012-09-22,3,1,9,4,0,6,0,1,0.56,0.5303,0.83,0.2836,5,10,15,15,True
15001,2012-09-22,3,1,9,5,0,6,0,1,0.56,0.5303,0.83,0.3284,2,15,17,17,True
15002,2012-09-22,3,1,9,6,0,6,0,1,0.56,0.5303,0.83,0.2985,6,35,41,41,True
15003,2012-09-22,3,1,9,7,0,6,0,1,0.58,0.5455,0.78,0.2537,7,70,77,77,True
15004,2012-09-22,3,1,9,8,0,6,0,1,0.6,0.5909,0.73,0.2985,21,197,218,218,True
15005,2012-09-22,3,1,9,9,0,6,0,1,0.64,0.6061,0.69,0.2537,88,289,377,377,True
15006,2012-09-22,3,1,9,10,0,6,0,1,0.66,0.6212,0.65,0.3284,114,350,464,464,True
15007,2012-09-22,3,1,9,11,0,6,0,1,0.7,0.6515,0.58,0.2836,114,437,551,551,True
15008,2012-09-22,3,1,9,12,0,6,0,1,0.72,0.6667,0.54,0.2985,114,460,574,574,True
15009,2012-09-22,3,1,9,13,0,6,0,1,0.74,0.6667,0.51,0.3582,114,434,548,548,True
15010,2012-09-22,3,1,9,14,0,6,0,1,0.76,0.6818,0.48,0.2836,114,404,518,518,True
15011,2012-09-22,3,1,9,15,0,6,0,1,0.74,0.6667,0.48,0.3881,114,443,557,557,True
15012,2012-09-22,3,1,9,16,0,6,0,1,0.74,0.6667,0.51,0.3284,114,427,541,541,True
15013,2012-09-22,3,1,9,17,0,6,0,1,0.74,0.6667,0.51,0.3284,114,451,565,565,True
15014,2012-09-22,3,1,9,18,0,6,0,1,0.72,0.6667,0.54,0.2836,114,427,541,541,True
15015,2012-09-22,3,1,9,19,0,6,0,1,0.7,0.6515,0.58,0.194,99,308,407,407,True
15016,2012-09-22,3,1,9,20,0,6,0,1,0.7,0.6515,0.54,0.2537,76,249,325,325,True
15017,2012-09-22,3,1,9,21,0,6,0,1,0.64,0.6212,0.57,0.2537,59,202,261,261,True
15018,2012-09-22,3,1,9,22,0,6,0,1,0.62,0.6212,0.57,0.194,59,180,239,239,True
15019,2012-09-22,3,1,9,23,0,6,0,1,0.62,0.6212,0.5,0.194,34,137,171,171,True
15020,2012-09-23,4,1,9,0,0,0,0,1,0.62,0.6212,0.38,0.2537,34,146,180,180,True
15021,2012-09-23,4,1,9,1,0,0,0,1,0.54,0.5152,0.52,0.3582,23,119,142,142,True
15022,2012-09-23,4,1,9,2,0,0,0,1,0.52,0.5,0.48,0.2537,18,77,95,95,True
15023,2012-09-23,4,1,9,3,0,0,0,1,0.48,0.4697,0.55,0.2985,13,41,54,54,True
15024,2012-09-23,4,1,9,4,0,0,0,1,0.46,0.4545,0.55,0.2239,1,9,10,10,True
15025,2012-09-23,4,1,9,5,0,0,0,1,0.46,0.4545,0.59,0.2537,1,5,6,6,True
15026,2012-09-23,4,1,9,6,0,0,0,1,0.44,0.4394,0.62,0.2537,5,11,16,16,True
15027,2012-09-23,4,1,9,7,0,0,0,1,0.46,0.4545,0.59,0.2239,9,48,57,57,True
15028,2012-09-23,4,1,9,8,0,0,0,1,0.48,0.4697,0.55,0.3582,38,137,175,175,True
15029,2012-09-23,4,1,9,9,0,0,0,1,0.5,0.4848,0.51,0.3284,71,205,276,276,True
15030,2012-09-23,4,1,9,10,0,0,0,1,0.54,0.5152,0.45,0.2537,114,351,465,465,True
15031,2012-09-23,4,1,9,11,0,0,0,1,0.56,0.5303,0.46,0.2537,114,384,498,498,True
15032,2012-09-23,4,1,9,12,0,0,0,1,0.56,0.5303,0.43,0.1045,114,499,613,613,True
15033,2012-09-23,4,1,9,13,0,0,0,1,0.6,0.6212,0.38,0.1642,114,445,559,559,True
15034,2012-09-23,4,1,9,14,0,0,0,1,0.6,0.6212,0.38,0.194,114,400,514,514,True
15035,2012-09-23,4,1,9,15,0,0,0,1,0.6,0.6212,0.33,0.2239,114,375,489,489,True
15036,2012-09-23,4,1,9,16,0,0,0,1,0.6,0.6212,0.33,0.3284,114,437,551,551,True
15037,2012-09-23,4,1,9,17,0,0,0,1,0.56,0.5303,0.35,0.2985,114,496,610,610,True
15038,2012-09-23,4,1,9,18,0,0,0,1,0.54,0.5152,0.37,0.194,114,405,519,519,True
15039,2012-09-23,4,1,9,19,0,0,0,1,0.52,0.5,0.42,0.1642,82,331,413,413,True
15040,2012-09-23,4,1,9,20,0,0,0,1,0.52,0.5,0.42,0.1642,60,192,252,252,True
15041,2012-09-23,4,1,9,21,0,0,0,2,0.52,0.5,0.48,0.1045,51,145,196,196,True
15042,2012-09-23,4,1,9,22,0,0,0,1,0.52,0.5,0.48,0.0,40,98,138,138,True
15043,2012-09-23,4,1,9,23,0,0,0,2,0.5,0.4848,0.59,0.1045,30,70,100,100,True
15044,2012-09-24,4,1,9,0,0,1,1,1,0.46,0.4545,0.63,0.194,10,54,64,64,True
15045,2012-09-24,4,1,9,1,0,1,1,1,0.46,0.4545,0.67,0.1343,6,12,18,18,True
15046,2012-09-24,4,1,9,2,0,1,1,2,0.46,0.4545,0.63,0.1343,0,8,8,8,True
15047,2012-09-24,4,1,9,3,0,1,1,1,0.46,0.4545,0.63,0.1642,0,5,5,5,True
15048,2012-09-24,4,1,9,4,0,1,1,1,0.44,0.4394,0.67,0.1045,0,8,8,8,True
15049,2012-09-24,4,1,9,5,0,1,1,1,0.46,0.4545,0.63,0.0,2,35,37,37,True
15050,2012-09-24,4,1,9,6,0,1,1,1,0.46,0.4545,0.59,0.0,6,162,168,168,True
15051,2012-09-24,4,1,9,7,0,1,1,1,0.46,0.4545,0.67,0.1343,17,499,516,516,True
15052,2012-09-24,4,1,9,8,0,1,1,1,0.5,0.4848,0.55,0.194,31,499,530,530,True
15053,2012-09-24,4,1,9,9,0,1,1,1,0.52,0.5,0.52,0.194,42,286,328,328,True
15054,2012-09-24,4,1,9,10,0,1,1,1,0.54,0.5152,0.49,0.2239,52,146,198,198,True
15055,2012-09-24,4,1,9,11,0,1,1,1,0.56,0.5303,0.37,0.194,71,167,238,238,True
15056,2012-09-24,4,1,9,12,0,1,1,1,0.56,0.5303,0.35,0.2985,77,265,342,342,True
15057,2012-09-24,4,1,9,13,0,1,1,1,0.6,0.6212,0.31,0.2985,80,248,328,328,True
15058,2012-09-24,4,1,9,14,0,1,1,1,0.6,0.6061,0.28,0.0,77,226,303,303,True
15059,2012-09-24,4,1,9,15,0,1,1,1,0.6,0.6212,0.31,0.0,84,216,300,300,True
15060,2012-09-24,4,1,9,16,0,1,1,1,0.58,0.5455,0.3,0.2537,99,417,516,516,True
15061,2012-09-24,4,1,9,17,0,1,1,1,0.58,0.5455,0.3,0.0,89,499,588,588,True
15062,2012-09-24,4,1,9,18,0,1,1,1,0.54,0.5152,0.37,0.1642,95,499,594,594,True
15063,2012-09-24,4,1,9,19,0,1,1,1,0.52,0.5,0.39,0.1343,56,499,555,555,True
15064,2012-09-24,4,1,9,20,0,1,1,1,0.52,0.5,0.52,0.1045,52,380,432,432,True
15065,2012-09-24,4,1,9,21,0,1,1,1,0.5,0.4848,0.51,0.1343,26,230,256,256,True
15066,2012-09-24,4,1,9,22,0,1,1,1,0.5,0.4848,0.51,0.2239,18,154,172,172,True
15067,2012-09-24,4,1,9,23,0,1,1,1,0.46,0.4545,0.63,0.1343,11,83,94,94,True
15068,2012-09-25,4,1,9,0,0,2,1,1,0.46,0.4545,0.67,0.1642,8,56,64,64,True
15069,2012-09-25,4,1,9,1,0,2,1,1,0.44,0.4394,0.72,0.1343,2,11,13,13,True
15070,2012-09-25,4,1,9,2,0,2,1,1,0.42,0.4242,0.77,0.1343,5,9,14,14,True
15071,2012-09-25,4,1,9,3,0,2,1,1,0.42,0.4242,0.71,0.0896,2,3,5,5,True
15072,2012-09-25,4,1,9,4,0,2,1,1,0.42,0.4242,0.71,0.1343,2,7,9,9,True
15073,2012-09-25,4,1,9,5,0,2,1,1,0.42,0.4242,0.77,0.0896,1,46,47,47,True
15074,2012-09-25,4,1,9,6,0,2,1,1,0.44,0.4394,0.77,0.2239,5,189,194,194,True
15075,2012-09-25,4,1,9,7,0,2,1,1,0.44,0.4394,0.77,0.194,17,499,516,516,True
15076,2012-09-25,4,1,9,8,0,2,1,1,0.48,0.4697,0.67,0.194,41,499,540,540,True
15077,2012-09-25,4,1,9,9,0,2,1,1,0.54,0.5152,0.56,0.2537,28,381,409,409,True
15078,2012-09-25,4,1,9,10,0,2,1,1,0.56,0.5303,0.52,0.2985,45,125,170,170,True
15079,2012-09-25,4,1,9,11,0,2,1,1,0.6,0.6212,0.46,0.2985,63,155,218,218,True
15080,2012-09-25,4,1,9,12,0,2,1,1,0.62,0.6212,0.43,0.2836,69,233,302,302,True
15081,2012-09-25,4,1,9,13,0,2,1,1,0.64,0.6212,0.47,0.2537,48,257,305,305,True
15082,2012-09-25,4,1,9,14,0,2,1,1,0.66,0.6212,0.39,0.3284,80,213,293,293,True
15083,2012-09-25,4,1,9,15,0,2,1,1,0.66,0.6212,0.36,0.3284,56,247,303,303,True
15084,2012-09-25,4,1,9,16,0,2,1,1,0.66,0.6212,0.39,0.2985,59,436,495,495,True
15085,2012-09-25,4,1,9,17,0,2,1,1,0.66,0.6212,0.39,0.2836,107,499,606,606,True
15086,2012-09-25,4,1,9,18,0,2,1,1,0.64,0.6212,0.41,0.2239,64,499,563,563,True
15087,2012-09-25,4,1,9,19,0,2,1,1,0.62,0.6212,0.5,0.2537,49,490,539,539,True
15088,2012-09-25,4,1,9,20,0,2,1,1,0.6,0.6212,0.56,0.2985,37,388,425,425,True
15089,2012-09-25,4,1,9,21,0,2,1,1,0.6,0.6212,0.56,0.2985,34,263,297,297,True
15090,2012-09-25,4,1,9,22,0,2,1,1,0.6,0.6212,0.56,0.2836,14,174,188,188,True
15091,2012-09-25,4,1,9,23,0,2,1,1,0.6,0.6212,0.56,0.3284,9,89,98,98,True
15092,2012-09-26,4,1,9,0,0,3,1,1,0.58,0.5455,0.64,0.2985,6,34,40,40,True
15093,2012-09-26,4,1,9,1,0,3,1,1,0.58,0.5455,0.64,0.3284,10,19,29,29,True
15094,2012-09-26,4,1,9,2,0,3,1,2,0.58,0.5455,0.64,0.2836,2,15,17,17,True
15095,2012-09-26,4,1,9,3,0,3,1,2,0.58,0.5455,0.64,0.2836,4,6,10,10,True
15096,2012-09-26,4,1,9,4,0,3,1,1,0.56,0.5303,0.73,0.2537,2,12,14,14,True
15097,2012-09-26,4,1,9,5,0,3,1,1,0.56,0.5303,0.73,0.2239,1,35,36,36,True
15098,2012-09-26,4,1,9,6,0,3,1,1,0.54,0.5152,0.73,0.194,3,179,182,182,True
15099,2012-09-26,4,1,9,7,0,3,1,1,0.54,0.5152,0.77,0.1343,9,499,508,508,True
15100,2012-09-26,4,1,9,8,0,3,1,1,0.56,0.5303,0.73,0.2985,30,499,529,529,True
15101,2012-09-26,4,1,9,9,0,3,1,1,0.6,0.6061,0.64,0.194,27,307,334,334,True
15102,2012-09-26,4,1,9,10,0,3,1,1,0.6,0.5909,0.73,0.2836,29,156,185,185,True
15103,2012-09-26,4,1,9,11,0,3,1,1,0.64,0.6212,0.61,0.2537,46,181,227,227,True
15104,2012-09-26,4,1,9,12,0,3,1,1,0.68,0.6364,0.61,0.2239,56,260,316,316,True
15105,2012-09-26,4,1,9,13,0,3,1,1,0.7,0.6515,0.58,0.2239,67,273,340,340,True
15106,2012-09-26,4,1,9,14,0,3,1,1,0.74,0.6667,0.48,0.2836,60,217,277,277,True
15107,2012-09-26,4,1,9,15,0,3,1,1,0.74,0.6667,0.48,0.2985,69,231,300,300,True
15108,2012-09-26,4,1,9,16,0,3,1,1,0.74,0.6667,0.45,0.2836,71,397,468,468,True
15109,2012-09-26,4,1,9,17,0,3,1,1,0.74,0.6667,0.48,0.2985,77,499,576,576,True
15110,2012-09-26,4,1,9,18,0,3,1,1,0.74,0.6667,0.48,0.2239,69,499,568,568,True
15111,2012-09-26,4,1,9,19,0,3,1,1,0.7,0.6515,0.54,0.1642,38,499,537,537,True
15112,2012-09-26,4,1,9,20,0,3,1,1,0.66,0.6212,0.69,0.194,45,389,434,434,True
15113,2012-09-26,4,1,9,21,0,3,1,1,0.66,0.6212,0.65,0.194,32,328,360,360,True
15114,2012-09-26,4,1,9,22,0,3,1,3,0.62,0.6061,0.69,0.194,21,194,215,215,True
15115,2012-09-26,4,1,9,23,0,3,1,2,0.6,0.5758,0.78,0.2537,13,102,115,115,True
15116,2012-09-27,4,1,9,0,0,4,1,1,0.6,0.5758,0.78,0.0896,5,60,65,65,True
15117,2012-09-27,4,1,9,1,0,4,1,1,0.6,0.5758,0.78,0.0896,5,16,21,21,True
15118,2012-09-27,4,1,9,2,0,4,1,1,0.6,0.5758,0.78,0.0896,3,13,16,16,True
15119,2012-09-27,4,1,9,3,0,4,1,1,0.6,0.5758,0.78,0.0,0,7,7,7,True
15120,2012-09-27,4,1,9,4,0,4,1,1,0.56,0.5303,0.94,0.1343,2,6,8,8,True
15121,2012-09-27,4,1,9,5,0,4,1,1,0.58,0.5455,0.83,0.0,2,64,66,66,True
15122,2012-09-27,4,1,9,6,0,4,1,1,0.56,0.5303,0.88,0.0896,5,164,169,169,True
15123,2012-09-27,4,1,9,7,0,4,1,1,0.6,0.5758,0.78,0.0,12,499,511,511,True
15124,2012-09-27,4,1,9,8,0,4,1,1,0.62,0.6061,0.71,0.0896,20,499,519,519,True
15125,2012-09-27,4,1,9,9,0,4,1,1,0.66,0.6212,0.65,0.0,30,305,335,335,True
15126,2012-09-27,4,1,9,10,0,4,1,2,0.7,0.6515,0.51,0.2836,40,168,208,208,True
15127,2012-09-27,4,1,9,11,0,4,1,2,0.72,0.6667,0.51,0.1642,67,227,294,294,True
15128,2012-09-27,4,1,9,12,0,4,1,2,0.74,0.6667,0.48,0.1343,63,272,335,335,True
15129,2012-09-27,4,1,9,13,0,4,1,2,0.74,0.6667,0.48,0.0,61,265,326,326,True
15130,2012-09-27,4,1,9,14,0,4,1,2,0.76,0.6818,0.45,0.0896,44,214,258,258,True
15131,2012-09-27,4,1,9,15,0,4,1,2,0.76,0.6818,0.45,0.0,41,255,296,296,True
15132,2012-09-27,4,1,9,16,0,4,1,2,0.72,0.6667,0.58,0.3284,73,399,472,472,True
15133,2012-09-27,4,1,9,17,0,4,1,2,0.66,0.6212,0.69,0.2985,87,499,586,586,True
15134,2012-09-27,4,1,9,18,0,4,1,2,0.66,0.6212,0.69,0.2239,77,499,576,576,True
15135,2012-09-27,4,1,9,19,0,4,1,1,0.66,0.6212,0.65,0.1343,48,499,547,547,True
15136,2012-09-27,4,1,9,20,0,4,1,2,0.64,0.6061,0.69,0.2239,45,412,457,457,True
15137,2012-09-27,4,1,9,21,0,4,1,3,0.62,0.5758,0.83,0.2985,18,235,253,253,True
15138,2012-09-27,4,1,9,22,0,4,1,3,0.62,0.5758,0.83,0.2985,2,45,47,47,True
15139,2012-09-27,4,1,9,23,0,4,1,3,0.62,0.5758,0.83,0.1642,1,44,45,45,True
15140,2012-09-28,4,1,9,0,0,5,1,3,0.6,0.5455,0.88,0.1642,2,15,17,17,True
15141,2012-09-28,4,1,9,1,0,5,1,3,0.6,0.5455,0.88,0.0,0,13,13,13,True
15142,2012-09-28,4,1,9,2,0,5,1,3,0.6,0.5455,0.88,0.2985,1,9,10,10,True
15143,2012-09-28,4,1,9,3,0,5,1,2,0.6,0.5606,0.83,0.1343,0,7,7,7,True
15144,2012-09-28,4,1,9,4,0,5,1,3,0.56,0.5303,0.88,0.1045,2,10,12,12,True
15145,2012-09-28,4,1,9,5,0,5,1,1,0.56,0.5303,0.88,0.0,1,37,38,38,True
15146,2012-09-28,4,1,9,6,0,5,1,2,0.56,0.5303,0.94,0.0896,2,136,138,138,True
15147,2012-09-28,4,1,9,7,0,5,1,2,0.56,0.5303,0.94,0.0,10,384,394,394,True
15148,2012-09-28,4,1,9,8,0,5,1,1,0.6,0.5606,0.83,0.0896,31,499,530,530,True
15149,2012-09-28,4,1,9,9,0,5,1,2,0.62,0.5758,0.83,0.1045,27,399,426,426,True
15150,2012-09-28,4,1,9,10,0,5,1,2,0.64,0.5909,0.78,0.1343,51,194,245,245,True
15151,2012-09-28,4,1,9,11,0,5,1,2,0.66,0.6212,0.69,0.0,109,252,361,361,True
15152,2012-09-28,4,1,9,12,0,5,1,2,0.7,0.6515,0.54,0.2537,94,286,380,380,True
15153,2012-09-28,4,1,9,13,0,5,1,2,0.7,0.6515,0.51,0.2537,106,304,410,410,True
15154,2012-09-28,4,1,9,14,0,5,1,2,0.7,0.6515,0.54,0.2537,105,294,399,399,True
15155,2012-09-28,4,1,9,15,0,5,1,2,0.68,0.6364,0.54,0.2836,104,288,392,392,True
15156,2012-09-28,4,1,9,16,0,5,1,2,0.66,0.6212,0.5,0.2239,83,419,502,502,True
15157,2012-09-28,4,1,9,17,0,5,1,2,0.66,0.6212,0.54,0.2985,101,499,600,600,True
15158,2012-09-28,4,1,9,18,0,5,1,2,0.64,0.6212,0.5,0.2239,58,499,557,557,True
15159,2012-09-28,4,1,9,19,0,5,1,3,0.62,0.6212,0.5,0.2537,38,470,508,508,True
15160,2012-09-28,4,1,9,20,0,5,1,3,0.6,0.6212,0.53,0.1642,32,304,336,336,True
15161,2012-09-28,4,1,9,21,0,5,1,3,0.6,0.6212,0.53,0.194,32,205,237,237,True
15162,2012-09-28,4,1,9,22,0,5,1,2,0.58,0.5455,0.53,0.2239,30,190,220,220,True
15163,2012-09-28,4,1,9,23,0,5,1,2,0.56,0.5303,0.56,0.194,26,164,190,190,True
15164,2012-09-29,4,1,9,0,0,6,0,1,0.54,0.5152,0.6,0.2239,15,134,149,149,True
15165,2012-09-29,4,1,9,1,0,6,0,1,0.54,0.5152,0.6,0.2239,12,89,101,101,True
15166,2012-09-29,4,1,9,2,0,6,0,2,0.54,0.5152,0.56,0.2239,12,80,92,92,True
15167,2012-09-29,4,1,9,3,0,6,0,2,0.52,0.5,0.59,0.194,4,25,29,29,True
15168,2012-09-29,4,1,9,4,0,6,0,1,0.52,0.5,0.59,0.2537,6,8,14,14,True
15169,2012-09-29,4,1,9,5,0,6,0,1,0.5,0.4848,0.63,0.194,2,13,15,15,True
15170,2012-09-29,4,1,9,6,0,6,0,1,0.5,0.4848,0.63,0.2537,4,33,37,37,True
15171,2012-09-29,4,1,9,7,0,6,0,1,0.48,0.4697,0.67,0.2836,12,61,73,73,True
15172,2012-09-29,4,1,9,8,0,6,0,1,0.5,0.4848,0.68,0.2836,37,174,211,211,True
15173,2012-09-29,4,1,9,9,0,6,0,1,0.5,0.4848,0.63,0.194,69,263,332,332,True
15174,2012-09-29,4,1,9,10,0,6,0,1,0.54,0.5152,0.56,0.2537,114,338,452,452,True
15175,2012-09-29,4,1,9,11,0,6,0,1,0.56,0.5303,0.52,0.2836,114,446,560,560,True
15176,2012-09-29,4,1,9,12,0,6,0,1,0.62,0.6212,0.41,0.2985,114,491,605,605,True
15177,2012-09-29,4,1,9,13,0,6,0,1,0.62,0.6212,0.41,0.2985,114,453,567,567,True
15178,2012-09-29,4,1,9,14,0,6,0,1,0.6,0.6212,0.4,0.2537,114,448,562,562,True
15179,2012-09-29,4,1,9,15,0,6,0,1,0.6,0.6212,0.43,0.2537,114,456,570,570,True
15180,2012-09-29,4,1,9,16,0,6,0,1,0.62,0.6212,0.41,0.2537,114,447,561,561,True
15181,2012-09-29,4,1,9,17,0,6,0,1,0.6,0.6212,0.38,0.3582,114,456,570,570,True
15182,2012-09-29,4,1,9,18,0,6,0,1,0.56,0.5303,0.46,0.194,114,420,534,534,True
15183,2012-09-29,4,1,9,19,0,6,0,1,0.52,0.5,0.55,0.1642,114,351,465,465,True
15184,2012-09-29,4,1,9,20,0,6,0,1,0.52,0.5,0.55,0.194,88,227,315,315,True
15185,2012-09-29,4,1,9,21,0,6,0,1,0.52,0.5,0.55,0.1343,73,219,292,292,True
15186,2012-09-29,4,1,9,22,0,6,0,1,0.5,0.4848,0.63,0.1045,48,173,221,221,True
15187,2012-09-29,4,1,9,23,0,6,0,1,0.5,0.4848,0.59,0.0896,35,161,196,196,True
15188,2012-09-30,4,1,9,0,0,0,0,1,0.5,0.4848,0.59,0.0,35,112,147,147,True
15189,2012-09-30,4,1,9,1,0,0,0,1,0.5,0.4848,0.59,0.0,31,85,116,116,True
15190,2012-09-30,4,1,9,2,0,0,0,1,0.48,0.4697,0.63,0.0,21,71,92,92,True
15191,2012-09-30,4,1,9,3,0,0,0,1,0.46,0.4545,0.67,0.0896,17,41,58,58,True
15192,2012-09-30,4,1,9,4,0,0,0,1,0.46,0.4545,0.67,0.0896,1,6,7,7,True
15193,2012-09-30,4,1,9,5,0,0,0,1,0.44,0.4394,0.72,0.0,1,9,10,10,True
15194,2012-09-30,4,1,9,6,0,0,0,1,0.44,0.4394,0.72,0.0896,2,20,22,22,True
15195,2012-09-30,4,1,9,7,0,0,0,1,0.44,0.4394,0.77,0.0,14,43,57,57,True
15196,2012-09-30,4,1,9,8,0,0,0,1,0.48,0.4697,0.67,0.1045,18,126,144,144,True
15197,2012-09-30,4,1,9,9,0,0,0,1,0.52,0.5,0.63,0.1045,74,211,285,285,True
15198,2012-09-30,4,1,9,10,0,0,0,1,0.58,0.5455,0.46,0.1642,114,319,433,433,True
15199,2012-09-30,4,1,9,11,0,0,0,1,0.6,0.6212,0.43,0.2239,114,369,483,483,True
15200,2012-09-30,4,1,9,12,0,0,0,1,0.62,0.6212,0.41,0.2985,114,474,588,588,True
15201,2012-09-30,4,1,9,13,0,0,0,1,0.62,0.6212,0.41,0.2537,114,414,528,528,True
15202,2012-09-30,4,1,9,14,0,0,0,1,0.62,0.6212,0.41,0.2537,114,404,518,518,True
15203,2012-09-30,4,1,9,15,0,0,0,1,0.64,0.6212,0.36,0.2537,114,419,533,533,True
15204,2012-09-30,4,1,9,16,0,0,0,1,0.64,0.6212,0.36,0.2239,114,446,560,560,True
15205,2012-09-30,4,1,9,17,0,0,0,1,0.62,0.6212,0.35,0.2836,114,380,494,494,True
15206,2012-09-30,4,1,9,18,0,0,0,1,0.52,0.5,0.59,0.4478,91,310,401,401,True
15207,2012-09-30,4,1,9,19,0,0,0,3,0.5,0.4848,0.72,0.1343,34,223,257,257,True
15208,2012-09-30,4,1,9,20,0,0,0,3,0.5,0.4848,0.72,0.1343,31,163,194,194,True
15209,2012-09-30,4,1,9,21,0,0,0,1,0.5,0.4848,0.68,0.0,19,104,123,123,True
15210,2012-09-30,4,1,9,22,0,0,0,1,0.48,0.4697,0.72,0.0,15,76,91,91,True
15211,2012-09-30,4,1,9,23,0,0,0,1,0.48,0.4697,0.72,0.0896,8,49,57,57,True
15212,2012-10-01,4,1,10,0,0,1,1,1,0.46,0.4545,0.72,0.1045,6,39,45,45,True
15213,2012-10-01,4,1,10,1,0,1,1,1,0.44,0.4394,0.77,0.0896,5,13,18,18,True
15214,2012-10-01,4,1,10,2,0,1,1,1,0.46,0.4545,0.72,0.0,6,6,12,12,True
15215,2012-10-01,4,1,10,3,0,1,1,1,0.44,0.4394,0.77,0.0,1,6,7,7,True
15216,2012-10-01,4,1,10,4,0,1,1,1,0.42,0.4242,0.82,0.1045,0,10,10,10,True
15217,2012-10-01,4,1,10,5,0,1,1,1,0.44,0.4394,0.77,0.0,2,34,36,36,True
15218,2012-10-01,4,1,10,6,0,1,1,1,0.44,0.4394,0.77,0.1045,8,147,155,155,True
15219,2012-10-01,4,1,10,7,0,1,1,1,0.44,0.4394,0.77,0.1642,13,470,483,483,True
15220,2012-10-01,4,1,10,8,0,1,1,2,0.46,0.4545,0.77,0.1045,40,499,539,539,True
15221,2012-10-01,4,1,10,9,0,1,1,2,0.52,0.5,0.63,0.0,26,314,340,340,True
15222,2012-10-01,4,1,10,10,0,1,1,1,0.54,0.5152,0.56,0.0,44,135,179,179,True
15223,2012-10-01,4,1,10,11,0,1,1,1,0.58,0.5455,0.46,0.0,76,196,272,272,True
15224,2012-10-01,4,1,10,12,0,1,1,2,0.6,0.6212,0.43,0.1642,61,262,323,323,True
15225,2012-10-01,4,1,10,13,0,1,1,2,0.6,0.6212,0.43,0.1642,80,225,305,305,True
15226,2012-10-01,4,1,10,14,0,1,1,2,0.6,0.6212,0.43,0.1045,51,193,244,244,True
15227,2012-10-01,4,1,10,15,0,1,1,2,0.62,0.6212,0.43,0.1343,95,234,329,329,True
15228,2012-10-01,4,1,10,16,0,1,1,2,0.62,0.6212,0.46,0.2537,51,408,459,459,True
15229,2012-10-01,4,1,10,17,0,1,1,3,0.56,0.5303,0.6,0.2537,65,499,564,564,True
15230,2012-10-01,4,1,10,18,0,1,1,3,0.56,0.5303,0.64,0.1045,42,499,541,541,True
15231,2012-10-01,4,1,10,19,0,1,1,2,0.54,0.5152,0.68,0.1045,33,483,516,516,True
15232,2012-10-01,4,1,10,20,0,1,1,3,0.54,0.5152,0.68,0.0,11,251,262,262,True
15233,2012-10-01,4,1,10,21,0,1,1,2,0.54,0.5152,0.73,0.1343,13,205,218,218,True
15234,2012-10-01,4,1,10,22,0,1,1,3,0.54,0.5152,0.77,0.0896,17,190,207,207,True
15235,2012-10-01,4,1,10,23,0,1,1,3,0.54,0.5152,0.77,0.0,17,88,105,105,True
15236,2012-10-02,4,1,10,0,0,2,1,2,0.56,0.5303,0.73,0.0,1,30,31,31,True
15237,2012-10-02,4,1,10,1,0,2,1,2,0.54,0.5152,0.77,0.1045,0,11,11,11,True
15238,2012-10-02,4,1,10,2,0,2,1,2,0.54,0.5152,0.77,0.1045,0,2,2,2,True
15239,2012-10-02,4,1,10,3,0,2,1,2,0.54,0.5152,0.88,0.194,1,4,5,5,True
15240,2012-10-02,4,1,10,4,0,2,1,2,0.56,0.5303,0.83,0.0896,2,8,10,10,True
15241,2012-10-02,4,1,10,5,0,2,1,2,0.56,0.5303,0.83,0.1343,1,42,43,43,True
15242,2012-10-02,4,1,10,6,0,2,1,3,0.58,0.5455,0.83,0.1045,3,176,179,179,True
15243,2012-10-02,4,1,10,7,0,2,1,3,0.58,0.5455,0.83,0.1045,4,256,260,260,True
15244,2012-10-02,4,1,10,8,0,2,1,3,0.6,0.5455,0.88,0.0,6,128,134,134,True
15245,2012-10-02,4,1,10,9,0,2,1,3,0.58,0.5455,0.88,0.1343,3,83,86,86,True
15246,2012-10-02,4,1,10,10,0,2,1,3,0.58,0.5455,0.88,0.1343,3,42,45,45,True
15247,2012-10-02,4,1,10,11,0,2,1,3,0.58,0.5455,0.94,0.1343,7,92,99,99,True
15248,2012-10-02,4,1,10,12,0,2,1,2,0.6,0.5455,0.88,0.194,6,98,104,104,True
15249,2012-10-02,4,1,10,13,0,2,1,2,0.6,0.5455,0.88,0.1343,6,148,154,154,True
15250,2012-10-02,4,1,10,14,0,2,1,3,0.6,0.5455,0.88,0.1343,16,147,163,163,True
15251,2012-10-02,4,1,10,15,0,2,1,3,0.62,0.5758,0.83,0.1343,14,195,209,209,True
15252,2012-10-02,4,1,10,16,0,2,1,3,0.62,0.5606,0.88,0.1343,46,328,374,374,True
15253,2012-10-02,4,1,10,17,0,2,1,3,0.62,0.5606,0.88,0.1045,38,499,537,537,True
15254,2012-10-02,4,1,10,18,0,2,1,3,0.62,0.5455,0.94,0.0896,48,499,547,547,True
15255,2012-10-02,4,1,10,19,0,2,1,3,0.62,0.5455,0.94,0.0,27,368,395,395,True
15256,2012-10-02,4,1,10,20,0,2,1,3,0.62,0.5455,0.94,0.1343,20,286,306,306,True
15257,2012-10-02,4,1,10,21,0,2,1,3,0.62,0.5455,0.94,0.1045,24,265,289,289,True
15258,2012-10-02,4,1,10,22,0,2,1,2,0.62,0.5455,0.94,0.1045,28,212,240,240,True
15259,2012-10-02,4,1,10,23,0,2,1,2,0.62,0.5455,0.94,0.0,11,87,98,98,True
15260,2012-10-03,4,1,10,0,0,3,1,3,0.62,0.5455,0.94,0.0,5,47,52,52,True
15261,2012-10-03,4,1,10,1,0,3,1,2,0.62,0.5455,0.94,0.0,3,16,19,19,True
15262,2012-10-03,4,1,10,2,0,3,1,2,0.62,0.5455,0.94,0.0,2,7,9,9,True
15263,2012-10-03,4,1,10,3,0,3,1,2,0.6,0.5152,0.94,0.0,0,7,7,7,True
15264,2012-10-03,4,1,10,4,0,3,1,2,0.6,0.5,1.0,0.0,2,9,11,11,True
15265,2012-10-03,4,1,10,5,0,3,1,2,0.62,0.5455,0.94,0.1045,2,32,34,34,True
15266,2012-10-03,4,1,10,6,0,3,1,2,0.6,0.5152,0.94,0.1343,4,173,177,177,True
15267,2012-10-03,4,1,10,7,0,3,1,2,0.6,0.5152,0.94,0.194,11,499,510,510,True
15268,2012-10-03,4,1,10,8,0,3,1,2,0.62,0.5606,0.88,0.1045,28,499,527,527,True
15269,2012-10-03,4,1,10,9,0,3,1,2,0.62,0.5758,0.83,0.194,30,332,362,362,True
15270,2012-10-03,4,1,10,10,0,3,1,1,0.66,0.6061,0.78,0.1642,29,146,175,175,True
15271,2012-10-03,4,1,10,11,0,3,1,1,0.66,0.6061,0.78,0.1642,52,178,230,230,True
15272,2012-10-03,4,1,10,12,0,3,1,2,0.7,0.6515,0.7,0.1045,69,289,358,358,True
15273,2012-10-03,4,1,10,13,0,3,1,2,0.7,0.6667,0.74,0.1045,55,224,279,279,True
15274,2012-10-03,4,1,10,14,0,3,1,2,0.72,0.6818,0.7,0.1642,56,195,251,251,True
15275,2012-10-03,4,1,10,15,0,3,1,2,0.72,0.6818,0.62,0.1642,59,260,319,319,True
15276,2012-10-03,4,1,10,16,0,3,1,2,0.72,0.6667,0.58,0.0,42,436,478,478,True
15277,2012-10-03,4,1,10,17,0,3,1,1,0.7,0.6515,0.65,0.0,84,499,583,583,True
15278,2012-10-03,4,1,10,18,0,3,1,1,0.7,0.6515,0.65,0.0,54,499,553,553,True
15279,2012-10-03,4,1,10,19,0,3,1,1,0.7,0.6515,0.65,0.0,49,499,548,548,True
15280,2012-10-03,4,1,10,20,0,3,1,1,0.7,0.6515,0.65,0.0,48,449,497,497,True
15281,2012-10-03,4,1,10,21,0,3,1,2,0.66,0.6212,0.74,0.0,14,195,209,209,True
15282,2012-10-03,4,1,10,22,0,3,1,1,0.66,0.6212,0.74,0.0,9,232,241,241,True
15283,2012-10-03,4,1,10,23,0,3,1,2,0.66,0.6061,0.78,0.0,21,199,220,220,True
15284,2012-10-04,4,1,10,0,0,4,1,3,0.64,0.5758,0.89,0.0,11,65,76,76,True
15285,2012-10-04,4,1,10,1,0,4,1,2,0.62,0.5455,0.94,0.0,2,23,25,25,True
15286,2012-10-04,4,1,10,2,0,4,1,1,0.64,0.5758,0.89,0.0,3,10,13,13,True
15287,2012-10-04,4,1,10,3,0,4,1,2,0.62,0.5606,0.88,0.0,5,6,11,11,True
15288,2012-10-04,4,1,10,4,0,4,1,2,0.64,0.5758,0.89,0.0,0,10,10,10,True
15289,2012-10-04,4,1,10,5,0,4,1,3,0.64,0.5758,0.89,0.1045,2,37,39,39,True
15290,2012-10-04,4,1,10,6,0,4,1,3,0.62,0.5455,0.94,0.0896,1,132,133,133,True
15291,2012-10-04,4,1,10,7,0,4,1,2,0.64,0.5758,0.89,0.0896,12,379,391,391,True
15292,2012-10-04,4,1,10,8,0,4,1,1,0.64,0.5758,0.89,0.0,27,499,526,526,True
15293,2012-10-04,4,1,10,9,0,4,1,2,0.64,0.5758,0.89,0.194,40,319,359,359,True
15294,2012-10-04,4,1,10,10,0,4,1,2,0.66,0.6061,0.83,0.1343,27,150,177,177,True
15295,2012-10-04,4,1,10,11,0,4,1,2,0.7,0.6515,0.7,0.1045,38,176,214,214,True
15296,2012-10-04,4,1,10,12,0,4,1,2,0.72,0.6667,0.54,0.194,57,231,288,288,True
15297,2012-10-04,4,1,10,13,0,4,1,2,0.72,0.6667,0.58,0.3284,63,231,294,294,True
15298,2012-10-04,4,1,10,14,0,4,1,1,0.7,0.6515,0.61,0.2537,56,211,267,267,True
15299,2012-10-04,4,1,10,15,0,4,1,1,0.72,0.6667,0.54,0.2836,77,248,325,325,True
15300,2012-10-04,4,1,10,16,0,4,1,1,0.7,0.6515,0.54,0.2836,86,411,497,497,True
15301,2012-10-04,4,1,10,17,0,4,1,1,0.7,0.6515,0.51,0.2239,112,499,611,611,True
15302,2012-10-04,4,1,10,18,0,4,1,1,0.66,0.6212,0.57,0.1045,75,499,574,574,True
15303,2012-10-04,4,1,10,19,0,4,1,1,0.66,0.6212,0.57,0.1045,67,467,534,534,True
15304,2012-10-04,4,1,10,20,0,4,1,1,0.64,0.6061,0.65,0.1045,50,391,441,441,True
15305,2012-10-04,4,1,10,21,0,4,1,1,0.62,0.6061,0.69,0.0,33,288,321,321,True
15306,2012-10-04,4,1,10,22,0,4,1,1,0.64,0.6212,0.47,0.1343,29,203,232,232,True
15307,2012-10-04,4,1,10,23,0,4,1,1,0.6,0.6212,0.56,0.0896,18,137,155,155,True
15308,2012-10-05,4,1,10,0,0,5,1,1,0.56,0.5303,0.73,0.0,16,86,102,102,True
15309,2012-10-05,4,1,10,1,0,5,1,1,0.54,0.5152,0.68,0.1045,3,43,46,46,True
15310,2012-10-05,4,1,10,2,0,5,1,1,0.54,0.5152,0.73,0.0896,1,10,11,11,True
15311,2012-10-05,4,1,10,3,0,5,1,1,0.54,0.5152,0.73,0.0,5,11,16,16,True
15312,2012-10-05,4,1,10,4,0,5,1,1,0.54,0.5152,0.77,0.0,0,11,11,11,True
15313,2012-10-05,4,1,10,5,0,5,1,1,0.52,0.5,0.77,0.0,0,41,41,41,True
15314,2012-10-05,4,1,10,6,0,5,1,1,0.52,0.5,0.83,0.0,4,133,137,137,True
15315,2012-10-05,4,1,10,7,0,5,1,1,0.52,0.5,0.83,0.1045,11,417,428,428,True
15316,2012-10-05,4,1,10,8,0,5,1,1,0.58,0.5455,0.64,0.0,36,499,535,535,True
15317,2012-10-05,4,1,10,9,0,5,1,1,0.6,0.6061,0.6,0.0896,58,326,384,384,True
15318,2012-10-05,4,1,10,10,0,5,1,1,0.66,0.6212,0.54,0.0,68,192,260,260,True
15319,2012-10-05,4,1,10,11,0,5,1,1,0.7,0.6515,0.48,0.194,90,214,304,304,True
15320,2012-10-05,4,1,10,12,0,5,1,1,0.72,0.6515,0.42,0.1642,114,307,421,421,True
15321,2012-10-05,4,1,10,13,0,5,1,1,0.7,0.6515,0.48,0.0,114,307,421,421,True
15322,2012-10-05,4,1,10,14,0,5,1,1,0.74,0.6515,0.37,0.2239,113,287,400,400,True
15323,2012-10-05,4,1,10,15,0,5,1,1,0.72,0.6515,0.39,0.2537,114,320,434,434,True
15324,2012-10-05,4,1,10,16,0,5,1,1,0.72,0.6515,0.37,0.0,114,481,595,595,True
15325,2012-10-05,4,1,10,17,0,5,1,1,0.7,0.6364,0.42,0.1642,114,499,613,613,True
15326,2012-10-05,4,1,10,18,0,5,1,1,0.64,0.6212,0.57,0.1343,106,499,605,605,True
15327,2012-10-05,4,1,10,19,0,5,1,1,0.62,0.5909,0.73,0.1642,67,433,500,500,True
15328,2012-10-05,4,1,10,20,0,5,1,1,0.6,0.5758,0.78,0.1343,66,306,372,372,True
15329,2012-10-05,4,1,10,21,0,5,1,1,0.6,0.5909,0.69,0.2239,47,220,267,267,True
15330,2012-10-05,4,1,10,22,0,5,1,1,0.6,0.5909,0.73,0.2836,63,201,264,264,True
15331,2012-10-05,4,1,10,23,0,5,1,1,0.58,0.5455,0.78,0.2239,23,148,171,171,True
15332,2012-10-06,4,1,10,0,0,6,0,1,0.56,0.5303,0.83,0.1642,37,154,191,191,True
15333,2012-10-06,4,1,10,1,0,6,0,1,0.56,0.5303,0.83,0.2537,25,116,141,141,True
15334,2012-10-06,4,1,10,2,0,6,0,1,0.56,0.5303,0.78,0.194,13,62,75,75,True
15335,2012-10-06,4,1,10,3,0,6,0,1,0.54,0.5152,0.77,0.2239,2,54,56,56,True
15336,2012-10-06,4,1,10,4,0,6,0,1,0.54,0.5152,0.83,0.2537,4,7,11,11,True
15337,2012-10-06,4,1,10,5,0,6,0,1,0.54,0.5152,0.83,0.194,2,8,10,10,True
15338,2012-10-06,4,1,10,6,0,6,0,1,0.54,0.5152,0.88,0.2537,2,28,30,30,True
15339,2012-10-06,4,1,10,7,0,6,0,1,0.54,0.5152,0.83,0.2985,13,71,84,84,True
15340,2012-10-06,4,1,10,8,0,6,0,1,0.56,0.5303,0.83,0.194,22,184,206,206,True
15341,2012-10-06,4,1,10,9,0,6,0,1,0.6,0.5909,0.73,0.194,114,265,379,379,True
15342,2012-10-06,4,1,10,10,0,6,0,1,0.62,0.6061,0.69,0.2836,114,341,455,455,True
15343,2012-10-06,4,1,10,11,0,6,0,1,0.64,0.6061,0.65,0.2537,114,389,503,503,True
15344,2012-10-06,4,1,10,12,0,6,0,1,0.7,0.6515,0.54,0.1045,114,381,495,495,True
15345,2012-10-06,4,1,10,13,0,6,0,2,0.64,0.6212,0.57,0.4775,114,400,514,514,True
15346,2012-10-06,4,1,10,14,0,6,0,2,0.6,0.6212,0.56,0.4179,114,307,421,421,True
15347,2012-10-06,4,1,10,15,0,6,0,1,0.6,0.6212,0.46,0.4179,114,341,455,455,True
15348,2012-10-06,4,1,10,16,0,6,0,1,0.6,0.6212,0.43,0.4775,114,342,456,456,True
15349,2012-10-06,4,1,10,17,0,6,0,1,0.54,0.5152,0.49,0.3881,114,342,456,456,True
15350,2012-10-06,4,1,10,18,0,6,0,1,0.52,0.5,0.48,0.4179,114,312,426,426,True
15351,2012-10-06,4,1,10,19,0,6,0,1,0.48,0.4697,0.55,0.2239,102,239,341,341,True
15352,2012-10-06,4,1,10,20,0,6,0,1,0.48,0.4697,0.55,0.2537,75,172,247,247,True
15353,2012-10-06,4,1,10,21,0,6,0,1,0.46,0.4545,0.59,0.1343,78,137,215,215,True
15354,2012-10-06,4,1,10,22,0,6,0,1,0.44,0.4394,0.62,0.1343,45,140,185,185,True
15355,2012-10-06,4,1,10,23,0,6,0,1,0.44,0.4394,0.62,0.1343,37,142,179,179,True
15356,2012-10-07,4,1,10,0,0,0,0,1,0.44,0.4394,0.62,0.1642,28,99,127,127,True
15357,2012-10-07,4,1,10,1,0,0,0,1,0.44,0.4394,0.54,0.2239,29,80,109,109,True
15358,2012-10-07,4,1,10,2,0,0,0,1,0.42,0.4242,0.62,0.1343,10,64,74,74,True
15359,2012-10-07,4,1,10,3,0,0,0,2,0.44,0.4394,0.62,0.1343,5,17,22,22,True
15360,2012-10-07,4,1,10,4,0,0,0,2,0.44,0.4394,0.54,0.2537,5,6,11,11,True
15361,2012-10-07,4,1,10,5,0,0,0,2,0.44,0.4394,0.54,0.1343,2,8,10,10,True
15362,2012-10-07,4,1,10,6,0,0,0,2,0.44,0.4394,0.54,0.194,4,19,23,23,True
15363,2012-10-07,4,1,10,7,0,0,0,3,0.42,0.4242,0.58,0.1642,6,29,35,35,True
15364,2012-10-07,4,1,10,8,0,0,0,3,0.42,0.4242,0.67,0.1343,11,51,62,62,True
15365,2012-10-07,4,1,10,9,0,0,0,3,0.4,0.4091,0.71,0.1343,16,70,86,86,True
15366,2012-10-07,4,1,10,10,0,0,0,2,0.42,0.4242,0.67,0.194,41,144,185,185,True
15367,2012-10-07,4,1,10,11,0,0,0,2,0.42,0.4242,0.71,0.1045,76,260,336,336,True
15368,2012-10-07,4,1,10,12,0,0,0,2,0.42,0.4242,0.71,0.0,100,292,392,392,True
15369,2012-10-07,4,1,10,13,0,0,0,2,0.44,0.4394,0.72,0.0896,80,240,320,320,True
15370,2012-10-07,4,1,10,14,0,0,0,2,0.44,0.4394,0.67,0.0,71,243,314,314,True
15371,2012-10-07,4,1,10,15,0,0,0,3,0.42,0.4242,0.77,0.1343,74,232,306,306,True
15372,2012-10-07,4,1,10,16,0,0,0,3,0.4,0.4091,0.82,0.1642,87,246,333,333,True
15373,2012-10-07,4,1,10,17,0,0,0,3,0.4,0.4091,0.82,0.2239,35,122,157,157,True
15374,2012-10-07,4,1,10,18,0,0,0,3,0.4,0.4091,0.82,0.194,24,82,106,106,True
15375,2012-10-07,4,1,10,19,0,0,0,2,0.4,0.4091,0.82,0.1045,17,97,114,114,True
15376,2012-10-07,4,1,10,20,0,0,0,1,0.4,0.4091,0.82,0.1343,19,97,116,116,True
15377,2012-10-07,4,1,10,21,0,0,0,1,0.38,0.3939,0.87,0.1045,22,91,113,113,True
15378,2012-10-07,4,1,10,22,0,0,0,1,0.38,0.3939,0.87,0.1343,7,72,79,79,True
15379,2012-10-07,4,1,10,23,0,0,0,1,0.36,0.3485,0.93,0.1343,12,68,80,80,True
15380,2012-10-08,4,1,10,0,1,1,0,1,0.38,0.3939,0.76,0.2836,7,44,51,51,True
15381,2012-10-08,4,1,10,1,1,1,0,1,0.34,0.3333,0.87,0.1642,2,35,37,37,True
15382,2012-10-08,4,1,10,2,1,1,0,1,0.34,0.3333,0.81,0.194,3,12,15,15,True
15383,2012-10-08,4,1,10,3,1,1,0,1,0.34,0.3485,0.81,0.1045,2,8,10,10,True
15384,2012-10-08,4,1,10,4,1,1,0,1,0.32,0.3333,0.87,0.1343,1,6,7,7,True
15385,2012-10-08,4,1,10,5,1,1,0,1,0.34,0.3182,0.76,0.2239,2,17,19,19,True
15386,2012-10-08,4,1,10,6,1,1,0,1,0.34,0.3485,0.76,0.1045,5,54,59,59,True
15387,2012-10-08,4,1,10,7,1,1,0,2,0.34,0.3333,0.76,0.1642,3,151,154,154,True
15388,2012-10-08,4,1,10,8,1,1,0,2,0.36,0.3485,0.71,0.2239,23,374,397,397,True
15389,2012-10-08,4,1,10,9,1,1,0,2,0.38,0.3939,0.66,0.1642,59,273,332,332,True
15390,2012-10-08,4,1,10,10,1,1,0,2,0.38,0.3939,0.68,0.1343,69,229,298,298,True
15391,2012-10-08,4,1,10,11,1,1,0,2,0.4,0.4091,0.62,0.0896,72,236,308,308,True
15392,2012-10-08,4,1,10,12,1,1,0,2,0.42,0.4242,0.63,0.1642,74,267,341,341,True
15393,2012-10-08,4,1,10,13,1,1,0,2,0.42,0.4242,0.62,0.194,82,323,405,405,True
15394,2012-10-08,4,1,10,14,1,1,0,2,0.42,0.4242,0.58,0.1045,114,299,413,413,True
15395,2012-10-08,4,1,10,15,1,1,0,3,0.42,0.4242,0.58,0.194,76,294,370,370,True
15396,2012-10-08,4,1,10,16,1,1,0,3,0.42,0.4242,0.58,0.194,61,316,377,377,True
15397,2012-10-08,4,1,10,17,1,1,0,2,0.42,0.4242,0.66,0.2537,81,416,497,497,True
15398,2012-10-08,4,1,10,18,1,1,0,2,0.42,0.4242,0.66,0.2836,41,415,456,456,True
15399,2012-10-08,4,1,10,19,1,1,0,2,0.4,0.4091,0.71,0.2537,38,333,371,371,True
15400,2012-10-08,4,1,10,20,1,1,0,3,0.4,0.4091,0.71,0.2239,20,207,227,227,True
15401,2012-10-08,4,1,10,21,1,1,0,2,0.4,0.4091,0.76,0.2239,17,134,151,151,True
15402,2012-10-08,4,1,10,22,1,1,0,3,0.4,0.4091,0.76,0.2537,6,101,107,107,True
15403,2012-10-08,4,1,10,23,1,1,0,2,0.4,0.4091,0.71,0.2239,9,60,69,69,True
15404,2012-10-09,4,1,10,0,0,2,1,2,0.38,0.3939,0.82,0.2239,9,22,31,31,True
15405,2012-10-09,4,1,10,1,0,2,1,3,0.36,0.3485,0.87,0.2239,0,13,13,13,True
15406,2012-10-09,4,1,10,2,0,2,1,3,0.36,0.3333,0.87,0.2537,2,5,7,7,True
15407,2012-10-09,4,1,10,3,0,2,1,3,0.36,0.3333,0.87,0.2836,0,3,3,3,True
15408,2012-10-09,4,1,10,4,0,2,1,3,0.36,0.3485,0.87,0.1642,1,6,7,7,True
15409,2012-10-09,4,1,10,5,0,2,1,2,0.38,0.3939,0.82,0.194,0,19,19,19,True
15410,2012-10-09,4,1,10,6,0,2,1,2,0.38,0.3939,0.82,0.2537,2,141,143,143,True
15411,2012-10-09,4,1,10,7,0,2,1,1,0.38,0.3939,0.83,0.2537,5,357,362,362,True
15412,2012-10-09,4,1,10,8,0,2,1,2,0.42,0.4242,0.8,0.194,15,499,514,514,True
15413,2012-10-09,4,1,10,9,0,2,1,2,0.42,0.4242,0.77,0.2239,37,345,382,382,True
15414,2012-10-09,4,1,10,10,0,2,1,2,0.44,0.4394,0.75,0.2239,33,131,164,164,True
15415,2012-10-09,4,1,10,11,0,2,1,2,0.48,0.4697,0.69,0.194,37,156,193,193,True
15416,2012-10-09,4,1,10,12,0,2,1,2,0.48,0.4697,0.69,0.194,43,217,260,260,True
15417,2012-10-09,4,1,10,13,0,2,1,2,0.5,0.4848,0.67,0.1343,54,184,238,238,True
15418,2012-10-09,4,1,10,14,0,2,1,2,0.54,0.5152,0.64,0.194,43,201,244,244,True
15419,2012-10-09,4,1,10,15,0,2,1,2,0.52,0.5,0.63,0.1642,59,195,254,254,True
15420,2012-10-09,4,1,10,16,0,2,1,2,0.5,0.4848,0.72,0.1642,70,354,424,424,True
15421,2012-10-09,4,1,10,17,0,2,1,2,0.52,0.5,0.68,0.1642,73,499,572,572,True
15422,2012-10-09,4,1,10,18,0,2,1,2,0.5,0.4848,0.72,0.2239,26,499,525,525,True
15423,2012-10-09,4,1,10,19,0,2,1,2,0.5,0.4848,0.72,0.1642,31,483,514,514,True
15424,2012-10-09,4,1,10,20,0,2,1,2,0.5,0.4848,0.72,0.1642,30,330,360,360,True
15425,2012-10-09,4,1,10,21,0,2,1,2,0.48,0.4697,0.77,0.1343,16,209,225,225,True
15426,2012-10-09,4,1,10,22,0,2,1,2,0.48,0.4697,0.77,0.0896,7,155,162,162,True
15427,2012-10-09,4,1,10,23,0,2,1,2,0.48,0.4697,0.77,0.0896,8,76,84,84,True
15428,2012-10-10,4,1,10,0,0,3,1,2,0.46,0.4545,0.88,0.0896,0,33,33,33,True
15429,2012-10-10,4,1,10,1,0,3,1,2,0.46,0.4545,0.88,0.0,2,6,8,8,True
15430,2012-10-10,4,1,10,2,0,3,1,2,0.46,0.4545,0.88,0.0,2,6,8,8,True
15431,2012-10-10,4,1,10,3,0,3,1,2,0.46,0.4545,0.88,0.0,0,6,6,6,True
15432,2012-10-10,4,1,10,4,0,3,1,2,0.46,0.4545,0.88,0.1045,0,6,6,6,True
15433,2012-10-10,4,1,10,5,0,3,1,2,0.46,0.4545,0.88,0.0896,2,38,40,40,True
15434,2012-10-10,4,1,10,6,0,3,1,2,0.46,0.4545,0.88,0.0896,3,172,175,175,True
15435,2012-10-10,4,1,10,7,0,3,1,1,0.46,0.4545,0.82,0.1045,9,498,507,507,True
15436,2012-10-10,4,1,10,8,0,3,1,1,0.5,0.4848,0.77,0.1642,33,499,532,532,True
15437,2012-10-10,4,1,10,9,0,3,1,1,0.54,0.5152,0.6,0.2836,35,331,366,366,True
15438,2012-10-10,4,1,10,10,0,3,1,1,0.56,0.5303,0.52,0.2985,27,190,217,217,True
15439,2012-10-10,4,1,10,11,0,3,1,1,0.54,0.5152,0.52,0.194,53,238,291,291,True
15440,2012-10-10,4,1,10,12,0,3,1,1,0.54,0.5152,0.56,0.2239,78,312,390,390,True
15441,2012-10-10,4,1,10,13,0,3,1,1,0.56,0.5303,0.49,0.0,60,237,297,297,True
15442,2012-10-10,4,1,10,14,0,3,1,1,0.6,0.6212,0.4,0.1642,63,208,271,271,True
15443,2012-10-10,4,1,10,15,0,3,1,1,0.6,0.6212,0.4,0.1642,58,261,319,319,True
15444,2012-10-10,4,1,10,16,0,3,1,1,0.6,0.6212,0.4,0.2239,92,474,566,566,True
15445,2012-10-10,4,1,10,17,0,3,1,1,0.58,0.5455,0.43,0.2239,91,499,590,590,True
15446,2012-10-10,4,1,10,18,0,3,1,2,0.56,0.5303,0.49,0.1642,57,499,556,556,True
15447,2012-10-10,4,1,10,19,0,3,1,2,0.56,0.5303,0.46,0.4775,32,499,531,531,True
15448,2012-10-10,4,1,10,20,0,3,1,1,0.52,0.5,0.48,0.4775,21,371,392,392,True
15449,2012-10-10,4,1,10,21,0,3,1,1,0.5,0.4848,0.51,0.3582,18,251,269,269,True
15450,2012-10-10,4,1,10,22,0,3,1,1,0.46,0.4545,0.55,0.2985,27,170,197,197,True
15451,2012-10-10,4,1,10,23,0,3,1,1,0.44,0.4394,0.58,0.194,17,119,136,136,True
15452,2012-10-11,4,1,10,0,0,4,1,1,0.44,0.4394,0.51,0.1343,1,41,42,42,True
15453,2012-10-11,4,1,10,1,0,4,1,1,0.44,0.4394,0.47,0.194,1,10,11,11,True
15454,2012-10-11,4,1,10,2,0,4,1,1,0.42,0.4242,0.5,0.1343,4,7,11,11,True
15455,2012-10-11,4,1,10,3,0,4,1,1,0.42,0.4242,0.47,0.2985,0,3,3,3,True
15456,2012-10-11,4,1,10,4,0,4,1,1,0.4,0.4091,0.5,0.2537,0,10,10,10,True
15457,2012-10-11,4,1,10,5,0,4,1,1,0.36,0.3485,0.5,0.1642,0,42,42,42,True
15458,2012-10-11,4,1,10,6,0,4,1,1,0.36,0.3485,0.5,0.1642,1,158,159,159,True
15459,2012-10-11,4,1,10,7,0,4,1,1,0.36,0.3333,0.5,0.2537,11,467,478,478,True
15460,2012-10-11,4,1,10,8,0,4,1,1,0.38,0.3939,0.46,0.3881,25,499,524,524,True
15461,2012-10-11,4,1,10,9,0,4,1,1,0.4,0.4091,0.43,0.3881,27,328,355,355,True
15462,2012-10-11,4,1,10,10,0,4,1,1,0.44,0.4394,0.41,0.3582,39,165,204,204,True
15463,2012-10-11,4,1,10,11,0,4,1,1,0.46,0.4545,0.36,0.0,76,175,251,251,True
15464,2012-10-11,4,1,10,12,0,4,1,1,0.46,0.4545,0.36,0.0,47,279,326,326,True
15465,2012-10-11,4,1,10,13,0,4,1,1,0.5,0.4848,0.31,0.1045,48,243,291,291,True
15466,2012-10-11,4,1,10,14,0,4,1,1,0.52,0.5,0.32,0.0896,78,270,348,348,True
15467,2012-10-11,4,1,10,15,0,4,1,1,0.52,0.5,0.34,0.1642,102,358,460,460,True
15468,2012-10-11,4,1,10,16,0,4,1,1,0.5,0.4848,0.36,0.1343,68,413,481,481,True
15469,2012-10-11,4,1,10,17,0,4,1,1,0.5,0.4848,0.39,0.2836,90,499,589,589,True
15470,2012-10-11,4,1,10,18,0,4,1,1,0.46,0.4545,0.44,0.1642,64,499,563,563,True
15471,2012-10-11,4,1,10,19,0,4,1,1,0.44,0.4394,0.51,0.1343,81,499,580,580,True
15472,2012-10-11,4,1,10,20,0,4,1,1,0.42,0.4242,0.62,0.1642,27,388,415,415,True
15473,2012-10-11,4,1,10,21,0,4,1,1,0.42,0.4242,0.62,0.1343,24,236,260,260,True
15474,2012-10-11,4,1,10,22,0,4,1,1,0.4,0.4091,0.66,0.1642,10,167,177,177,True
15475,2012-10-11,4,1,10,23,0,4,1,1,0.42,0.4242,0.58,0.0896,10,176,186,186,True
15476,2012-10-12,4,1,10,0,0,5,1,1,0.4,0.4091,0.66,0.1045,8,60,68,68,True
15477,2012-10-12,4,1,10,1,0,5,1,1,0.4,0.4091,0.66,0.0896,8,29,37,37,True
15478,2012-10-12,4,1,10,2,0,5,1,1,0.4,0.4091,0.66,0.0896,0,16,16,16,True
15479,2012-10-12,4,1,10,3,0,5,1,1,0.36,0.3636,0.76,0.0896,0,6,6,6,True
15480,2012-10-12,4,1,10,4,0,5,1,1,0.36,0.3636,0.76,0.1045,0,8,8,8,True
15481,2012-10-12,4,1,10,5,0,5,1,1,0.36,0.3636,0.81,0.0896,2,33,35,35,True
15482,2012-10-12,4,1,10,6,0,5,1,1,0.34,0.3485,0.81,0.0896,3,140,143,143,True
15483,2012-10-12,4,1,10,7,0,5,1,1,0.36,0.3636,0.81,0.0896,8,384,392,392,True
15484,2012-10-12,4,1,10,8,0,5,1,1,0.42,0.4242,0.71,0.0896,34,499,533,533,True
15485,2012-10-12,4,1,10,9,0,5,1,1,0.5,0.4848,0.39,0.2985,26,374,400,400,True
15486,2012-10-12,4,1,10,10,0,5,1,1,0.52,0.5,0.36,0.2985,75,200,275,275,True
15487,2012-10-12,4,1,10,11,0,5,1,1,0.54,0.5152,0.37,0.3582,61,252,313,313,True
15488,2012-10-12,4,1,10,12,0,5,1,1,0.54,0.5152,0.39,0.4627,75,312,387,387,True
15489,2012-10-12,4,1,10,13,0,5,1,1,0.56,0.5303,0.37,0.3881,81,300,381,381,True
15490,2012-10-12,4,1,10,14,0,5,1,1,0.56,0.5303,0.37,0.4627,109,262,371,371,True
15491,2012-10-12,4,1,10,15,0,5,1,1,0.52,0.5,0.42,0.4478,114,317,431,431,True
15492,2012-10-12,4,1,10,16,0,5,1,1,0.46,0.4545,0.41,0.3582,108,412,520,520,True
15493,2012-10-12,4,1,10,17,0,5,1,1,0.46,0.4545,0.38,0.3881,114,499,613,613,True
15494,2012-10-12,4,1,10,18,0,5,1,1,0.44,0.4394,0.38,0.2985,76,499,575,575,True
15495,2012-10-12,4,1,10,19,0,5,1,1,0.42,0.4242,0.41,0.2239,40,453,493,493,True
15496,2012-10-12,4,1,10,20,0,5,1,1,0.42,0.4242,0.47,0.1343,28,280,308,308,True
15497,2012-10-12,4,1,10,21,0,5,1,1,0.4,0.4091,0.54,0.194,21,169,190,190,True
15498,2012-10-12,4,1,10,22,0,5,1,1,0.4,0.4091,0.47,0.2985,17,143,160,160,True
15499,2012-10-12,4,1,10,23,0,5,1,1,0.36,0.3485,0.57,0.194,11,89,100,100,True
15500,2012-10-13,4,1,10,0,0,6,0,1,0.36,0.3636,0.57,0.0896,31,218,249,249,True
15501,2012-10-13,4,1,10,1,0,6,0,1,0.34,0.3333,0.53,0.1343,23,123,146,146,True
15502,2012-10-13,4,1,10,2,0,6,0,1,0.34,0.3333,0.53,0.194,7,60,67,67,True
15503,2012-10-13,4,1,10,3,0,6,0,1,0.32,0.303,0.66,0.2239,2,13,15,15,True
15504,2012-10-13,4,1,10,4,0,6,0,1,0.3,0.303,0.65,0.1642,2,9,11,11,True
15505,2012-10-13,4,1,10,5,0,6,0,1,0.3,0.2879,0.61,0.194,0,11,11,11,True
15506,2012-10-13,4,1,10,6,0,6,0,1,0.3,0.2879,0.61,0.194,5,23,28,28,True
15507,2012-10-13,4,1,10,7,0,6,0,1,0.3,0.303,0.61,0.1642,10,60,70,70,True
15508,2012-10-13,4,1,10,8,0,6,0,1,0.34,0.3485,0.53,0.1045,23,151,174,174,True
15509,2012-10-13,4,1,10,9,0,6,0,1,0.36,0.3636,0.5,0.0896,46,220,266,266,True
15510,2012-10-13,4,1,10,10,0,6,0,1,0.4,0.4091,0.43,0.0,82,265,347,347,True
15511,2012-10-13,4,1,10,11,0,6,0,1,0.42,0.4242,0.35,0.1343,114,335,449,449,True
15512,2012-10-13,4,1,10,12,0,6,0,1,0.44,0.4394,0.35,0.0,114,371,485,485,True
15513,2012-10-13,4,1,10,13,0,6,0,1,0.46,0.4545,0.36,0.194,114,435,549,549,True
15514,2012-10-13,4,1,10,14,0,6,0,1,0.48,0.4697,0.33,0.194,114,354,468,468,True
15515,2012-10-13,4,1,10,15,0,6,0,1,0.5,0.4848,0.36,0.194,114,364,478,478,True
15516,2012-10-13,4,1,10,16,0,6,0,1,0.5,0.4848,0.31,0.194,114,343,457,457,True
15517,2012-10-13,4,1,10,17,0,6,0,1,0.46,0.4545,0.38,0.1642,114,335,449,449,True
15518,2012-10-13,4,1,10,18,0,6,0,1,0.46,0.4545,0.44,0.1343,114,299,413,413,True
15519,2012-10-13,4,1,10,19,0,6,0,1,0.44,0.4394,0.44,0.1642,73,259,332,332,True
15520,2012-10-13,4,1,10,20,0,6,0,1,0.4,0.4091,0.54,0.0896,57,198,255,255,True
15521,2012-10-13,4,1,10,21,0,6,0,1,0.4,0.4091,0.58,0.194,47,157,204,204,True
15522,2012-10-13,4,1,10,22,0,6,0,1,0.4,0.4091,0.62,0.0,33,156,189,189,True
15523,2012-10-13,4,1,10,23,0,6,0,1,0.42,0.4242,0.58,0.2985,27,98,125,125,True
15524,2012-10-14,4,1,10,0,0,0,0,1,0.4,0.4091,0.71,0.2537,8,103,111,111,True
15525,2012-10-14,4,1,10,1,0,0,0,1,0.42,0.4242,0.77,0.2836,16,96,112,112,True
15526,2012-10-14,4,1,10,2,0,0,0,1,0.4,0.4091,0.76,0.0896,8,58,66,66,True
15527,2012-10-14,4,1,10,3,0,0,0,1,0.42,0.4242,0.77,0.2985,3,25,28,28,True
15528,2012-10-14,4,1,10,4,0,0,0,1,0.42,0.4242,0.77,0.2836,2,10,12,12,True
15529,2012-10-14,4,1,10,5,0,0,0,1,0.4,0.4091,0.82,0.194,5,6,11,11,True
15530,2012-10-14,4,1,10,6,0,0,0,1,0.4,0.4091,0.82,0.1642,4,20,24,24,True
15531,2012-10-14,4,1,10,7,0,0,0,1,0.42,0.4242,0.82,0.2239,7,44,51,51,True
15532,2012-10-14,4,1,10,8,0,0,0,1,0.44,0.4394,0.77,0.194,28,104,132,132,True
15533,2012-10-14,4,1,10,9,0,0,0,2,0.48,0.4697,0.67,0.2836,62,161,223,223,True
15534,2012-10-14,4,1,10,10,0,0,0,1,0.54,0.5152,0.56,0.194,114,278,392,392,True
15535,2012-10-14,4,1,10,11,0,0,0,1,0.56,0.5303,0.52,0.2985,114,338,452,452,True
15536,2012-10-14,4,1,10,12,0,0,0,1,0.62,0.6212,0.46,0.3284,114,362,476,476,True
15537,2012-10-14,4,1,10,13,0,0,0,1,0.64,0.6212,0.41,0.4478,114,401,515,515,True
15538,2012-10-14,4,1,10,14,0,0,0,1,0.66,0.6212,0.39,0.4179,114,368,482,482,True
15539,2012-10-14,4,1,10,15,0,0,0,1,0.66,0.6212,0.39,0.4179,114,355,469,469,True
15540,2012-10-14,4,1,10,16,0,0,0,1,0.64,0.6212,0.41,0.2985,114,378,492,492,True
15541,2012-10-14,4,1,10,17,0,0,0,1,0.64,0.6212,0.44,0.194,114,346,460,460,True
15542,2012-10-14,4,1,10,18,0,0,0,1,0.58,0.5455,0.6,0.2537,114,319,433,433,True
15543,2012-10-14,4,1,10,19,0,0,0,1,0.56,0.5303,0.64,0.2239,68,268,336,336,True
15544,2012-10-14,4,1,10,20,0,0,0,1,0.54,0.5152,0.73,0.2239,48,198,246,246,True
15545,2012-10-14,4,1,10,21,0,0,0,1,0.56,0.5303,0.73,0.4478,40,156,196,196,True
15546,2012-10-14,4,1,10,22,0,0,0,1,0.56,0.5303,0.73,0.3881,38,87,125,125,True
15547,2012-10-14,4,1,10,23,0,0,0,2,0.56,0.5303,0.68,0.2836,27,78,105,105,True
15548,2012-10-15,4,1,10,0,0,1,1,2,0.56,0.5303,0.73,0.2537,17,31,48,48,True
15549,2012-10-15,4,1,10,1,0,1,1,2,0.58,0.5455,0.64,0.3881,5,24,29,29,True
15550,2012-10-15,4,1,10,2,0,1,1,2,0.58,0.5455,0.64,0.3582,1,5,6,6,True
15551,2012-10-15,4,1,10,3,0,1,1,2,0.56,0.5303,0.73,0.2537,2,2,4,4,True
15552,2012-10-15,4,1,10,4,0,1,1,2,0.56,0.5303,0.68,0.2239,1,9,10,10,True
15553,2012-10-15,4,1,10,5,0,1,1,2,0.56,0.5303,0.73,0.2836,2,38,40,40,True
15554,2012-10-15,4,1,10,6,0,1,1,2,0.56,0.5303,0.73,0.2985,6,141,147,147,True
15555,2012-10-15,4,1,10,7,0,1,1,2,0.58,0.5455,0.68,0.3284,15,461,476,476,True
15556,2012-10-15,4,1,10,8,0,1,1,2,0.6,0.6061,0.64,0.3881,24,499,523,523,True
15557,2012-10-15,4,1,10,9,0,1,1,3,0.6,0.5909,0.69,0.3881,31,328,359,359,True
15558,2012-10-15,4,1,10,10,0,1,1,2,0.6,0.5909,0.73,0.3881,43,125,168,168,True
15559,2012-10-15,4,1,10,11,0,1,1,2,0.6,0.5909,0.73,0.3881,88,175,263,263,True
15560,2012-10-15,4,1,10,12,0,1,1,3,0.6,0.5758,0.78,0.3284,73,211,284,284,True
15561,2012-10-15,4,1,10,13,0,1,1,2,0.56,0.5303,0.88,0.2239,37,109,146,146,True
15562,2012-10-15,4,1,10,14,0,1,1,2,0.6,0.5758,0.78,0.2836,57,128,185,185,True
15563,2012-10-15,4,1,10,15,0,1,1,1,0.6,0.5758,0.78,0.3284,70,190,260,260,True
15564,2012-10-15,4,1,10,16,0,1,1,1,0.56,0.5303,0.64,0.2985,76,371,447,447,True
15565,2012-10-15,4,1,10,17,0,1,1,1,0.56,0.5303,0.64,0.2537,96,499,595,595,True
15566,2012-10-15,4,1,10,18,0,1,1,3,0.54,0.5152,0.77,0.1343,52,499,551,551,True
15567,2012-10-15,4,1,10,19,0,1,1,3,0.52,0.5,0.83,0.0896,12,227,239,239,True
15568,2012-10-15,4,1,10,20,0,1,1,2,0.52,0.5,0.72,0.3881,19,237,256,256,True
15569,2012-10-15,4,1,10,21,0,1,1,1,0.52,0.5,0.59,0.3284,16,190,206,206,True
15570,2012-10-15,4,1,10,22,0,1,1,1,0.5,0.4848,0.59,0.2836,8,118,126,126,True
15571,2012-10-15,4,1,10,23,0,1,1,1,0.46,0.4545,0.63,0.2239,9,72,81,81,True
15572,2012-10-16,4,1,10,0,0,2,1,1,0.46,0.4545,0.63,0.3881,3,45,48,48,True
15573,2012-10-16,4,1,10,1,0,2,1,1,0.44,0.4394,0.67,0.194,4,9,13,13,True
15574,2012-10-16,4,1,10,2,0,2,1,1,0.44,0.4394,0.67,0.1343,2,1,3,3,True
15575,2012-10-16,4,1,10,3,0,2,1,1,0.42,0.4242,0.67,0.1045,0,2,2,2,True
15576,2012-10-16,4,1,10,4,0,2,1,1,0.42,0.4242,0.67,0.1642,0,7,7,7,True
15577,2012-10-16,4,1,10,5,0,2,1,1,0.42,0.4242,0.67,0.2537,5,47,52,52,True
15578,2012-10-16,4,1,10,6,0,2,1,1,0.42,0.4242,0.67,0.1642,4,168,172,172,True
15579,2012-10-16,4,1,10,7,0,2,1,1,0.42,0.4242,0.67,0.0896,20,499,519,519,True
15580,2012-10-16,4,1,10,8,0,2,1,1,0.44,0.4394,0.62,0.0,35,499,534,534,True
15581,2012-10-16,4,1,10,9,0,2,1,1,0.48,0.4697,0.55,0.2537,32,323,355,355,True
15582,2012-10-16,4,1,10,10,0,2,1,1,0.5,0.4848,0.48,0.2836,65,157,222,222,True
15583,2012-10-16,4,1,10,11,0,2,1,1,0.5,0.4848,0.45,0.4179,56,172,228,228,True
15584,2012-10-16,4,1,10,12,0,2,1,2,0.52,0.5,0.45,0.3284,69,256,325,325,True
15585,2012-10-16,4,1,10,13,0,2,1,1,0.52,0.5,0.45,0.2836,68,260,328,328,True
15586,2012-10-16,4,1,10,14,0,2,1,1,0.54,0.5152,0.39,0.2537,94,214,308,308,True
15587,2012-10-16,4,1,10,15,0,2,1,1,0.54,0.5152,0.41,0.3284,76,270,346,346,True
15588,2012-10-16,4,1,10,16,0,2,1,1,0.54,0.5152,0.39,0.2836,79,367,446,446,True
15589,2012-10-16,4,1,10,17,0,2,1,1,0.52,0.5,0.39,0.194,104,499,603,603,True
15590,2012-10-16,4,1,10,18,0,2,1,1,0.5,0.4848,0.42,0.1642,71,499,570,570,True
15591,2012-10-16,4,1,10,19,0,2,1,1,0.48,0.4697,0.48,0.0,40,491,531,531,True
15592,2012-10-16,4,1,10,20,0,2,1,1,0.46,0.4545,0.55,0.0,35,397,432,432,True
15593,2012-10-16,4,1,10,21,0,2,1,1,0.46,0.4545,0.63,0.0,19,176,195,195,True
15594,2012-10-16,4,1,10,22,0,2,1,1,0.4,0.4091,0.71,0.0896,18,163,181,181,True
15595,2012-10-16,4,1,10,23,0,2,1,1,0.4,0.4091,0.71,0.0,23,176,199,199,True
15596,2012-10-17,4,1,10,0,0,3,1,1,0.38,0.3939,0.76,0.0,1,48,49,49,True
15597,2012-10-17,4,1,10,1,0,3,1,1,0.38,0.3939,0.76,0.0,3,14,17,17,True
15598,2012-10-17,4,1,10,2,0,3,1,1,0.38,0.3939,0.76,0.0,4,12,16,16,True
15599,2012-10-17,4,1,10,3,0,3,1,1,0.36,0.3788,0.87,0.0,0,7,7,7,True
15600,2012-10-17,4,1,10,4,0,3,1,1,0.36,0.3636,0.81,0.0896,0,4,4,4,True
15601,2012-10-17,4,1,10,5,0,3,1,2,0.36,0.3788,0.81,0.0,2,39,41,41,True
15602,2012-10-17,4,1,10,6,0,3,1,1,0.38,0.3939,0.82,0.0,7,171,178,178,True
15603,2012-10-17,4,1,10,7,0,3,1,1,0.36,0.3636,0.81,0.1045,15,449,464,464,True
15604,2012-10-17,4,1,10,8,0,3,1,2,0.4,0.4091,0.76,0.0,38,499,537,537,True
15605,2012-10-17,4,1,10,9,0,3,1,2,0.42,0.4242,0.77,0.0,38,344,382,382,True
15606,2012-10-17,4,1,10,10,0,3,1,2,0.46,0.4545,0.67,0.0,60,168,228,228,True
15607,2012-10-17,4,1,10,11,0,3,1,2,0.5,0.4848,0.51,0.0896,78,156,234,234,True
15608,2012-10-17,4,1,10,12,0,3,1,2,0.52,0.5,0.48,0.1642,71,261,332,332,True
15609,2012-10-17,4,1,10,13,0,3,1,2,0.54,0.5152,0.49,0.1343,73,237,310,310,True
15610,2012-10-17,4,1,10,14,0,3,1,2,0.56,0.5303,0.43,0.1642,82,188,270,270,True
15611,2012-10-17,4,1,10,15,0,3,1,2,0.58,0.5455,0.43,0.2239,62,239,301,301,True
15612,2012-10-17,4,1,10,16,0,3,1,1,0.56,0.5303,0.52,0.194,70,396,466,466,True
15613,2012-10-17,4,1,10,17,0,3,1,1,0.54,0.5152,0.56,0.1045,114,499,613,613,True
15614,2012-10-17,4,1,10,18,0,3,1,1,0.52,0.5,0.59,0.1642,90,499,589,589,True
15615,2012-10-17,4,1,10,19,0,3,1,1,0.5,0.4848,0.72,0.194,49,467,516,516,True
15616,2012-10-17,4,1,10,20,0,3,1,1,0.5,0.4848,0.72,0.1343,54,360,414,414,True
15617,2012-10-17,4,1,10,21,0,3,1,1,0.46,0.4545,0.82,0.194,28,301,329,329,True
15618,2012-10-17,4,1,10,22,0,3,1,1,0.46,0.4545,0.88,0.2537,17,198,215,215,True
15619,2012-10-17,4,1,10,23,0,3,1,1,0.46,0.4545,0.88,0.2239,15,84,99,99,True
15620,2012-10-18,4,1,10,0,0,4,1,1,0.46,0.4545,0.88,0.194,4,53,57,57,True
15621,2012-10-18,4,1,10,1,0,4,1,1,0.46,0.4545,0.82,0.2239,0,14,14,14,True
15622,2012-10-18,4,1,10,2,0,4,1,1,0.46,0.4545,0.82,0.194,1,13,14,14,True
15623,2012-10-18,4,1,10,3,0,4,1,1,0.44,0.4394,0.88,0.2239,0,5,5,5,True
15624,2012-10-18,4,1,10,4,0,4,1,1,0.44,0.4394,0.88,0.2239,0,5,5,5,True
15625,2012-10-18,4,1,10,5,0,4,1,1,0.44,0.4394,0.82,0.2239,1,41,42,42,True
15626,2012-10-18,4,1,10,6,0,4,1,1,0.44,0.4394,0.88,0.2985,3,150,153,153,True
15627,2012-10-18,4,1,10,7,0,4,1,1,0.44,0.4394,0.88,0.2537,20,488,508,508,True
15628,2012-10-18,4,1,10,8,0,4,1,1,0.46,0.4545,0.82,0.2537,31,499,530,530,True
15629,2012-10-18,4,1,10,9,0,4,1,2,0.5,0.4848,0.77,0.1642,41,346,387,387,True
15630,2012-10-18,4,1,10,10,0,4,1,2,0.52,0.5,0.68,0.2239,60,158,218,218,True
15631,2012-10-18,4,1,10,11,0,4,1,2,0.56,0.5303,0.56,0.2239,79,189,268,268,True
15632,2012-10-18,4,1,10,12,0,4,1,2,0.6,0.6212,0.53,0.2537,93,284,377,377,True
15633,2012-10-18,4,1,10,13,0,4,1,1,0.62,0.6212,0.53,0.3582,96,236,332,332,True
15634,2012-10-18,4,1,10,14,0,4,1,2,0.62,0.6212,0.5,0.2985,94,191,285,285,True
15635,2012-10-18,4,1,10,15,0,4,1,2,0.6,0.6061,0.6,0.194,69,284,353,353,True
15636,2012-10-18,4,1,10,16,0,4,1,1,0.6,0.6212,0.56,0.2836,94,356,450,450,True
15637,2012-10-18,4,1,10,17,0,4,1,2,0.58,0.5455,0.64,0.3284,102,499,601,601,True
15638,2012-10-18,4,1,10,18,0,4,1,2,0.56,0.5303,0.64,0.3284,68,499,567,567,True
15639,2012-10-18,4,1,10,19,0,4,1,2,0.56,0.5303,0.68,0.2985,42,471,513,513,True
15640,2012-10-18,4,1,10,20,0,4,1,2,0.56,0.5303,0.68,0.2537,39,348,387,387,True
15641,2012-10-18,4,1,10,21,0,4,1,2,0.54,0.5152,0.77,0.194,38,245,283,283,True
15642,2012-10-18,4,1,10,22,0,4,1,2,0.54,0.5152,0.83,0.194,27,202,229,229,True
15643,2012-10-18,4,1,10,23,0,4,1,2,0.54,0.5152,0.83,0.0,6,111,117,117,True
15644,2012-10-19,4,1,10,0,0,5,1,2,0.56,0.5303,0.83,0.1045,5,51,56,56,True
15645,2012-10-19,4,1,10,1,0,5,1,3,0.54,0.5152,0.88,0.0,4,12,16,16,True
15646,2012-10-19,4,1,10,2,0,5,1,2,0.54,0.5152,0.88,0.0,1,9,10,10,True
15647,2012-10-19,4,1,10,3,0,5,1,2,0.56,0.5303,0.83,0.0,0,5,5,5,True
15648,2012-10-19,4,1,10,4,0,5,1,2,0.56,0.5303,0.83,0.0,1,5,6,6,True
15649,2012-10-19,4,1,10,5,0,5,1,2,0.54,0.5152,0.88,0.0,1,35,36,36,True
15650,2012-10-19,4,1,10,6,0,5,1,3,0.54,0.5152,0.94,0.1642,5,126,131,131,True
15651,2012-10-19,4,1,10,7,0,5,1,3,0.54,0.5152,0.94,0.0,5,149,154,154,True
15652,2012-10-19,4,1,10,8,0,5,1,2,0.54,0.5152,0.94,0.1045,20,447,467,467,True
15653,2012-10-19,4,1,10,9,0,5,1,2,0.54,0.5152,0.94,0.1045,26,363,389,389,True
15654,2012-10-19,4,1,10,10,0,5,1,2,0.58,0.5455,0.88,0.194,26,198,224,224,True
15655,2012-10-19,4,1,10,11,0,5,1,1,0.6,0.5606,0.83,0.194,41,211,252,252,True
15656,2012-10-19,4,1,10,12,0,5,1,1,0.64,0.6061,0.69,0.2239,74,258,332,332,True
15657,2012-10-19,4,1,10,13,0,5,1,1,0.62,0.5909,0.73,0.2239,87,288,375,375,True
15658,2012-10-19,4,1,10,14,0,5,1,1,0.66,0.6212,0.61,0.2537,88,277,365,365,True
15659,2012-10-19,4,1,10,15,0,5,1,1,0.64,0.6061,0.65,0.2985,93,302,395,395,True
15660,2012-10-19,4,1,10,16,0,5,1,3,0.62,0.6061,0.69,0.3582,114,434,548,548,True
15661,2012-10-19,4,1,10,17,0,5,1,3,0.62,0.6061,0.69,0.3582,48,377,425,425,True
15662,2012-10-19,4,1,10,18,0,5,1,1,0.56,0.5303,0.83,0.1045,21,212,233,233,True
15663,2012-10-19,4,1,10,19,0,5,1,1,0.54,0.5152,0.88,0.1642,19,213,232,232,True
15664,2012-10-19,4,1,10,20,0,5,1,1,0.52,0.5,0.77,0.194,13,216,229,229,True
15665,2012-10-19,4,1,10,21,0,5,1,1,0.5,0.4848,0.77,0.0,17,189,206,206,True
15666,2012-10-19,4,1,10,22,0,5,1,1,0.5,0.4848,0.77,0.0896,14,176,190,190,True
15667,2012-10-19,4,1,10,23,0,5,1,1,0.46,0.4545,0.88,0.1045,13,118,131,131,True
15668,2012-10-20,4,1,10,0,0,6,0,1,0.46,0.4545,0.82,0.1343,13,110,123,123,True
15669,2012-10-20,4,1,10,1,0,6,0,1,0.46,0.4545,0.72,0.1343,2,93,95,95,True
15670,2012-10-20,4,1,10,2,0,6,0,1,0.44,0.4394,0.77,0.1045,9,69,78,78,True
15671,2012-10-20,4,1,10,3,0,6,0,1,0.42,0.4242,0.77,0.1343,2,27,29,29,True
15672,2012-10-20,4,1,10,4,0,6,0,1,0.44,0.4394,0.72,0.0,9,9,18,18,True
15673,2012-10-20,4,1,10,5,0,6,0,1,0.4,0.4091,0.82,0.0,6,7,13,13,True
15674,2012-10-20,4,1,10,6,0,6,0,1,0.42,0.4242,0.71,0.0,5,26,31,31,True
15675,2012-10-20,4,1,10,7,0,6,0,1,0.4,0.4091,0.82,0.0,6,59,65,65,True
15676,2012-10-20,4,1,10,8,0,6,0,1,0.46,0.4545,0.67,0.1343,29,164,193,193,True
15677,2012-10-20,4,1,10,9,0,6,0,1,0.5,0.4848,0.59,0.1343,106,257,363,363,True
15678,2012-10-20,4,1,10,10,0,6,0,1,0.52,0.5,0.52,0.1343,111,312,423,423,True
15679,2012-10-20,4,1,10,11,0,6,0,1,0.54,0.5152,0.52,0.2239,114,408,522,522,True
15680,2012-10-20,4,1,10,12,0,6,0,1,0.56,0.5303,0.46,0.1045,114,436,550,550,True
15681,2012-10-20,4,1,10,13,0,6,0,1,0.56,0.5303,0.43,0.1642,114,441,555,555,True
15682,2012-10-20,4,1,10,14,0,6,0,1,0.56,0.5303,0.4,0.0,114,376,490,490,True
15683,2012-10-20,4,1,10,15,0,6,0,1,0.56,0.5303,0.43,0.0,114,403,517,517,True
15684,2012-10-20,4,1,10,16,0,6,0,1,0.54,0.5152,0.42,0.2836,114,366,480,480,True
15685,2012-10-20,4,1,10,17,0,6,0,1,0.54,0.5152,0.37,0.2239,114,384,498,498,True
15686,2012-10-20,4,1,10,18,0,6,0,1,0.52,0.5,0.39,0.2239,114,356,470,470,True
15687,2012-10-20,4,1,10,19,0,6,0,1,0.5,0.4848,0.45,0.1343,77,268,345,345,True
15688,2012-10-20,4,1,10,20,0,6,0,1,0.5,0.4848,0.39,0.2239,61,198,259,259,True
15689,2012-10-20,4,1,10,21,0,6,0,1,0.46,0.4545,0.47,0.2239,72,224,296,296,True
15690,2012-10-20,4,1,10,22,0,6,0,1,0.44,0.4394,0.51,0.1045,47,155,202,202,True
15691,2012-10-20,4,1,10,23,0,6,0,1,0.42,0.4242,0.58,0.0,27,136,163,163,True
15692,2012-10-21,4,1,10,0,0,0,0,1,0.44,0.4394,0.54,0.1642,35,119,154,154,True
15693,2012-10-21,4,1,10,1,0,0,0,1,0.42,0.4242,0.58,0.2239,20,97,117,117,True
15694,2012-10-21,4,1,10,2,0,0,0,1,0.4,0.4091,0.62,0.1642,44,88,132,132,True
15695,2012-10-21,4,1,10,3,0,0,0,1,0.38,0.3939,0.66,0.0896,12,29,41,41,True
15696,2012-10-21,4,1,10,4,0,0,0,1,0.36,0.3485,0.71,0.1642,8,13,21,21,True
15697,2012-10-21,4,1,10,5,0,0,0,1,0.38,0.3939,0.66,0.0896,6,4,10,10,True
15698,2012-10-21,4,1,10,6,0,0,0,1,0.4,0.4091,0.62,0.0,8,18,26,26,True
15699,2012-10-21,4,1,10,7,0,0,0,1,0.4,0.4091,0.62,0.0,13,43,56,56,True
15700,2012-10-21,4,1,10,8,0,0,0,1,0.42,0.4242,0.67,0.0,39,104,143,143,True
15701,2012-10-21,4,1,10,9,0,0,0,1,0.46,0.4545,0.55,0.1642,77,192,269,269,True
15702,2012-10-21,4,1,10,10,0,0,0,1,0.5,0.4848,0.48,0.2985,114,276,390,390,True
15703,2012-10-21,4,1,10,11,0,0,0,1,0.52,0.5,0.44,0.3284,114,356,470,470,True
15704,2012-10-21,4,1,10,12,0,0,0,1,0.54,0.5152,0.39,0.3284,114,439,553,553,True
15705,2012-10-21,4,1,10,13,0,0,0,1,0.56,0.5303,0.37,0.2537,114,383,497,497,True
15706,2012-10-21,4,1,10,14,0,0,0,1,0.56,0.5303,0.35,0.194,114,405,519,519,True
15707,2012-10-21,4,1,10,15,0,0,0,1,0.56,0.5303,0.35,0.3284,114,383,497,497,True
15708,2012-10-21,4,1,10,16,0,0,0,1,0.54,0.5152,0.37,0.2239,114,409,523,523,True
15709,2012-10-21,4,1,10,17,0,0,0,1,0.52,0.5,0.39,0.2537,114,338,452,452,True
15710,2012-10-21,4,1,10,18,0,0,0,1,0.52,0.5,0.39,0.194,71,342,413,413,True
15711,2012-10-21,4,1,10,19,0,0,0,1,0.5,0.4848,0.42,0.1642,50,216,266,266,True
15712,2012-10-21,4,1,10,20,0,0,0,1,0.48,0.4697,0.44,0.194,35,160,195,195,True
15713,2012-10-21,4,1,10,21,0,0,0,1,0.42,0.4242,0.54,0.1642,42,124,166,166,True
15714,2012-10-21,4,1,10,22,0,0,0,1,0.42,0.4242,0.54,0.0,18,95,113,113,True
15715,2012-10-21,4,1,10,23,0,0,0,1,0.44,0.4394,0.54,0.0,7,59,66,66,True
15716,2012-10-22,4,1,10,0,0,1,1,1,0.4,0.4091,0.62,0.0,3,28,31,31,True
15717,2012-10-22,4,1,10,1,0,1,1,1,0.4,0.4091,0.71,0.0,0,11,11,11,True
15718,2012-10-22,4,1,10,2,0,1,1,1,0.38,0.3939,0.71,0.0,1,4,5,5,True
15719,2012-10-22,4,1,10,3,0,1,1,1,0.4,0.4091,0.62,0.0,1,5,6,6,True
15720,2012-10-22,4,1,10,4,0,1,1,1,0.38,0.3939,0.66,0.0,1,6,7,7,True
15721,2012-10-22,4,1,10,5,0,1,1,1,0.38,0.3939,0.76,0.0896,2,44,46,46,True
15722,2012-10-22,4,1,10,6,0,1,1,1,0.36,0.3636,0.76,0.0896,4,140,144,144,True
15723,2012-10-22,4,1,10,7,0,1,1,1,0.38,0.3939,0.66,0.0896,15,437,452,452,True
15724,2012-10-22,4,1,10,8,0,1,1,1,0.44,0.4394,0.67,0.0,32,499,531,531,True
15725,2012-10-22,4,1,10,9,0,1,1,1,0.46,0.4545,0.63,0.0896,25,335,360,360,True
15726,2012-10-22,4,1,10,10,0,1,1,1,0.5,0.4848,0.55,0.0,51,161,212,212,True
15727,2012-10-22,4,1,10,11,0,1,1,1,0.56,0.5303,0.37,0.1642,63,148,211,211,True
15728,2012-10-22,4,1,10,12,0,1,1,1,0.58,0.5455,0.35,0.0,52,231,283,283,True
15729,2012-10-22,4,1,10,13,0,1,1,1,0.62,0.6212,0.29,0.1642,88,227,315,315,True
15730,2012-10-22,4,1,10,14,0,1,1,1,0.62,0.6061,0.27,0.194,73,209,282,282,True
15731,2012-10-22,4,1,10,15,0,1,1,1,0.64,0.6212,0.29,0.1642,74,222,296,296,True
15732,2012-10-22,4,1,10,16,0,1,1,1,0.62,0.6212,0.33,0.1642,80,444,524,524,True
15733,2012-10-22,4,1,10,17,0,1,1,1,0.62,0.6212,0.33,0.1045,84,499,583,583,True
15734,2012-10-22,4,1,10,18,0,1,1,1,0.54,0.5152,0.64,0.1045,60,499,559,559,True
15735,2012-10-22,4,1,10,19,0,1,1,1,0.52,0.5,0.52,0.1045,36,478,514,514,True
15736,2012-10-22,4,1,10,20,0,1,1,1,0.5,0.4848,0.59,0.1045,21,382,403,403,True
15737,2012-10-22,4,1,10,21,0,1,1,1,0.48,0.4697,0.67,0.0896,19,155,174,174,True
15738,2012-10-22,4,1,10,22,0,1,1,1,0.46,0.4545,0.82,0.1343,25,158,183,183,True
15739,2012-10-22,4,1,10,23,0,1,1,1,0.46,0.4545,0.82,0.1045,20,143,163,163,True
15740,2012-10-23,4,1,10,0,0,2,1,1,0.46,0.4545,0.88,0.1642,5,32,37,37,True
15741,2012-10-23,4,1,10,1,0,2,1,1,0.46,0.4545,0.77,0.1642,1,16,17,17,True
15742,2012-10-23,4,1,10,2,0,2,1,1,0.44,0.4394,0.88,0.1343,1,6,7,7,True
15743,2012-10-23,4,1,10,3,0,2,1,1,0.44,0.4394,0.77,0.1343,0,1,1,1,True
15744,2012-10-23,4,1,10,4,0,2,1,1,0.42,0.4242,0.77,0.1045,1,6,7,7,True
15745,2012-10-23,4,1,10,5,0,2,1,1,0.44,0.4394,0.77,0.0896,1,49,50,50,True
15746,2012-10-23,4,1,10,6,0,2,1,1,0.4,0.4091,0.82,0.0896,6,152,158,158,True
15747,2012-10-23,4,1,10,7,0,2,1,2,0.44,0.4394,0.77,0.1045,12,499,511,511,True
15748,2012-10-23,4,1,10,8,0,2,1,2,0.46,0.4545,0.72,0.0896,28,499,527,527,True
15749,2012-10-23,4,1,10,9,0,2,1,2,0.5,0.4848,0.72,0.1045,29,305,334,334,True
15750,2012-10-23,4,1,10,10,0,2,1,1,0.54,0.5152,0.6,0.0,50,171,221,221,True
15751,2012-10-23,4,1,10,11,0,2,1,1,0.6,0.6212,0.53,0.0,52,201,253,253,True
15752,2012-10-23,4,1,10,12,0,2,1,2,0.62,0.6212,0.46,0.0896,80,298,378,378,True
15753,2012-10-23,4,1,10,13,0,2,1,2,0.64,0.6212,0.44,0.0,59,244,303,303,True
15754,2012-10-23,4,1,10,14,0,2,1,1,0.68,0.6364,0.41,0.1642,67,229,296,296,True
15755,2012-10-23,4,1,10,15,0,2,1,1,0.68,0.6364,0.41,0.2239,76,270,346,346,True
15756,2012-10-23,4,1,10,16,0,2,1,1,0.68,0.6364,0.44,0.0896,108,433,541,541,True
15757,2012-10-23,4,1,10,17,0,2,1,1,0.68,0.6364,0.41,0.0,67,499,566,566,True
15758,2012-10-23,4,1,10,18,0,2,1,1,0.62,0.6212,0.53,0.0896,64,499,563,563,True
15759,2012-10-23,4,1,10,19,0,2,1,1,0.62,0.6212,0.57,0.0896,25,457,482,482,True
15760,2012-10-23,4,1,10,20,0,2,1,1,0.58,0.5455,0.64,0.1343,45,334,379,379,True
15761,2012-10-23,4,1,10,21,0,2,1,1,0.56,0.5303,0.68,0.0,35,260,295,295,True
15762,2012-10-23,4,1,10,22,0,2,1,1,0.56,0.5303,0.68,0.1045,20,174,194,194,True
15763,2012-10-23,4,1,10,23,0,2,1,1,0.54,0.5152,0.73,0.1045,9,102,111,111,True
15764,2012-10-24,4,1,10,0,0,3,1,1,0.54,0.5152,0.73,0.0896,7,39,46,46,True
15765,2012-10-24,4,1,10,1,0,3,1,1,0.54,0.5152,0.68,0.0,4,23,27,27,True
15766,2012-10-24,4,1,10,2,0,3,1,1,0.54,0.5152,0.68,0.0,0,6,6,6,True
15767,2012-10-24,4,1,10,3,0,3,1,1,0.5,0.4848,0.77,0.0896,0,4,4,4,True
15768,2012-10-24,4,1,10,4,0,3,1,1,0.5,0.4848,0.77,0.0896,1,5,6,6,True
15769,2012-10-24,4,1,10,5,0,3,1,1,0.5,0.4848,0.82,0.0,1,52,53,53,True
15770,2012-10-24,4,1,10,6,0,3,1,1,0.48,0.4697,0.82,0.1045,11,162,173,173,True
15771,2012-10-24,4,1,10,7,0,3,1,1,0.5,0.4848,0.88,0.0896,20,499,519,519,True
15772,2012-10-24,4,1,10,8,0,3,1,2,0.52,0.5,0.83,0.1045,24,499,523,523,True
15773,2012-10-24,4,1,10,9,0,3,1,2,0.52,0.5,0.77,0.0896,24,349,373,373,True
15774,2012-10-24,4,1,10,10,0,3,1,2,0.54,0.5152,0.73,0.0,29,142,171,171,True
15775,2012-10-24,4,1,10,11,0,3,1,1,0.58,0.5455,0.64,0.0,47,189,236,236,True
15776,2012-10-24,4,1,10,12,0,3,1,1,0.62,0.6061,0.61,0.0896,48,268,316,316,True
15777,2012-10-24,4,1,10,13,0,3,1,1,0.66,0.6212,0.54,0.0,65,241,306,306,True
15778,2012-10-24,4,1,10,14,0,3,1,1,0.74,0.6515,0.3,0.2537,64,237,301,301,True
15779,2012-10-24,4,1,10,15,0,3,1,1,0.7,0.6364,0.39,0.1045,63,245,308,308,True
15780,2012-10-24,4,1,10,16,0,3,1,1,0.74,0.6515,0.33,0.1343,67,465,532,532,True
15781,2012-10-24,4,1,10,17,0,3,1,1,0.66,0.6212,0.47,0.0,87,499,586,586,True
15782,2012-10-24,4,1,10,18,0,3,1,1,0.66,0.6212,0.44,0.0,63,499,562,562,True
15783,2012-10-24,4,1,10,19,0,3,1,2,0.64,0.6212,0.53,0.0896,50,499,549,549,True
15784,2012-10-24,4,1,10,20,0,3,1,2,0.62,0.6061,0.61,0.0896,45,396,441,441,True
15785,2012-10-24,4,1,10,21,0,3,1,2,0.62,0.6061,0.61,0.1045,33,280,313,313,True
15786,2012-10-24,4,1,10,22,0,3,1,2,0.6,0.6061,0.64,0.1343,30,208,238,238,True
15787,2012-10-24,4,1,10,23,0,3,1,2,0.58,0.5455,0.68,0.0896,12,111,123,123,True
15788,2012-10-25,4,1,10,0,0,4,1,2,0.6,0.6061,0.64,0.1045,19,57,76,76,True
15789,2012-10-25,4,1,10,1,0,4,1,1,0.58,0.5455,0.68,0.0,6,22,28,28,True
15790,2012-10-25,4,1,10,2,0,4,1,1,0.54,0.5152,0.77,0.0,3,15,18,18,True
15791,2012-10-25,4,1,10,3,0,4,1,2,0.52,0.5,0.88,0.1343,0,8,8,8,True
15792,2012-10-25,4,1,10,4,0,4,1,2,0.52,0.5,0.88,0.1045,1,4,5,5,True
15793,2012-10-25,4,1,10,5,0,4,1,2,0.52,0.5,0.88,0.1642,2,53,55,55,True
15794,2012-10-25,4,1,10,6,0,4,1,2,0.52,0.5,0.88,0.194,3,168,171,171,True
15795,2012-10-25,4,1,10,7,0,4,1,2,0.52,0.5,0.88,0.194,18,477,495,495,True
15796,2012-10-25,4,1,10,8,0,4,1,2,0.52,0.5,0.83,0.1642,33,499,532,532,True
15797,2012-10-25,4,1,10,9,0,4,1,2,0.52,0.5,0.83,0.194,23,320,343,343,True
15798,2012-10-25,4,1,10,10,0,4,1,2,0.54,0.5152,0.83,0.1343,53,172,225,225,True
15799,2012-10-25,4,1,10,11,0,4,1,2,0.54,0.5152,0.83,0.1045,57,181,238,238,True
15800,2012-10-25,4,1,10,12,0,4,1,2,0.56,0.5303,0.78,0.1045,61,258,319,319,True
15801,2012-10-25,4,1,10,13,0,4,1,2,0.56,0.5303,0.78,0.0,49,264,313,313,True
15802,2012-10-25,4,1,10,14,0,4,1,1,0.6,0.5909,0.73,0.1343,71,214,285,285,True
15803,2012-10-25,4,1,10,15,0,4,1,1,0.62,0.6061,0.65,0.1343,63,242,305,305,True
15804,2012-10-25,4,1,10,16,0,4,1,1,0.6,0.5909,0.69,0.1642,92,407,499,499,True
15805,2012-10-25,4,1,10,17,0,4,1,1,0.6,0.5909,0.69,0.1642,112,499,611,611,True
15806,2012-10-25,4,1,10,18,0,4,1,1,0.56,0.5303,0.83,0.1045,77,499,576,576,True
15807,2012-10-25,4,1,10,19,0,4,1,1,0.54,0.5152,0.83,0.194,45,497,542,542,True
15808,2012-10-25,4,1,10,20,0,4,1,2,0.52,0.5,0.88,0.1343,28,319,347,347,True
15809,2012-10-25,4,1,10,21,0,4,1,2,0.52,0.5,0.88,0.1343,24,247,271,271,True
15810,2012-10-25,4,1,10,22,0,4,1,2,0.54,0.5152,0.83,0.0896,22,185,207,207,True
15811,2012-10-25,4,1,10,23,0,4,1,2,0.54,0.5152,0.83,0.1343,13,122,135,135,True
15812,2012-10-26,4,1,10,0,0,5,1,2,0.54,0.5152,0.77,0.0,6,65,71,71,True
15813,2012-10-26,4,1,10,1,0,5,1,2,0.52,0.5,0.88,0.0896,4,32,36,36,True
15814,2012-10-26,4,1,10,2,0,5,1,2,0.52,0.5,0.88,0.1045,4,15,19,19,True
15815,2012-10-26,4,1,10,3,0,5,1,2,0.52,0.5,0.88,0.1642,5,8,13,13,True
15816,2012-10-26,4,1,10,4,0,5,1,2,0.52,0.5,0.88,0.1642,1,4,5,5,True
15817,2012-10-26,4,1,10,5,0,5,1,2,0.52,0.5,0.88,0.1045,3,47,50,50,True
15818,2012-10-26,4,1,10,6,0,5,1,2,0.52,0.5,0.88,0.0896,2,142,144,144,True
15819,2012-10-26,4,1,10,7,0,5,1,2,0.52,0.5,0.88,0.1045,13,408,421,421,True
15820,2012-10-26,4,1,10,8,0,5,1,2,0.54,0.5152,0.88,0.1343,20,499,519,519,True
15821,2012-10-26,4,1,10,9,0,5,1,2,0.54,0.5152,0.88,0.1343,56,347,403,403,True
15822,2012-10-26,4,1,10,10,0,5,1,2,0.54,0.5152,0.88,0.1045,41,156,197,197,True
15823,2012-10-26,4,1,10,11,0,5,1,2,0.56,0.5303,0.78,0.1642,68,222,290,290,True
15824,2012-10-26,4,1,10,12,0,5,1,2,0.58,0.5455,0.73,0.194,90,302,392,392,True
15825,2012-10-26,4,1,10,13,0,5,1,2,0.58,0.5455,0.68,0.1343,77,260,337,337,True
15826,2012-10-26,4,1,10,14,0,5,1,2,0.6,0.6061,0.64,0.1343,99,252,351,351,True
15827,2012-10-26,4,1,10,15,0,5,1,2,0.62,0.6061,0.61,0.1045,114,306,420,420,True
15828,2012-10-26,4,1,10,16,0,5,1,2,0.58,0.5455,0.73,0.1642,114,445,559,559,True
15829,2012-10-26,4,1,10,17,0,5,1,2,0.56,0.5303,0.76,0.194,114,499,613,613,True
15830,2012-10-26,4,1,10,18,0,5,1,2,0.56,0.5303,0.78,0.1343,81,499,580,580,True
15831,2012-10-26,4,1,10,19,0,5,1,2,0.54,0.5152,0.83,0.1642,72,399,471,471,True
15832,2012-10-26,4,1,10,20,0,5,1,2,0.54,0.5152,0.83,0.1642,40,271,311,311,True
15833,2012-10-26,4,1,10,21,0,5,1,2,0.54,0.5152,0.77,0.1343,40,252,292,292,True
15834,2012-10-26,4,1,10,22,0,5,1,2,0.52,0.5,0.83,0.1343,37,180,217,217,True
15835,2012-10-26,4,1,10,23,0,5,1,1,0.52,0.5,0.83,0.1642,19,159,178,178,True
15836,2012-10-27,4,1,10,0,0,6,0,1,0.5,0.4848,0.88,0.1343,10,132,142,142,True
15837,2012-10-27,4,1,10,1,0,6,0,2,0.5,0.4848,0.88,0.1343,23,123,146,146,True
15838,2012-10-27,4,1,10,2,0,6,0,2,0.5,0.4848,0.88,0.194,19,71,90,90,True
15839,2012-10-27,4,1,10,3,0,6,0,1,0.5,0.4848,0.88,0.1642,5,21,26,26,True
15840,2012-10-27,4,1,10,4,0,6,0,2,0.5,0.4848,0.88,0.1642,1,12,13,13,True
15841,2012-10-27,4,1,10,5,0,6,0,2,0.5,0.4848,0.82,0.194,2,7,9,9,True
15842,2012-10-27,4,1,10,6,0,6,0,2,0.5,0.4848,0.82,0.194,2,29,31,31,True
15843,2012-10-27,4,1,10,7,0,6,0,1,0.48,0.4697,0.83,0.194,7,79,86,86,True
15844,2012-10-27,4,1,10,8,0,6,0,1,0.5,0.4848,0.77,0.2537,26,187,213,213,True
15845,2012-10-27,4,1,10,9,0,6,0,1,0.5,0.4848,0.77,0.2537,88,240,328,328,True
15846,2012-10-27,4,1,10,10,0,6,0,1,0.54,0.5152,0.73,0.2836,114,314,428,428,True
15847,2012-10-27,4,1,10,11,0,6,0,1,0.56,0.5303,0.64,0.2836,114,388,502,502,True
15848,2012-10-27,4,1,10,12,0,6,0,1,0.6,0.6212,0.53,0.2537,114,404,518,518,True
15849,2012-10-27,4,1,10,13,0,6,0,1,0.6,0.6212,0.43,0.2537,114,450,564,564,True
15850,2012-10-27,4,1,10,14,0,6,0,1,0.6,0.6212,0.46,0.2537,114,425,539,539,True
15851,2012-10-27,4,1,10,15,0,6,0,2,0.56,0.5303,0.6,0.2836,114,401,515,515,True
15852,2012-10-27,4,1,10,16,0,6,0,2,0.56,0.5303,0.64,0.2836,114,355,469,469,True
15853,2012-10-27,4,1,10,17,0,6,0,2,0.56,0.5303,0.64,0.2836,114,370,484,484,True
15854,2012-10-27,4,1,10,18,0,6,0,2,0.56,0.5303,0.64,0.2836,114,318,432,432,True
15855,2012-10-27,4,1,10,19,0,6,0,2,0.52,0.5,0.72,0.2239,67,233,300,300,True
15856,2012-10-27,4,1,10,20,0,6,0,2,0.52,0.5,0.72,0.2239,58,238,296,296,True
15857,2012-10-27,4,1,10,21,0,6,0,2,0.52,0.5,0.72,0.2239,49,160,209,209,True
15858,2012-10-27,4,1,10,22,0,6,0,2,0.52,0.5,0.72,0.2537,41,116,157,157,True
15859,2012-10-27,4,1,10,23,0,6,0,2,0.52,0.5,0.68,0.3881,31,136,167,167,True
15860,2012-10-28,4,1,10,0,0,0,0,3,0.52,0.5,0.68,0.2985,20,97,117,117,True
15861,2012-10-28,4,1,10,1,0,0,0,2,0.5,0.4848,0.72,0.2836,22,111,133,133,True
15862,2012-10-28,4,1,10,2,0,0,0,2,0.5,0.4848,0.68,0.2985,17,99,116,116,True
15863,2012-10-28,4,1,10,3,0,0,0,2,0.5,0.4848,0.63,0.3284,18,61,79,79,True
15864,2012-10-28,4,1,10,4,0,0,0,2,0.5,0.4848,0.63,0.3582,1,19,20,20,True
15865,2012-10-28,4,1,10,5,0,0,0,2,0.5,0.4848,0.63,0.2985,6,22,28,28,True
15866,2012-10-28,4,1,10,6,0,0,0,2,0.5,0.4848,0.59,0.3284,7,32,39,39,True
15867,2012-10-28,4,1,10,7,0,0,0,2,0.5,0.4848,0.59,0.2985,17,48,65,65,True
15868,2012-10-28,4,1,10,8,0,0,0,2,0.5,0.4848,0.59,0.4775,55,118,173,173,True
15869,2012-10-28,4,1,10,9,0,0,0,2,0.5,0.4848,0.55,0.4179,114,206,320,320,True
15870,2012-10-28,4,1,10,10,0,0,0,2,0.48,0.4697,0.51,0.4179,114,314,428,428,True
15871,2012-10-28,4,1,10,11,0,0,0,2,0.5,0.4848,0.51,0.3881,110,352,462,462,True
15872,2012-10-28,4,1,10,12,0,0,0,2,0.48,0.4697,0.59,0.4775,114,373,487,487,True
15873,2012-10-28,4,1,10,13,0,0,0,2,0.48,0.4697,0.59,0.4179,75,316,391,391,True
15874,2012-10-28,4,1,10,14,0,0,0,2,0.5,0.4848,0.59,0.4478,98,304,402,402,True
15875,2012-10-28,4,1,10,15,0,0,0,2,0.5,0.4848,0.63,0.4775,76,225,301,301,True
15876,2012-10-28,4,1,10,16,0,0,0,3,0.48,0.4697,0.67,0.4627,42,251,293,293,True
15877,2012-10-28,4,1,10,17,0,0,0,3,0.46,0.4545,0.77,0.4775,37,188,225,225,True
15878,2012-10-28,4,1,10,18,0,0,0,3,0.42,0.4242,0.94,0.4775,18,136,154,154,True
15879,2012-10-28,4,1,10,19,0,0,0,3,0.42,0.4242,0.94,0.3582,7,47,54,54,True
15880,2012-10-28,4,1,10,20,0,0,0,3,0.42,0.4242,0.94,0.4627,4,51,55,55,True
15881,2012-10-28,4,1,10,21,0,0,0,3,0.44,0.4394,0.88,0.4179,2,44,46,46,True
15882,2012-10-28,4,1,10,22,0,0,0,3,0.44,0.4394,0.88,0.3582,2,35,37,37,True
15883,2012-10-28,4,1,10,23,0,0,0,3,0.42,0.4242,0.94,0.3582,2,12,14,14,True
15884,2012-10-29,4,1,10,0,0,1,1,3,0.44,0.4394,0.88,0.3582,2,20,22,22,True
15885,2012-10-30,4,1,10,13,0,2,1,3,0.3,0.2727,0.81,0.3582,11,105,116,116,True
15886,2012-10-30,4,1,10,14,0,2,1,3,0.3,0.2727,0.81,0.3582,8,118,126,126,True
15887,2012-10-30,4,1,10,15,0,2,1,3,0.3,0.2879,0.87,0.2537,10,114,124,124,True
15888,2012-10-30,4,1,10,16,0,2,1,3,0.3,0.2879,0.87,0.2537,15,83,98,98,True
15889,2012-10-30,4,1,10,17,0,2,1,3,0.3,0.2879,0.87,0.2239,19,105,124,124,True
15890,2012-10-30,4,1,10,18,0,2,1,3,0.3,0.303,0.87,0.1343,4,139,143,143,True
15891,2012-10-30,4,1,10,19,0,2,1,2,0.5,0.4848,0.68,0.194,6,109,115,115,True
15892,2012-10-30,4,1,10,20,0,2,1,2,0.3,0.2879,0.81,0.194,5,76,81,81,True
15893,2012-10-30,4,1,10,21,0,2,1,2,0.3,0.3182,0.87,0.1045,4,60,64,64,True
15894,2012-10-30,4,1,10,22,0,2,1,1,0.3,0.303,0.81,0.1343,2,64,66,66,True
15895,2012-10-30,4,1,10,23,0,2,1,1,0.3,0.303,0.81,0.1343,3,36,39,39,True
15896,2012-10-31,4,1,10,0,0,3,1,2,0.3,0.3182,0.81,0.1045,0,16,16,16,True
15897,2012-10-31,4,1,10,1,0,3,1,2,0.3,0.3182,0.81,0.0896,0,8,8,8,True
15898,2012-10-31,4,1,10,2,0,3,1,2,0.3,0.303,0.81,0.1343,0,7,7,7,True
15899,2012-10-31,4,1,10,3,0,3,1,2,0.3,0.3182,0.81,0.1045,0,3,3,3,True
15900,2012-10-31,4,1,10,4,0,3,1,2,0.3,0.2879,0.87,0.194,0,5,5,5,True
15901,2012-10-31,4,1,10,5,0,3,1,2,0.3,0.303,0.81,0.1343,0,24,24,24,True
15902,2012-10-31,4,1,10,6,0,3,1,1,0.3,0.303,0.81,0.1642,0,116,116,116,True
15903,2012-10-31,4,1,10,7,0,3,1,2,0.3,0.303,0.87,0.1343,3,334,337,337,True
15904,2012-10-31,4,1,10,8,0,3,1,1,0.32,0.3333,0.81,0.1343,6,499,505,505,True
15905,2012-10-31,4,1,10,9,0,3,1,1,0.34,0.3333,0.76,0.1343,17,280,297,297,True
15906,2012-10-31,4,1,10,10,0,3,1,1,0.36,0.3333,0.71,0.2836,21,147,168,168,True
15907,2012-10-31,4,1,10,11,0,3,1,2,0.36,0.3485,0.66,0.2239,37,152,189,189,True
15908,2012-10-31,4,1,10,12,0,3,1,1,0.4,0.4091,0.58,0.194,44,197,241,241,True
15909,2012-10-31,4,1,10,13,0,3,1,1,0.42,0.4242,0.5,0.2239,22,191,213,213,True
15910,2012-10-31,4,1,10,14,0,3,1,2,0.42,0.4242,0.5,0.2239,45,179,224,224,True
15911,2012-10-31,4,1,10,15,0,3,1,1,0.42,0.4242,0.54,0.1642,33,197,230,230,True
15912,2012-10-31,4,1,10,16,0,3,1,2,0.42,0.4242,0.54,0.2239,51,373,424,424,True
15913,2012-10-31,4,1,10,17,0,3,1,2,0.4,0.4091,0.58,0.1642,39,499,538,538,True
15914,2012-10-31,4,1,10,18,0,3,1,2,0.4,0.4091,0.58,0.1642,28,499,527,527,True
15915,2012-10-31,4,1,10,19,0,3,1,2,0.4,0.4091,0.5,0.194,27,383,410,410,True
15916,2012-10-31,4,1,10,20,0,3,1,2,0.4,0.4091,0.5,0.194,9,259,268,268,True
15917,2012-10-31,4,1,10,21,0,3,1,2,0.4,0.4091,0.5,0.194,12,180,192,192,True
15918,2012-10-31,4,1,10,22,0,3,1,1,0.36,0.3485,0.57,0.1343,18,147,165,165,True
15919,2012-10-31,4,1,10,23,0,3,1,1,0.36,0.3636,0.57,0.0896,7,94,101,101,True
15920,2012-11-01,4,1,11,0,0,4,1,1,0.36,0.3636,0.57,0.0896,8,52,60,60,True
15921,2012-11-01,4,1,11,1,0,4,1,1,0.3,0.3182,0.75,0.1045,8,22,30,30,True
15922,2012-11-01,4,1,11,2,0,4,1,1,0.32,0.3333,0.66,0.1343,10,10,20,20,True
15923,2012-11-01,4,1,11,3,0,4,1,1,0.34,0.3333,0.61,0.1343,5,10,15,15,True
15924,2012-11-01,4,1,11,4,0,4,1,2,0.34,0.3485,0.66,0.1045,2,8,10,10,True
15925,2012-11-01,4,1,11,5,0,4,1,1,0.34,0.3333,0.66,0.1343,1,39,40,40,True
15926,2012-11-01,4,1,11,6,0,4,1,1,0.34,0.3333,0.61,0.1642,2,146,148,148,True
15927,2012-11-01,4,1,11,7,0,4,1,2,0.36,0.3485,0.57,0.1642,6,414,420,420,True
15928,2012-11-01,4,1,11,8,0,4,1,2,0.36,0.3788,0.56,0.1045,12,499,511,511,True
15929,2012-11-01,4,1,11,9,0,4,1,3,0.36,0.3636,0.57,0.1045,21,310,331,331,True
15930,2012-11-01,4,1,11,10,0,4,1,3,0.36,0.3485,0.62,0.194,13,133,146,146,True
15931,2012-11-01,4,1,11,11,0,4,1,3,0.36,0.3485,0.62,0.194,14,156,170,170,True
15932,2012-11-01,4,1,11,12,0,4,1,3,0.38,0.3939,0.62,0.1642,23,198,221,221,True
15933,2012-11-01,4,1,11,13,0,4,1,2,0.4,0.4091,0.58,0.1642,49,199,248,248,True
15934,2012-11-01,4,1,11,14,0,4,1,2,0.4,0.4091,0.5,0.2239,31,154,185,185,True
15935,2012-11-01,4,1,11,15,0,4,1,2,0.4,0.4091,0.54,0.1642,35,179,214,214,True
15936,2012-11-01,4,1,11,16,0,4,1,2,0.4,0.4091,0.54,0.1642,31,313,344,344,True
15937,2012-11-01,4,1,11,17,0,4,1,3,0.4,0.4091,0.5,0.2239,37,499,536,536,True
15938,2012-11-01,4,1,11,18,0,4,1,2,0.4,0.4091,0.5,0.1642,50,499,549,549,True
15939,2012-11-01,4,1,11,19,0,4,1,2,0.4,0.4091,0.5,0.1642,28,424,452,452,True
15940,2012-11-01,4,1,11,20,0,4,1,2,0.38,0.3939,0.54,0.2537,16,280,296,296,True
15941,2012-11-01,4,1,11,21,0,4,1,2,0.38,0.3939,0.54,0.1343,29,238,267,267,True
15942,2012-11-01,4,1,11,22,0,4,1,1,0.36,0.3485,0.57,0.1642,27,175,202,202,True
15943,2012-11-01,4,1,11,23,0,4,1,1,0.34,0.3333,0.57,0.1642,8,112,120,120,True
15944,2012-11-02,4,1,11,0,0,5,1,1,0.34,0.3333,0.57,0.1642,10,40,50,50,True
15945,2012-11-02,4,1,11,1,0,5,1,1,0.32,0.3182,0.66,0.1642,5,19,24,24,True
15946,2012-11-02,4,1,11,2,0,5,1,1,0.32,0.3182,0.66,0.1642,3,7,10,10,True
15947,2012-11-02,4,1,11,3,0,5,1,1,0.3,0.303,0.7,0.1642,0,3,3,3,True
15948,2012-11-02,4,1,11,4,0,5,1,1,0.3,0.3182,0.7,0.1045,1,6,7,7,True
15949,2012-11-02,4,1,11,5,0,5,1,2,0.32,0.3182,0.66,0.1642,1,25,26,26,True
15950,2012-11-02,4,1,11,6,0,5,1,1,0.3,0.303,0.7,0.1642,2,120,122,122,True
15951,2012-11-02,4,1,11,7,0,5,1,2,0.3,0.303,0.7,0.1343,8,349,357,357,True
15952,2012-11-02,4,1,11,8,0,5,1,1,0.32,0.3333,0.57,0.1045,31,499,530,530,True
15953,2012-11-02,4,1,11,9,0,5,1,1,0.34,0.3485,0.53,0.1045,27,355,382,382,True
15954,2012-11-02,4,1,11,10,0,5,1,1,0.38,0.3939,0.46,0.2985,21,183,204,204,True
15955,2012-11-02,4,1,11,11,0,5,1,1,0.42,0.4242,0.41,0.4179,42,179,221,221,True
15956,2012-11-02,4,1,11,12,0,5,1,1,0.42,0.4242,0.41,0.3582,52,240,292,292,True
15957,2012-11-02,4,1,11,13,0,5,1,1,0.4,0.4091,0.43,0.3582,64,230,294,294,True
15958,2012-11-02,4,1,11,14,0,5,1,2,0.4,0.4091,0.4,0.4775,63,199,262,262,True
15959,2012-11-02,4,1,11,15,0,5,1,2,0.4,0.4091,0.4,0.4179,51,255,306,306,True
15960,2012-11-02,4,1,11,16,0,5,1,1,0.38,0.3939,0.4,0.3284,48,373,421,421,True
15961,2012-11-02,4,1,11,17,0,5,1,1,0.38,0.3939,0.4,0.3284,57,499,556,556,True
15962,2012-11-02,4,1,11,18,0,5,1,2,0.38,0.3939,0.43,0.3284,32,490,522,522,True
15963,2012-11-02,4,1,11,19,0,5,1,2,0.38,0.3939,0.43,0.2985,38,336,374,374,True
15964,2012-11-02,4,1,11,20,0,5,1,2,0.36,0.3333,0.46,0.4179,14,207,221,221,True
15965,2012-11-02,4,1,11,21,0,5,1,2,0.36,0.3333,0.46,0.3582,23,133,156,156,True
15966,2012-11-02,4,1,11,22,0,5,1,1,0.36,0.3333,0.46,0.2537,14,135,149,149,True
15967,2012-11-02,4,1,11,23,0,5,1,1,0.34,0.303,0.53,0.2985,11,108,119,119,True
15968,2012-11-03,4,1,11,0,0,6,0,1,0.34,0.3333,0.53,0.1642,9,99,108,108,True
15969,2012-11-03,4,1,11,1,0,6,0,2,0.34,0.303,0.49,0.3284,6,83,89,89,True
15970,2012-11-03,4,1,11,2,0,6,0,2,0.34,0.3182,0.49,0.2537,10,36,46,46,True
15971,2012-11-03,4,1,11,3,0,6,0,2,0.34,0.3182,0.49,0.2537,6,22,28,28,True
15972,2012-11-03,4,1,11,4,0,6,0,2,0.32,0.303,0.49,0.2985,8,8,16,16,True
15973,2012-11-03,4,1,11,5,0,6,0,2,0.32,0.303,0.49,0.2537,1,8,9,9,True
15974,2012-11-03,4,1,11,6,0,6,0,2,0.32,0.3182,0.49,0.194,4,17,21,21,True
15975,2012-11-03,4,1,11,7,0,6,0,2,0.32,0.303,0.49,0.2537,1,58,59,59,True
15976,2012-11-03,4,1,11,8,0,6,0,2,0.34,0.303,0.46,0.2985,10,132,142,142,True
15977,2012-11-03,4,1,11,9,0,6,0,2,0.34,0.303,0.49,0.2985,31,188,219,219,True
15978,2012-11-03,4,1,11,10,0,6,0,1,0.36,0.3333,0.46,0.3881,68,260,328,328,True
15979,2012-11-03,4,1,11,11,0,6,0,2,0.36,0.3333,0.46,0.3881,56,284,340,340,True
15980,2012-11-03,4,1,11,12,0,6,0,2,0.36,0.3182,0.46,0.4627,74,320,394,394,True
15981,2012-11-03,4,1,11,13,0,6,0,2,0.36,0.3333,0.46,0.3582,110,339,449,449,True
15982,2012-11-03,4,1,11,14,0,6,0,2,0.36,0.3333,0.5,0.3284,114,319,433,433,True
15983,2012-11-03,4,1,11,15,0,6,0,2,0.36,0.3182,0.46,0.4478,114,331,445,445,True
15984,2012-11-03,4,1,11,16,0,6,0,2,0.36,0.3333,0.46,0.3284,108,292,400,400,True
15985,2012-11-03,4,1,11,17,0,6,0,2,0.36,0.3333,0.46,0.2985,112,298,410,410,True
15986,2012-11-03,4,1,11,18,0,6,0,2,0.36,0.3333,0.46,0.2836,58,239,297,297,True
15987,2012-11-03,4,1,11,19,0,6,0,1,0.36,0.3485,0.5,0.1642,22,217,239,239,True
15988,2012-11-03,4,1,11,20,0,6,0,1,0.34,0.3333,0.53,0.1343,23,158,181,181,True
15989,2012-11-03,4,1,11,21,0,6,0,1,0.34,0.3485,0.53,0.1045,31,135,166,166,True
15990,2012-11-03,4,1,11,22,0,6,0,1,0.32,0.3333,0.57,0.1045,13,133,146,146,True
15991,2012-11-03,4,1,11,23,0,6,0,1,0.32,0.3333,0.57,0.1045,15,133,148,148,True
15992,2012-11-04,4,1,11,0,0,0,0,1,0.3,0.3182,0.61,0.1045,5,97,102,102,True
15993,2012-11-04,4,1,11,1,0,0,0,1,0.26,0.2879,0.81,0.0896,26,139,165,165,True
15994,2012-11-04,4,1,11,2,0,0,0,1,0.3,0.3333,0.65,0.0,6,31,37,37,True
15995,2012-11-04,4,1,11,3,0,0,0,1,0.28,0.2879,0.61,0.1045,1,10,11,11,True
15996,2012-11-04,4,1,11,4,0,0,0,1,0.26,0.2727,0.65,0.1343,2,7,9,9,True
15997,2012-11-04,4,1,11,5,0,0,0,1,0.26,0.2727,0.65,0.1045,0,5,5,5,True
15998,2012-11-04,4,1,11,6,0,0,0,1,0.28,0.2879,0.61,0.1343,2,14,16,16,True
15999,2012-11-04,4,1,11,7,0,0,0,1,0.26,0.2727,0.65,0.1045,11,39,50,50,True
16000,2012-11-04,4,1,11,8,0,0,0,1,0.3,0.303,0.56,0.1343,34,115,149,149,True
16001,2012-11-04,4,1,11,9,0,0,0,1,0.32,0.3333,0.53,0.0,56,161,217,217,True
16002,2012-11-04,4,1,11,10,0,0,0,1,0.34,0.3333,0.49,0.194,73,287,360,360,True
16003,2012-11-04,4,1,11,11,0,0,0,1,0.38,0.3939,0.46,0.2239,114,311,425,425,True
16004,2012-11-04,4,1,11,12,0,0,0,1,0.38,0.3939,0.46,0.2239,114,354,468,468,True
16005,2012-11-04,4,1,11,13,0,0,0,1,0.4,0.4091,0.43,0.2239,114,371,485,485,True
16006,2012-11-04,4,1,11,14,0,0,0,1,0.4,0.4091,0.4,0.194,114,360,474,474,True
16007,2012-11-04,4,1,11,15,0,0,0,1,0.4,0.4091,0.4,0.2239,114,300,414,414,True
16008,2012-11-04,4,1,11,16,0,0,0,1,0.4,0.4091,0.4,0.3284,114,316,430,430,True
16009,2012-11-04,4,1,11,17,0,0,0,1,0.36,0.3485,0.43,0.194,57,270,327,327,True
16010,2012-11-04,4,1,11,18,0,0,0,1,0.36,0.3485,0.43,0.2239,31,206,237,237,True
16011,2012-11-04,4,1,11,19,0,0,0,1,0.36,0.3333,0.43,0.2537,24,203,227,227,True
16012,2012-11-04,4,1,11,20,0,0,0,1,0.32,0.2879,0.53,0.3582,7,134,141,141,True
16013,2012-11-04,4,1,11,21,0,0,0,1,0.3,0.2727,0.52,0.2985,16,71,87,87,True
16014,2012-11-04,4,1,11,22,0,0,0,1,0.3,0.2879,0.52,0.2836,15,64,79,79,True
16015,2012-11-04,4,1,11,23,0,0,0,2,0.3,0.303,0.56,0.1642,12,41,53,53,True
16016,2012-11-05,4,1,11,0,0,1,1,2,0.3,0.2879,0.56,0.194,3,20,23,23,True
16017,2012-11-05,4,1,11,1,0,1,1,2,0.3,0.303,0.56,0.1642,0,8,8,8,True
16018,2012-11-05,4,1,11,2,0,1,1,2,0.3,0.303,0.56,0.1642,2,4,6,6,True
16019,2012-11-05,4,1,11,3,0,1,1,2,0.3,0.2879,0.56,0.2239,1,3,4,4,True
16020,2012-11-05,4,1,11,4,0,1,1,2,0.3,0.2879,0.52,0.2537,5,11,16,16,True
16021,2012-11-05,4,1,11,5,0,1,1,2,0.3,0.2727,0.52,0.3284,1,38,39,39,True
16022,2012-11-05,4,1,11,6,0,1,1,2,0.3,0.2879,0.49,0.2836,4,135,139,139,True
16023,2012-11-05,4,1,11,7,0,1,1,2,0.3,0.2879,0.49,0.2537,8,453,461,461,True
16024,2012-11-05,4,1,11,8,0,1,1,2,0.3,0.2879,0.49,0.2239,19,499,518,518,True
16025,2012-11-05,4,1,11,9,0,1,1,2,0.3,0.2879,0.52,0.2836,18,239,257,257,True
16026,2012-11-05,4,1,11,10,0,1,1,1,0.32,0.303,0.49,0.2836,30,112,142,142,True
16027,2012-11-05,4,1,11,11,0,1,1,1,0.34,0.3182,0.46,0.2239,31,119,150,150,True
16028,2012-11-05,4,1,11,12,0,1,1,1,0.36,0.3333,0.43,0.3284,38,206,244,244,True
16029,2012-11-05,4,1,11,13,0,1,1,1,0.36,0.3333,0.4,0.2537,39,183,222,222,True
16030,2012-11-05,4,1,11,14,0,1,1,1,0.38,0.3939,0.4,0.1642,31,165,196,196,True
16031,2012-11-05,4,1,11,15,0,1,1,1,0.38,0.3939,0.4,0.2836,24,207,231,231,True
16032,2012-11-05,4,1,11,16,0,1,1,1,0.36,0.3333,0.43,0.2836,35,325,360,360,True
16033,2012-11-05,4,1,11,17,0,1,1,1,0.34,0.3182,0.46,0.2239,34,499,533,533,True
16034,2012-11-05,4,1,11,18,0,1,1,1,0.34,0.3182,0.46,0.2239,19,499,518,518,True
16035,2012-11-05,4,1,11,19,0,1,1,1,0.32,0.3182,0.49,0.1642,11,361,372,372,True
16036,2012-11-05,4,1,11,20,0,1,1,1,0.32,0.303,0.49,0.2537,13,228,241,241,True
16037,2012-11-05,4,1,11,21,0,1,1,1,0.3,0.2879,0.52,0.2836,8,144,152,152,True
16038,2012-11-05,4,1,11,22,0,1,1,1,0.28,0.2727,0.56,0.194,4,111,115,115,True
16039,2012-11-05,4,1,11,23,0,1,1,1,0.26,0.2727,0.6,0.1343,0,53,53,53,True
16040,2012-11-06,4,1,11,0,0,2,1,1,0.24,0.2576,0.6,0.1045,1,18,19,19,True
16041,2012-11-06,4,1,11,1,0,2,1,1,0.24,0.2424,0.6,0.1642,0,8,8,8,True
16042,2012-11-06,4,1,11,2,0,2,1,1,0.24,0.2576,0.65,0.0896,0,2,2,2,True
16043,2012-11-06,4,1,11,3,0,2,1,1,0.22,0.2424,0.64,0.1045,0,4,4,4,True
16044,2012-11-06,4,1,11,4,0,2,1,1,0.22,0.2576,0.69,0.0896,0,7,7,7,True
16045,2012-11-06,4,1,11,5,0,2,1,2,0.22,0.2273,0.64,0.194,1,40,41,41,True
16046,2012-11-06,4,1,11,6,0,2,1,1,0.22,0.2273,0.69,0.1343,6,143,149,149,True
16047,2012-11-06,4,1,11,7,0,2,1,1,0.2,0.2121,0.69,0.1642,9,378,387,387,True
16048,2012-11-06,4,1,11,8,0,2,1,1,0.22,0.2273,0.69,0.1642,20,499,519,519,True
16049,2012-11-06,4,1,11,9,0,2,1,1,0.26,0.2576,0.6,0.1642,25,338,363,363,True
16050,2012-11-06,4,1,11,10,0,2,1,1,0.3,0.2879,0.49,0.194,41,189,230,230,True
16051,2012-11-06,4,1,11,11,0,2,1,1,0.32,0.3333,0.45,0.1343,39,177,216,216,True
16052,2012-11-06,4,1,11,12,0,2,1,1,0.32,0.3333,0.45,0.1343,31,217,248,248,True
16053,2012-11-06,4,1,11,13,0,2,1,1,0.34,0.3333,0.46,0.1343,46,232,278,278,True
16054,2012-11-06,4,1,11,14,0,2,1,1,0.36,0.3636,0.4,0.1045,44,196,240,240,True
16055,2012-11-06,4,1,11,15,0,2,1,1,0.34,0.3182,0.46,0.2537,45,227,272,272,True
16056,2012-11-06,4,1,11,16,0,2,1,1,0.34,0.3333,0.46,0.1642,33,369,402,402,True
16057,2012-11-06,4,1,11,17,0,2,1,1,0.32,0.303,0.53,0.2239,30,499,529,529,True
16058,2012-11-06,4,1,11,18,0,2,1,1,0.32,0.303,0.57,0.2985,20,477,497,497,True
16059,2012-11-06,4,1,11,19,0,2,1,1,0.3,0.2879,0.56,0.2239,15,356,371,371,True
16060,2012-11-06,4,1,11,20,0,2,1,1,0.3,0.2879,0.61,0.2239,10,218,228,228,True
16061,2012-11-06,4,1,11,21,0,2,1,2,0.3,0.2879,0.56,0.2537,14,137,151,151,True
16062,2012-11-06,4,1,11,22,0,2,1,2,0.3,0.2879,0.56,0.2239,17,136,153,153,True
16063,2012-11-06,4,1,11,23,0,2,1,1,0.3,0.2879,0.56,0.2239,19,186,205,205,True
16064,2012-11-07,4,1,11,0,0,3,1,2,0.3,0.2879,0.56,0.2836,49,234,283,283,True
16065,2012-11-07,4,1,11,1,0,3,1,2,0.28,0.2727,0.61,0.2537,6,86,92,92,True
16066,2012-11-07,4,1,11,2,0,3,1,2,0.28,0.2576,0.56,0.2985,6,68,74,74,True
16067,2012-11-07,4,1,11,3,0,3,1,2,0.28,0.2576,0.52,0.3284,2,9,11,11,True
16068,2012-11-07,4,1,11,4,0,3,1,2,0.28,0.2576,0.52,0.2985,0,9,9,9,True
16069,2012-11-07,4,1,11,5,0,3,1,2,0.28,0.2576,0.52,0.3284,0,27,27,27,True
16070,2012-11-07,4,1,11,6,0,3,1,2,0.26,0.2424,0.56,0.2836,3,115,118,118,True
16071,2012-11-07,4,1,11,7,0,3,1,2,0.26,0.2273,0.56,0.2985,5,314,319,319,True
16072,2012-11-07,4,1,11,8,0,3,1,2,0.26,0.2424,0.6,0.2836,18,499,517,517,True
16073,2012-11-07,4,1,11,9,0,3,1,2,0.26,0.2424,0.6,0.2836,17,351,368,368,True
16074,2012-11-07,4,1,11,10,0,3,1,2,0.28,0.2576,0.56,0.2985,27,151,178,178,True
16075,2012-11-07,4,1,11,11,0,3,1,2,0.32,0.2879,0.51,0.3582,15,132,147,147,True
16076,2012-11-07,4,1,11,12,0,3,1,2,0.32,0.303,0.53,0.2836,24,188,212,212,True
16077,2012-11-07,4,1,11,13,0,3,1,2,0.32,0.303,0.53,0.2537,23,158,181,181,True
16078,2012-11-07,4,1,11,14,0,3,1,2,0.32,0.2879,0.53,0.3582,19,142,161,161,True
16079,2012-11-07,4,1,11,15,0,3,1,2,0.32,0.303,0.53,0.2985,20,178,198,198,True
16080,2012-11-07,4,1,11,16,0,3,1,2,0.32,0.2879,0.53,0.3582,23,250,273,273,True
16081,2012-11-07,4,1,11,17,0,3,1,2,0.32,0.2879,0.53,0.3881,16,499,515,515,True
16082,2012-11-07,4,1,11,18,0,3,1,2,0.32,0.2879,0.53,0.3582,17,448,465,465,True
16083,2012-11-07,4,1,11,19,0,3,1,2,0.3,0.2727,0.56,0.2985,17,302,319,319,True
16084,2012-11-07,4,1,11,20,0,3,1,2,0.32,0.303,0.49,0.3284,7,249,256,256,True
16085,2012-11-07,4,1,11,21,0,3,1,2,0.32,0.303,0.49,0.2985,5,121,126,126,True
16086,2012-11-07,4,1,11,22,0,3,1,3,0.3,0.2879,0.56,0.2537,4,56,60,60,True
16087,2012-11-07,4,1,11,23,0,3,1,3,0.28,0.2727,0.65,0.2239,3,37,40,40,True
16088,2012-11-08,4,1,11,0,0,4,1,3,0.28,0.2727,0.61,0.2239,1,14,15,15,True
16089,2012-11-08,4,1,11,1,0,4,1,3,0.3,0.2727,0.52,0.3582,1,11,12,12,True
16090,2012-11-08,4,1,11,2,0,4,1,2,0.3,0.2879,0.49,0.2239,1,5,6,6,True
16091,2012-11-08,4,1,11,4,0,4,1,2,0.3,0.2879,0.45,0.2836,1,9,10,10,True
16092,2012-11-08,4,1,11,5,0,4,1,2,0.3,0.2879,0.42,0.2239,0,35,35,35,True
16093,2012-11-08,4,1,11,6,0,4,1,1,0.3,0.2879,0.39,0.2239,2,122,124,124,True
16094,2012-11-08,4,1,11,7,0,4,1,1,0.28,0.2576,0.36,0.3881,12,411,423,423,True
16095,2012-11-08,4,1,11,8,0,4,1,1,0.3,0.2879,0.33,0.2836,16,499,515,515,True
16096,2012-11-08,4,1,11,9,0,4,1,1,0.32,0.2879,0.31,0.3582,22,253,275,275,True
16097,2012-11-08,4,1,11,10,0,4,1,1,0.32,0.303,0.31,0.3284,13,148,161,161,True
16098,2012-11-08,4,1,11,11,0,4,1,1,0.36,0.3333,0.29,0.3881,16,155,171,171,True
16099,2012-11-08,4,1,11,12,0,4,1,1,0.4,0.4091,0.24,0.4775,33,202,235,235,True
16100,2012-11-08,4,1,11,13,0,4,1,1,0.44,0.4394,0.18,0.4179,33,195,228,228,True
16101,2012-11-08,4,1,11,14,0,4,1,1,0.44,0.4394,0.18,0.4179,33,149,182,182,True
16102,2012-11-08,4,1,11,15,0,4,1,1,0.44,0.4394,0.18,0.4179,32,201,233,233,True
16103,2012-11-08,4,1,11,16,0,4,1,1,0.42,0.4242,0.16,0.3881,18,321,339,339,True
16104,2012-11-08,4,1,11,17,0,4,1,1,0.4,0.4091,0.2,0.2985,36,499,535,535,True
16105,2012-11-08,4,1,11,18,0,4,1,1,0.4,0.4091,0.24,0.4179,16,491,507,507,True
16106,2012-11-08,4,1,11,19,0,4,1,1,0.38,0.3939,0.27,0.3582,14,359,373,373,True
16107,2012-11-08,4,1,11,20,0,4,1,1,0.38,0.3939,0.29,0.4627,10,235,245,245,True
16108,2012-11-08,4,1,11,21,0,4,1,1,0.36,0.3333,0.37,0.3881,11,222,233,233,True
16109,2012-11-08,4,1,11,22,0,4,1,1,0.34,0.303,0.42,0.2985,14,147,161,161,True
16110,2012-11-08,4,1,11,23,0,4,1,1,0.34,0.303,0.46,0.3582,5,82,87,87,True
16111,2012-11-09,4,1,11,0,0,5,1,1,0.34,0.303,0.49,0.3284,9,46,55,55,True
16112,2012-11-09,4,1,11,1,0,5,1,1,0.32,0.303,0.53,0.2836,3,17,20,20,True
16113,2012-11-09,4,1,11,2,0,5,1,1,0.32,0.303,0.53,0.2537,1,11,12,12,True
16114,2012-11-09,4,1,11,3,0,5,1,1,0.32,0.2879,0.53,0.4179,3,6,9,9,True
16115,2012-11-09,4,1,11,4,0,5,1,1,0.32,0.2879,0.53,0.3582,0,14,14,14,True
16116,2012-11-09,4,1,11,5,0,5,1,1,0.3,0.2879,0.56,0.194,2,25,27,27,True
16117,2012-11-09,4,1,11,6,0,5,1,1,0.26,0.2727,0.65,0.1045,5,126,131,131,True
16118,2012-11-09,4,1,11,7,0,5,1,1,0.26,0.2727,0.65,0.1343,9,332,341,341,True
16119,2012-11-09,4,1,11,8,0,5,1,1,0.32,0.3182,0.57,0.1642,25,499,524,524,True
16120,2012-11-09,4,1,11,9,0,5,1,1,0.34,0.303,0.53,0.4179,23,304,327,327,True
16121,2012-11-09,4,1,11,10,0,5,1,1,0.36,0.3333,0.5,0.3284,34,163,197,197,True
16122,2012-11-09,4,1,11,11,0,5,1,1,0.4,0.4091,0.47,0.2985,66,185,251,251,True
16123,2012-11-09,4,1,11,12,0,5,1,1,0.44,0.4394,0.41,0.3284,48,214,262,262,True
16124,2012-11-09,4,1,11,13,0,5,1,1,0.46,0.4545,0.38,0.2985,62,237,299,299,True
16125,2012-11-09,4,1,11,14,0,5,1,1,0.46,0.4545,0.38,0.194,67,207,274,274,True
16126,2012-11-09,4,1,11,15,0,5,1,1,0.46,0.4545,0.36,0.2239,78,278,356,356,True
16127,2012-11-09,4,1,11,16,0,5,1,1,0.46,0.4545,0.38,0.1642,57,377,434,434,True
16128,2012-11-09,4,1,11,17,0,5,1,1,0.42,0.4242,0.44,0.1343,61,499,560,560,True
16129,2012-11-09,4,1,11,18,0,5,1,1,0.42,0.4242,0.44,0.1045,46,450,496,496,True
16130,2012-11-09,4,1,11,19,0,5,1,1,0.34,0.3485,0.71,0.0896,30,331,361,361,True
16131,2012-11-09,4,1,11,20,0,5,1,1,0.36,0.3485,0.66,0.1343,20,235,255,255,True
16132,2012-11-09,4,1,11,21,0,5,1,1,0.34,0.3636,0.76,0.0,23,176,199,199,True
16133,2012-11-09,4,1,11,22,0,5,1,1,0.34,0.3485,0.71,0.1045,17,146,163,163,True
16134,2012-11-09,4,1,11,23,0,5,1,1,0.32,0.3333,0.81,0.0896,20,142,162,162,True
16135,2012-11-10,4,1,11,0,0,6,0,1,0.32,0.3333,0.76,0.0896,16,106,122,122,True
16136,2012-11-10,4,1,11,1,0,6,0,1,0.3,0.3182,0.81,0.0896,8,68,76,76,True
16137,2012-11-10,4,1,11,2,0,6,0,1,0.32,0.3485,0.81,0.0,2,42,44,44,True
16138,2012-11-10,4,1,11,3,0,6,0,1,0.3,0.3333,0.81,0.0,9,11,20,20,True
16139,2012-11-10,4,1,11,4,0,6,0,1,0.26,0.2727,0.87,0.1045,2,4,6,6,True
16140,2012-11-10,4,1,11,5,0,6,0,1,0.28,0.3182,0.87,0.0,1,9,10,10,True
16141,2012-11-10,4,1,11,6,0,6,0,1,0.24,0.2576,0.93,0.0896,5,11,16,16,True
16142,2012-11-10,4,1,11,7,0,6,0,1,0.26,0.2727,0.87,0.1045,14,57,71,71,True
16143,2012-11-10,4,1,11,8,0,6,0,1,0.32,0.3485,0.76,0.0,16,130,146,146,True
16144,2012-11-10,4,1,11,9,0,6,0,1,0.36,0.3485,0.66,0.194,43,216,259,259,True
16145,2012-11-10,4,1,11,10,0,6,0,1,0.4,0.4091,0.58,0.0,86,264,350,350,True
16146,2012-11-10,4,1,11,11,0,6,0,1,0.4,0.4091,0.58,0.1045,114,323,437,437,True
16147,2012-11-10,4,1,11,12,0,6,0,1,0.48,0.4697,0.48,0.0,114,348,462,462,True
16148,2012-11-10,4,1,11,13,0,6,0,1,0.52,0.5,0.39,0.0,114,383,497,497,True
16149,2012-11-10,4,1,11,14,0,6,0,1,0.54,0.5152,0.37,0.0,114,347,461,461,True
16150,2012-11-10,4,1,11,15,0,6,0,1,0.52,0.5,0.45,0.0,114,351,465,465,True
16151,2012-11-10,4,1,11,16,0,6,0,1,0.54,0.5152,0.37,0.0,114,378,492,492,True
16152,2012-11-10,4,1,11,17,0,6,0,1,0.5,0.4848,0.45,0.194,114,318,432,432,True
16153,2012-11-10,4,1,11,18,0,6,0,1,0.44,0.4394,0.54,0.1343,103,256,359,359,True
16154,2012-11-10,4,1,11,19,0,6,0,1,0.46,0.4545,0.51,0.0896,55,228,283,283,True
16155,2012-11-10,4,1,11,20,0,6,0,1,0.44,0.4394,0.54,0.0,39,153,192,192,True
16156,2012-11-10,4,1,11,21,0,6,0,1,0.4,0.4091,0.66,0.0,51,169,220,220,True
16157,2012-11-10,4,1,11,22,0,6,0,1,0.38,0.3939,0.71,0.0896,39,154,193,193,True
16158,2012-11-10,4,1,11,23,0,6,0,1,0.36,0.3636,0.71,0.1045,26,120,146,146,True
16159,2012-11-11,4,1,11,0,0,0,0,1,0.34,0.3485,0.81,0.0896,14,110,124,124,True
16160,2012-11-11,4,1,11,1,0,0,0,1,0.34,0.3485,0.76,0.0896,26,82,108,108,True
16161,2012-11-11,4,1,11,2,0,0,0,1,0.32,0.3333,0.87,0.1045,12,58,70,70,True
16162,2012-11-11,4,1,11,3,0,0,0,1,0.34,0.3636,0.81,0.0,9,39,48,48,True
16163,2012-11-11,4,1,11,4,0,0,0,1,0.32,0.3333,0.81,0.1045,5,6,11,11,True
16164,2012-11-11,4,1,11,5,0,0,0,1,0.3,0.303,0.87,0.1343,0,12,12,12,True
16165,2012-11-11,4,1,11,6,0,0,0,1,0.3,0.3182,0.87,0.0896,3,16,19,19,True
16166,2012-11-11,4,1,11,7,0,0,0,1,0.3,0.3182,0.89,0.0896,12,56,68,68,True
16167,2012-11-11,4,1,11,8,0,0,0,1,0.32,0.3333,0.87,0.1045,32,87,119,119,True
16168,2012-11-11,4,1,11,9,0,0,0,1,0.36,0.3788,0.77,0.0,94,179,273,273,True
16169,2012-11-11,4,1,11,10,0,0,0,1,0.4,0.4091,0.69,0.1045,114,272,386,386,True
16170,2012-11-11,4,1,11,11,0,0,0,1,0.46,0.4545,0.59,0.1343,114,324,438,438,True
16171,2012-11-11,4,1,11,12,0,0,0,1,0.5,0.4848,0.48,0.0896,114,390,504,504,True
16172,2012-11-11,4,1,11,13,0,0,0,1,0.54,0.5152,0.45,0.1045,114,424,538,538,True
16173,2012-11-11,4,1,11,14,0,0,0,1,0.6,0.6212,0.33,0.1642,114,362,476,476,True
16174,2012-11-11,4,1,11,15,0,0,0,1,0.56,0.5303,0.37,0.2239,114,420,534,534,True
16175,2012-11-11,4,1,11,16,0,0,0,1,0.54,0.5152,0.42,0.2239,114,393,507,507,True
16176,2012-11-11,4,1,11,17,0,0,0,1,0.54,0.5152,0.45,0.1642,114,342,456,456,True
16177,2012-11-11,4,1,11,18,0,0,0,1,0.52,0.5,0.45,0.1343,102,303,405,405,True
16178,2012-11-11,4,1,11,19,0,0,0,1,0.48,0.4697,0.55,0.1343,69,208,277,277,True
16179,2012-11-11,4,1,11,20,0,0,0,1,0.44,0.4394,0.62,0.1642,54,146,200,200,True
16180,2012-11-11,4,1,11,21,0,0,0,1,0.44,0.4394,0.67,0.2239,44,127,171,171,True
16181,2012-11-11,4,1,11,22,0,0,0,1,0.42,0.4242,0.71,0.194,21,113,134,134,True
16182,2012-11-11,4,1,11,23,0,0,0,1,0.42,0.4242,0.71,0.194,16,93,109,109,True
16183,2012-11-12,4,1,11,0,1,1,0,1,0.42,0.4242,0.71,0.1045,6,43,49,49,True
16184,2012-11-12,4,1,11,1,1,1,0,1,0.4,0.4091,0.76,0.1642,4,26,30,30,True
16185,2012-11-12,4,1,11,2,1,1,0,1,0.4,0.4091,0.76,0.1343,6,14,20,20,True
16186,2012-11-12,4,1,11,3,1,1,0,1,0.4,0.4091,0.76,0.1343,1,3,4,4,True
16187,2012-11-12,4,1,11,4,1,1,0,1,0.4,0.4091,0.76,0.0896,1,3,4,4,True
16188,2012-11-12,4,1,11,5,1,1,0,1,0.38,0.3939,0.87,0.0,1,23,24,24,True
16189,2012-11-12,4,1,11,6,1,1,0,1,0.38,0.3939,0.87,0.1045,7,64,71,71,True
16190,2012-11-12,4,1,11,7,1,1,0,1,0.4,0.4091,0.87,0.0,16,248,264,264,True
16191,2012-11-12,4,1,11,8,1,1,0,1,0.42,0.4242,0.82,0.1642,50,490,540,540,True
16192,2012-11-12,4,1,11,9,1,1,0,1,0.44,0.4394,0.88,0.1045,60,337,397,397,True
16193,2012-11-12,4,1,11,10,1,1,0,1,0.48,0.4697,0.77,0.1642,82,184,266,266,True
16194,2012-11-12,4,1,11,11,1,1,0,1,0.52,0.5,0.72,0.1642,112,255,367,367,True
16195,2012-11-12,4,1,11,12,1,1,0,1,0.56,0.5303,0.64,0.2239,105,314,419,419,True
16196,2012-11-12,4,1,11,13,1,1,0,1,0.6,0.6061,0.6,0.2239,108,312,420,420,True
16197,2012-11-12,4,1,11,14,1,1,0,1,0.58,0.5455,0.6,0.2836,114,310,424,424,True
16198,2012-11-12,4,1,11,15,1,1,0,1,0.56,0.5303,0.64,0.2537,102,280,382,382,True
16199,2012-11-12,4,1,11,16,1,1,0,1,0.56,0.5303,0.64,0.1642,87,347,434,434,True
16200,2012-11-12,4,1,11,17,1,1,0,1,0.56,0.5303,0.64,0.2836,66,499,565,565,True
16201,2012-11-12,4,1,11,18,1,1,0,1,0.52,0.5,0.72,0.1343,65,486,551,551,True
16202,2012-11-12,4,1,11,19,1,1,0,1,0.54,0.5152,0.73,0.2836,30,323,353,353,True
16203,2012-11-12,4,1,11,20,1,1,0,2,0.52,0.5,0.77,0.2836,31,273,304,304,True
16204,2012-11-12,4,1,11,21,1,1,0,3,0.54,0.5152,0.73,0.2239,10,145,155,155,True
16205,2012-11-12,4,1,11,22,1,1,0,1,0.52,0.5,0.77,0.2537,12,100,112,112,True
16206,2012-11-12,4,1,11,23,1,1,0,2,0.54,0.5152,0.77,0.2239,1,62,63,63,True
16207,2012-11-13,4,1,11,0,0,2,1,2,0.52,0.5,0.83,0.2836,5,18,23,23,True
16208,2012-11-13,4,1,11,1,0,2,1,3,0.44,0.4394,0.88,0.4775,0,5,5,5,True
16209,2012-11-13,4,1,11,2,0,2,1,3,0.36,0.3182,0.87,0.4478,7,4,11,11,True
16210,2012-11-13,4,1,11,3,0,2,1,3,0.36,0.3333,0.87,0.3582,2,3,5,5,True
16211,2012-11-13,4,1,11,4,0,2,1,2,0.36,0.3333,0.81,0.3881,0,9,9,9,True
16212,2012-11-13,4,1,11,5,0,2,1,2,0.34,0.3182,0.87,0.2836,0,18,18,18,True
16213,2012-11-13,4,1,11,6,0,2,1,3,0.32,0.2879,0.81,0.4627,2,48,50,50,True
16214,2012-11-13,4,1,11,7,0,2,1,3,0.32,0.303,0.87,0.2537,1,106,107,107,True
16215,2012-11-13,4,1,11,8,0,2,1,3,0.32,0.303,0.87,0.2537,4,207,211,211,True
16216,2012-11-13,4,1,11,9,0,2,1,3,0.32,0.303,0.81,0.3284,1,109,110,110,True
16217,2012-11-13,4,1,11,10,0,2,1,3,0.3,0.2727,0.75,0.3881,10,84,94,94,True
16218,2012-11-13,4,1,11,11,0,2,1,1,0.32,0.303,0.7,0.2537,22,133,155,155,True
16219,2012-11-13,4,1,11,12,0,2,1,1,0.34,0.3182,0.61,0.2836,16,180,196,196,True
16220,2012-11-13,4,1,11,13,0,2,1,1,0.34,0.3182,0.53,0.2537,30,188,218,218,True
16221,2012-11-13,4,1,11,14,0,2,1,1,0.38,0.3939,0.46,0.3881,34,169,203,203,True
16222,2012-11-13,4,1,11,15,0,2,1,1,0.4,0.4091,0.4,0.2985,33,184,217,217,True
16223,2012-11-13,4,1,11,16,0,2,1,1,0.38,0.3939,0.4,0.2985,28,282,310,310,True
16224,2012-11-13,4,1,11,17,0,2,1,1,0.34,0.303,0.49,0.3582,33,499,532,532,True
16225,2012-11-13,4,1,11,18,0,2,1,1,0.34,0.3182,0.49,0.2836,45,499,544,544,True
16226,2012-11-13,4,1,11,19,0,2,1,1,0.32,0.2879,0.49,0.3582,12,344,356,356,True
16227,2012-11-13,4,1,11,20,0,2,1,1,0.3,0.2727,0.49,0.3582,12,211,223,223,True
16228,2012-11-13,4,1,11,21,0,2,1,1,0.3,0.2727,0.49,0.3582,9,178,187,187,True
16229,2012-11-13,4,1,11,22,0,2,1,1,0.26,0.2273,0.56,0.3284,15,120,135,135,True
16230,2012-11-13,4,1,11,23,0,2,1,1,0.26,0.2273,0.56,0.2985,6,78,84,84,True
16231,2012-11-14,4,1,11,0,0,3,1,1,0.26,0.2424,0.56,0.2836,4,20,24,24,True
16232,2012-11-14,4,1,11,1,0,3,1,1,0.24,0.2121,0.6,0.2985,2,10,12,12,True
16233,2012-11-14,4,1,11,2,0,3,1,1,0.24,0.2121,0.6,0.2985,0,1,1,1,True
16234,2012-11-14,4,1,11,3,0,3,1,1,0.24,0.2273,0.65,0.2239,0,5,5,5,True
16235,2012-11-14,4,1,11,4,0,3,1,1,0.22,0.2273,0.69,0.194,0,6,6,6,True
16236,2012-11-14,4,1,11,5,0,3,1,1,0.22,0.2273,0.69,0.194,0,39,39,39,True
16237,2012-11-14,4,1,11,6,0,3,1,1,0.24,0.2273,0.65,0.194,4,142,146,146,True
16238,2012-11-14,4,1,11,7,0,3,1,1,0.24,0.2121,0.65,0.2836,10,405,415,415,True
16239,2012-11-14,4,1,11,8,0,3,1,1,0.28,0.2576,0.56,0.2985,27,499,526,526,True
16240,2012-11-14,4,1,11,9,0,3,1,1,0.3,0.2727,0.52,0.3881,22,310,332,332,True
16241,2012-11-14,4,1,11,10,0,3,1,1,0.32,0.2879,0.45,0.3582,18,153,171,171,True
16242,2012-11-14,4,1,11,11,0,3,1,1,0.32,0.303,0.49,0.2537,25,126,151,151,True
16243,2012-11-14,4,1,11,12,0,3,1,1,0.34,0.3333,0.46,0.0,40,200,240,240,True
16244,2012-11-14,4,1,11,13,0,3,1,1,0.36,0.3333,0.43,0.2537,32,182,214,214,True
16245,2012-11-14,4,1,11,14,0,3,1,1,0.36,0.3485,0.43,0.1343,20,161,181,181,True
16246,2012-11-14,4,1,11,15,0,3,1,1,0.36,0.3333,0.43,0.2836,32,228,260,260,True
16247,2012-11-14,4,1,11,16,0,3,1,1,0.34,0.3485,0.46,0.1045,31,290,321,321,True
16248,2012-11-14,4,1,11,17,0,3,1,1,0.32,0.3182,0.49,0.194,19,499,518,518,True
16249,2012-11-14,4,1,11,18,0,3,1,1,0.32,0.3182,0.53,0.1642,24,499,523,523,True
16250,2012-11-14,4,1,11,19,0,3,1,1,0.3,0.303,0.52,0.1642,28,368,396,396,True
16251,2012-11-14,4,1,11,20,0,3,1,1,0.3,0.3182,0.52,0.0896,15,252,267,267,True
16252,2012-11-14,4,1,11,21,0,3,1,1,0.3,0.3333,0.56,0.0,5,208,213,213,True
16253,2012-11-14,4,1,11,22,0,3,1,1,0.28,0.3182,0.61,0.0,6,167,173,173,True
16254,2012-11-14,4,1,11,23,0,3,1,1,0.24,0.2424,0.7,0.1343,9,78,87,87,True
16255,2012-11-15,4,1,11,0,0,4,1,2,0.26,0.303,0.65,0.0,1,33,34,34,True
16256,2012-11-15,4,1,11,1,0,4,1,2,0.26,0.2727,0.65,0.1045,2,14,16,16,True
16257,2012-11-15,4,1,11,2,0,4,1,2,0.26,0.2576,0.7,0.1642,0,7,7,7,True
16258,2012-11-15,4,1,11,3,0,4,1,2,0.26,0.2879,0.7,0.0896,0,2,2,2,True
16259,2012-11-15,4,1,11,4,0,4,1,2,0.28,0.2879,0.65,0.1343,0,5,5,5,True
16260,2012-11-15,4,1,11,5,0,4,1,2,0.3,0.2879,0.61,0.2239,3,34,37,37,True
16261,2012-11-15,4,1,11,6,0,4,1,2,0.3,0.2879,0.65,0.2537,1,146,147,147,True
16262,2012-11-15,4,1,11,7,0,4,1,2,0.3,0.2879,0.65,0.194,7,403,410,410,True
16263,2012-11-15,4,1,11,8,0,4,1,2,0.3,0.2879,0.61,0.2239,21,499,520,520,True
16264,2012-11-15,4,1,11,9,0,4,1,2,0.32,0.3182,0.61,0.194,17,306,323,323,True
16265,2012-11-15,4,1,11,10,0,4,1,2,0.32,0.3333,0.66,0.1343,11,142,153,153,True
16266,2012-11-15,4,1,11,11,0,4,1,2,0.34,0.3333,0.61,0.1343,28,138,166,166,True
16267,2012-11-15,4,1,11,12,0,4,1,2,0.36,0.3636,0.62,0.1045,29,184,213,213,True
16268,2012-11-15,4,1,11,13,0,4,1,2,0.38,0.3939,0.54,0.1045,20,197,217,217,True
16269,2012-11-15,4,1,11,14,0,4,1,2,0.38,0.3939,0.54,0.1642,27,174,201,201,True
16270,2012-11-15,4,1,11,15,0,4,1,2,0.38,0.3939,0.58,0.1642,26,191,217,217,True
16271,2012-11-15,4,1,11,16,0,4,1,2,0.36,0.3485,0.57,0.194,24,318,342,342,True
16272,2012-11-15,4,1,11,17,0,4,1,2,0.36,0.3485,0.57,0.2239,22,499,521,521,True
16273,2012-11-15,4,1,11,18,0,4,1,2,0.36,0.3485,0.57,0.194,10,499,509,509,True
16274,2012-11-15,4,1,11,19,0,4,1,2,0.34,0.3333,0.61,0.1343,11,375,386,386,True
16275,2012-11-15,4,1,11,20,0,4,1,1,0.34,0.3485,0.61,0.1045,23,262,285,285,True
16276,2012-11-15,4,1,11,21,0,4,1,2,0.32,0.3333,0.66,0.1045,20,204,224,224,True
16277,2012-11-15,4,1,11,22,0,4,1,2,0.32,0.3182,0.66,0.1642,10,143,153,153,True
16278,2012-11-15,4,1,11,23,0,4,1,2,0.32,0.3182,0.61,0.1642,7,118,125,125,True
16279,2012-11-16,4,1,11,0,0,5,1,2,0.32,0.3333,0.66,0.1045,7,58,65,65,True
16280,2012-11-16,4,1,11,1,0,5,1,2,0.3,0.3182,0.65,0.0896,5,16,21,21,True
16281,2012-11-16,4,1,11,2,0,5,1,2,0.3,0.303,0.7,0.1642,0,9,9,9,True
16282,2012-11-16,4,1,11,3,0,5,1,2,0.3,0.303,0.65,0.1343,0,6,6,6,True
16283,2012-11-16,4,1,11,4,0,5,1,2,0.3,0.3182,0.65,0.1045,0,5,5,5,True
16284,2012-11-16,4,1,11,5,0,5,1,2,0.3,0.3182,0.65,0.0896,2,34,36,36,True
16285,2012-11-16,4,1,11,6,0,5,1,2,0.3,0.3182,0.61,0.0896,4,126,130,130,True
16286,2012-11-16,4,1,11,7,0,5,1,2,0.3,0.303,0.61,0.1642,5,362,367,367,True
16287,2012-11-16,4,1,11,8,0,5,1,2,0.32,0.3333,0.57,0.1343,17,499,516,516,True
16288,2012-11-16,4,1,11,9,0,5,1,1,0.34,0.3485,0.53,0.1045,21,330,351,351,True
16289,2012-11-16,4,1,11,10,0,5,1,1,0.34,0.3333,0.53,0.194,33,165,198,198,True
16290,2012-11-16,4,1,11,11,0,5,1,1,0.38,0.3939,0.43,0.2239,33,185,218,218,True
16291,2012-11-16,4,1,11,12,0,5,1,1,0.4,0.4091,0.43,0.2836,28,262,290,290,True
16292,2012-11-16,4,1,11,13,0,5,1,1,0.42,0.4242,0.38,0.194,52,226,278,278,True
16293,2012-11-16,4,1,11,14,0,5,1,1,0.42,0.4242,0.35,0.1045,47,204,251,251,True
16294,2012-11-16,4,1,11,15,0,5,1,1,0.42,0.4242,0.38,0.1343,30,237,267,267,True
16295,2012-11-16,4,1,11,16,0,5,1,1,0.42,0.4242,0.35,0.2836,33,350,383,383,True
16296,2012-11-16,4,1,11,17,0,5,1,1,0.36,0.3485,0.46,0.194,41,499,540,540,True
16297,2012-11-16,4,1,11,18,0,5,1,1,0.34,0.3333,0.53,0.1642,22,483,505,505,True
16298,2012-11-16,4,1,11,19,0,5,1,1,0.36,0.3485,0.46,0.2239,26,306,332,332,True
16299,2012-11-16,4,1,11,20,0,5,1,1,0.36,0.3333,0.46,0.2537,20,207,227,227,True
16300,2012-11-16,4,1,11,21,0,5,1,1,0.34,0.3333,0.49,0.194,21,157,178,178,True
16301,2012-11-16,4,1,11,22,0,5,1,1,0.32,0.303,0.53,0.2537,23,139,162,162,True
16302,2012-11-16,4,1,11,23,0,5,1,1,0.32,0.303,0.53,0.2239,14,114,128,128,True
16303,2012-11-17,4,1,11,0,0,6,0,1,0.3,0.303,0.52,0.1642,11,95,106,106,True
16304,2012-11-17,4,1,11,1,0,6,0,1,0.26,0.2576,0.6,0.194,13,74,87,87,True
16305,2012-11-17,4,1,11,2,0,6,0,1,0.26,0.2576,0.65,0.194,8,41,49,49,True
16306,2012-11-17,4,1,11,3,0,6,0,1,0.26,0.2576,0.65,0.194,2,19,21,21,True
16307,2012-11-17,4,1,11,4,0,6,0,1,0.24,0.2273,0.7,0.194,1,6,7,7,True
16308,2012-11-17,4,1,11,5,0,6,0,1,0.24,0.2424,0.7,0.1642,1,10,11,11,True
16309,2012-11-17,4,1,11,6,0,6,0,1,0.24,0.2273,0.7,0.2239,0,21,21,21,True
16310,2012-11-17,4,1,11,7,0,6,0,1,0.24,0.2273,0.7,0.194,8,70,78,78,True
16311,2012-11-17,4,1,11,8,0,6,0,1,0.26,0.2576,0.65,0.2239,30,138,168,168,True
16312,2012-11-17,4,1,11,9,0,6,0,1,0.34,0.3182,0.49,0.2239,48,200,248,248,True
16313,2012-11-17,4,1,11,10,0,6,0,1,0.36,0.3333,0.46,0.2537,62,258,320,320,True
16314,2012-11-17,4,1,11,11,0,6,0,1,0.38,0.3939,0.43,0.194,80,343,423,423,True
16315,2012-11-17,4,1,11,12,0,6,0,1,0.4,0.4091,0.4,0.1642,114,359,473,473,True
16316,2012-11-17,4,1,11,13,0,6,0,1,0.42,0.4242,0.38,0.2537,114,346,460,460,True
16317,2012-11-17,4,1,11,14,0,6,0,1,0.42,0.4242,0.38,0.194,114,380,494,494,True
16318,2012-11-17,4,1,11,15,0,6,0,1,0.42,0.4242,0.35,0.2985,114,374,488,488,True
16319,2012-11-17,4,1,11,16,0,6,0,1,0.4,0.4091,0.4,0.2239,114,325,439,439,True
16320,2012-11-17,4,1,11,17,0,6,0,1,0.38,0.3939,0.4,0.1642,101,302,403,403,True
16321,2012-11-17,4,1,11,18,0,6,0,1,0.36,0.3636,0.5,0.1045,34,237,271,271,True
16322,2012-11-17,4,1,11,19,0,6,0,1,0.34,0.3485,0.53,0.0896,45,208,253,253,True
16323,2012-11-17,4,1,11,20,0,6,0,2,0.34,0.3485,0.66,0.0896,30,142,172,172,True
16324,2012-11-17,4,1,11,21,0,6,0,2,0.32,0.3333,0.57,0.1045,15,124,139,139,True
16325,2012-11-17,4,1,11,22,0,6,0,2,0.32,0.3333,0.57,0.1045,15,130,145,145,True
16326,2012-11-17,4,1,11,23,0,6,0,2,0.3,0.3182,0.7,0.1045,19,114,133,133,True
16327,2012-11-18,4,1,11,0,0,0,0,2,0.3,0.303,0.7,0.1642,11,118,129,129,True
16328,2012-11-18,4,1,11,1,0,0,0,1,0.3,0.2879,0.7,0.194,14,81,95,95,True
16329,2012-11-18,4,1,11,2,0,0,0,1,0.28,0.2879,0.81,0.1045,8,65,73,73,True
16330,2012-11-18,4,1,11,3,0,0,0,2,0.3,0.303,0.81,0.1642,9,37,46,46,True
16331,2012-11-18,4,1,11,4,0,0,0,2,0.3,0.2879,0.81,0.194,4,8,12,12,True
16332,2012-11-18,4,1,11,5,0,0,0,1,0.28,0.2879,0.81,0.1343,5,7,12,12,True
16333,2012-11-18,4,1,11,6,0,0,0,1,0.28,0.2727,0.81,0.1642,2,13,15,15,True
16334,2012-11-18,4,1,11,7,0,0,0,1,0.28,0.2727,0.81,0.194,3,39,42,42,True
16335,2012-11-18,4,1,11,8,0,0,0,1,0.3,0.2879,0.75,0.2537,19,100,119,119,True
16336,2012-11-18,4,1,11,9,0,0,0,1,0.32,0.303,0.7,0.2537,49,155,204,204,True
16337,2012-11-18,4,1,11,10,0,0,0,1,0.34,0.303,0.66,0.2985,79,250,329,329,True
16338,2012-11-18,4,1,11,11,0,0,0,1,0.38,0.3939,0.62,0.2836,92,267,359,359,True
16339,2012-11-18,4,1,11,12,0,0,0,1,0.4,0.4091,0.62,0.2836,101,341,442,442,True
16340,2012-11-18,4,1,11,13,0,0,0,1,0.4,0.4091,0.62,0.3284,113,334,447,447,True
16341,2012-11-18,4,1,11,14,0,0,0,1,0.4,0.4091,0.62,0.2985,114,303,417,417,True
16342,2012-11-18,4,1,11,15,0,0,0,1,0.42,0.4242,0.54,0.2836,89,318,407,407,True
16343,2012-11-18,4,1,11,16,0,0,0,2,0.4,0.4091,0.62,0.3284,59,313,372,372,True
16344,2012-11-18,4,1,11,17,0,0,0,2,0.38,0.3939,0.66,0.2537,48,232,280,280,True
16345,2012-11-18,4,1,11,18,0,0,0,1,0.36,0.3485,0.66,0.2239,36,240,276,276,True
16346,2012-11-18,4,1,11,19,0,0,0,1,0.36,0.3485,0.66,0.1642,16,194,210,210,True
16347,2012-11-18,4,1,11,20,0,0,0,1,0.36,0.3485,0.66,0.1642,9,120,129,129,True
16348,2012-11-18,4,1,11,21,0,0,0,1,0.36,0.3333,0.66,0.2537,17,93,110,110,True
16349,2012-11-18,4,1,11,22,0,0,0,2,0.36,0.3333,0.66,0.2537,8,66,74,74,True
16350,2012-11-18,4,1,11,23,0,0,0,1,0.36,0.3485,0.66,0.2239,6,53,59,59,True
16351,2012-11-19,4,1,11,0,0,1,1,1,0.36,0.3485,0.66,0.2239,5,22,27,27,True
16352,2012-11-19,4,1,11,1,0,1,1,2,0.36,0.3485,0.66,0.2239,0,19,19,19,True
16353,2012-11-19,4,1,11,2,0,1,1,2,0.36,0.3333,0.66,0.2537,0,5,5,5,True
16354,2012-11-19,4,1,11,3,0,1,1,2,0.36,0.3485,0.66,0.2239,0,2,2,2,True
16355,2012-11-19,4,1,11,4,0,1,1,2,0.36,0.3485,0.66,0.2239,1,11,12,12,True
16356,2012-11-19,4,1,11,5,0,1,1,2,0.36,0.3485,0.66,0.2239,1,38,39,39,True
16357,2012-11-19,4,1,11,6,0,1,1,2,0.36,0.3333,0.66,0.2537,3,128,131,131,True
16358,2012-11-19,4,1,11,7,0,1,1,2,0.36,0.3333,0.66,0.2985,5,381,386,386,True
16359,2012-11-19,4,1,11,8,0,1,1,2,0.36,0.3333,0.66,0.2985,13,499,512,512,True
16360,2012-11-19,4,1,11,9,0,1,1,2,0.36,0.3333,0.66,0.2537,18,260,278,278,True
16361,2012-11-19,4,1,11,10,0,1,1,2,0.36,0.3333,0.66,0.2537,33,106,139,139,True
16362,2012-11-19,4,1,11,11,0,1,1,2,0.38,0.3939,0.66,0.2537,33,164,197,197,True
16363,2012-11-19,4,1,11,12,0,1,1,2,0.4,0.4091,0.62,0.2836,35,207,242,242,True
16364,2012-11-19,4,1,11,13,0,1,1,1,0.44,0.4394,0.54,0.2537,46,205,251,251,True
16365,2012-11-19,4,1,11,14,0,1,1,1,0.44,0.4394,0.54,0.2537,47,170,217,217,True
16366,2012-11-19,4,1,11,15,0,1,1,1,0.44,0.4394,0.54,0.194,44,213,257,257,True
16367,2012-11-19,4,1,11,16,0,1,1,1,0.42,0.4242,0.58,0.2537,55,325,380,380,True
16368,2012-11-19,4,1,11,17,0,1,1,2,0.42,0.4242,0.58,0.194,33,499,532,532,True
16369,2012-11-19,4,1,11,18,0,1,1,2,0.4,0.4091,0.58,0.2537,21,499,520,520,True
16370,2012-11-19,4,1,11,19,0,1,1,2,0.4,0.4091,0.58,0.2836,25,381,406,406,True
16371,2012-11-19,4,1,11,20,0,1,1,2,0.38,0.3939,0.62,0.2537,7,252,259,259,True
16372,2012-11-19,4,1,11,21,0,1,1,2,0.38,0.3939,0.54,0.2239,15,188,203,203,True
16373,2012-11-19,4,1,11,22,0,1,1,1,0.34,0.3485,0.66,0.1045,7,106,113,113,True
16374,2012-11-19,4,1,11,23,0,1,1,1,0.34,0.3485,0.66,0.1045,2,72,74,74,True
16375,2012-11-20,4,1,11,0,0,2,1,1,0.32,0.3333,0.7,0.1343,3,26,29,29,True
16376,2012-11-20,4,1,11,1,0,2,1,1,0.34,0.3485,0.66,0.1045,3,10,13,13,True
16377,2012-11-20,4,1,11,2,0,2,1,2,0.32,0.3333,0.76,0.0896,0,5,5,5,True
16378,2012-11-20,4,1,11,3,0,2,1,2,0.34,0.3485,0.71,0.1045,0,2,2,2,True
16379,2012-11-20,4,1,11,4,0,2,1,2,0.34,0.3333,0.66,0.194,0,6,6,6,True
16380,2012-11-20,4,1,11,5,0,2,1,2,0.34,0.3333,0.66,0.1343,2,32,34,34,True
16381,2012-11-20,4,1,11,6,0,2,1,2,0.34,0.3333,0.71,0.1642,2,146,148,148,True
16382,2012-11-20,4,1,11,7,0,2,1,1,0.32,0.3333,0.76,0.0896,7,411,418,418,True
16383,2012-11-20,4,1,11,8,0,2,1,1,0.34,0.3333,0.71,0.1343,16,499,515,515,True
16384,2012-11-20,4,1,11,9,0,2,1,2,0.36,0.3788,0.71,0.0,28,298,326,326,True
16385,2012-11-20,4,1,11,10,0,2,1,2,0.4,0.4091,0.66,0.0896,32,144,176,176,True
16386,2012-11-20,4,1,11,11,0,2,1,2,0.42,0.4242,0.67,0.0896,45,160,205,205,True
16387,2012-11-20,4,1,11,12,0,2,1,2,0.42,0.4242,0.67,0.0,70,243,313,313,True
16388,2012-11-20,4,1,11,13,0,2,1,2,0.44,0.4394,0.58,0.0,49,218,267,267,True
16389,2012-11-20,4,1,11,14,0,2,1,2,0.44,0.4394,0.58,0.1045,47,177,224,224,True
16390,2012-11-20,4,1,11,15,0,2,1,2,0.46,0.4545,0.55,0.1045,61,226,287,287,True
16391,2012-11-20,4,1,11,16,0,2,1,2,0.42,0.4242,0.62,0.0896,60,335,395,395,True
16392,2012-11-20,4,1,11,17,0,2,1,2,0.4,0.4091,0.71,0.1642,37,499,536,536,True
16393,2012-11-20,4,1,11,18,0,2,1,2,0.4,0.4091,0.66,0.0896,16,499,515,515,True
16394,2012-11-20,4,1,11,19,0,2,1,2,0.4,0.4091,0.71,0.0,23,361,384,384,True
16395,2012-11-20,4,1,11,20,0,2,1,2,0.38,0.3939,0.76,0.0,11,224,235,235,True
16396,2012-11-20,4,1,11,21,0,2,1,1,0.36,0.3788,0.71,0.0,14,143,157,157,True
16397,2012-11-20,4,1,11,22,0,2,1,1,0.36,0.3788,0.71,0.0,7,115,122,122,True
16398,2012-11-20,4,1,11,23,0,2,1,1,0.32,0.3333,0.81,0.1045,1,82,83,83,True
16399,2012-11-21,4,1,11,0,0,3,1,1,0.34,0.3636,0.81,0.0,1,25,26,26,True
16400,2012-11-21,4,1,11,1,0,3,1,1,0.32,0.3333,0.81,0.1045,1,13,14,14,True
16401,2012-11-21,4,1,11,2,0,3,1,1,0.28,0.2879,0.87,0.1045,2,6,8,8,True
16402,2012-11-21,4,1,11,3,0,3,1,1,0.28,0.2879,0.87,0.1045,0,2,2,2,True
16403,2012-11-21,4,1,11,4,0,3,1,1,0.28,0.2879,0.87,0.1045,0,10,10,10,True
16404,2012-11-21,4,1,11,5,0,3,1,1,0.28,0.2879,0.87,0.1045,1,28,29,29,True
16405,2012-11-21,4,1,11,6,0,3,1,1,0.28,0.303,0.87,0.0896,2,99,101,101,True
16406,2012-11-21,4,1,11,7,0,3,1,1,0.26,0.2879,0.87,0.0896,11,262,273,273,True
16407,2012-11-21,4,1,11,8,0,3,1,2,0.28,0.303,0.81,0.0896,12,499,511,511,True
16408,2012-11-21,4,1,11,9,0,3,1,1,0.32,0.3333,0.76,0.0896,45,320,365,365,True
16409,2012-11-21,4,1,11,10,0,3,1,1,0.36,0.3788,0.62,0.0,22,150,172,172,True
16410,2012-11-21,4,1,11,11,0,3,1,1,0.4,0.4091,0.5,0.194,43,198,241,241,True
16411,2012-11-21,4,1,11,12,0,3,1,1,0.44,0.4394,0.41,0.194,74,270,344,344,True
16412,2012-11-21,4,1,11,13,0,3,1,1,0.44,0.4394,0.35,0.2239,70,295,365,365,True
16413,2012-11-21,4,1,11,14,0,3,1,1,0.46,0.4545,0.33,0.194,84,329,413,413,True
16414,2012-11-21,4,1,11,15,0,3,1,1,0.46,0.4545,0.36,0.0896,68,381,449,449,True
16415,2012-11-21,4,1,11,16,0,3,1,1,0.44,0.4394,0.33,0.1343,59,410,469,469,True
16416,2012-11-21,4,1,11,17,0,3,1,1,0.4,0.4091,0.4,0.1642,41,333,374,374,True
16417,2012-11-21,4,1,11,18,0,3,1,1,0.42,0.4242,0.38,0.1045,24,287,311,311,True
16418,2012-11-21,4,1,11,19,0,3,1,1,0.38,0.3939,0.43,0.194,23,220,243,243,True
16419,2012-11-21,4,1,11,20,0,3,1,1,0.34,0.3485,0.61,0.1045,11,125,136,136,True
16420,2012-11-21,4,1,11,21,0,3,1,1,0.36,0.3788,0.5,0.0,8,97,105,105,True
16421,2012-11-21,4,1,11,22,0,3,1,1,0.34,0.3636,0.49,0.0,6,82,88,88,True
16422,2012-11-21,4,1,11,23,0,3,1,1,0.32,0.3485,0.61,0.0,7,50,57,57,True
16423,2012-11-22,4,1,11,0,1,4,0,1,0.32,0.3333,0.66,0.0896,3,43,46,46,True
16424,2012-11-22,4,1,11,1,1,4,0,1,0.28,0.303,0.65,0.0896,5,37,42,42,True
16425,2012-11-22,4,1,11,2,1,4,0,1,0.24,0.2576,0.75,0.0896,3,15,18,18,True
16426,2012-11-22,4,1,11,3,1,4,0,1,0.24,0.2576,0.75,0.1045,0,6,6,6,True
16427,2012-11-22,4,1,11,4,1,4,0,1,0.22,0.2273,0.8,0.1343,1,2,3,3,True
16428,2012-11-22,4,1,11,5,1,4,0,1,0.24,0.2576,0.75,0.1045,2,6,8,8,True
16429,2012-11-22,4,1,11,6,1,4,0,1,0.26,0.2727,0.7,0.1045,2,15,17,17,True
16430,2012-11-22,4,1,11,7,1,4,0,1,0.22,0.2273,0.75,0.1343,7,49,56,56,True
16431,2012-11-22,4,1,11,8,1,4,0,1,0.24,0.2424,0.75,0.1343,20,77,97,97,True
16432,2012-11-22,4,1,11,9,1,4,0,1,0.3,0.3333,0.65,0.0,25,94,119,119,True
16433,2012-11-22,4,1,11,10,1,4,0,1,0.36,0.3636,0.57,0.1045,65,154,219,219,True
16434,2012-11-22,4,1,11,11,1,4,0,1,0.42,0.4242,0.41,0.0896,89,143,232,232,True
16435,2012-11-22,4,1,11,12,1,4,0,1,0.44,0.4394,0.35,0.0,114,145,259,259,True
16436,2012-11-22,4,1,11,13,1,4,0,1,0.46,0.4545,0.31,0.0,114,144,258,258,True
16437,2012-11-22,4,1,11,14,1,4,0,1,0.48,0.4697,0.29,0.0,114,95,209,209,True
16438,2012-11-22,4,1,11,15,1,4,0,1,0.48,0.4697,0.29,0.0,114,96,210,210,True
16439,2012-11-22,4,1,11,16,1,4,0,1,0.46,0.4545,0.33,0.0,101,81,182,182,True
16440,2012-11-22,4,1,11,17,1,4,0,1,0.44,0.4394,0.35,0.0,66,43,109,109,True
16441,2012-11-22,4,1,11,18,1,4,0,1,0.4,0.4091,0.43,0.0,16,54,70,70,True
16442,2012-11-22,4,1,11,19,1,4,0,1,0.36,0.3788,0.76,0.0,13,31,44,44,True
16443,2012-11-22,4,1,11,20,1,4,0,1,0.34,0.3636,0.71,0.0,15,37,52,52,True
16444,2012-11-22,4,1,11,21,1,4,0,1,0.34,0.3485,0.61,0.0896,7,39,46,46,True
16445,2012-11-22,4,1,11,22,1,4,0,1,0.32,0.3485,0.61,0.0,8,36,44,44,True
16446,2012-11-22,4,1,11,23,1,4,0,1,0.3,0.3333,0.7,0.0,8,28,36,36,True
16447,2012-11-23,4,1,11,0,0,5,1,1,0.28,0.3182,0.65,0.0,0,32,32,32,True
16448,2012-11-23,4,1,11,1,0,5,1,1,0.28,0.303,0.81,0.0896,2,11,13,13,True
16449,2012-11-23,4,1,11,2,0,5,1,1,0.26,0.2879,0.75,0.0896,1,4,5,5,True
16450,2012-11-23,4,1,11,3,0,5,1,1,0.26,0.303,0.7,0.0,1,0,1,1,True
16451,2012-11-23,4,1,11,4,0,5,1,1,0.24,0.2576,0.75,0.1045,1,3,4,4,True
16452,2012-11-23,4,1,11,5,0,5,1,1,0.24,0.2879,0.81,0.0,0,10,10,10,True
16453,2012-11-23,4,1,11,6,0,5,1,1,0.24,0.2879,0.81,0.0,0,20,20,20,True
16454,2012-11-23,4,1,11,7,0,5,1,1,0.24,0.2879,0.81,0.0,5,72,77,77,True
16455,2012-11-23,4,1,11,8,0,5,1,1,0.24,0.2576,0.87,0.0896,11,83,94,94,True
16456,2012-11-23,4,1,11,9,0,5,1,1,0.28,0.2879,0.75,0.1045,32,80,112,112,True
16457,2012-11-23,4,1,11,10,0,5,1,1,0.34,0.3333,0.61,0.1642,87,114,201,201,True
16458,2012-11-23,4,1,11,11,0,5,1,1,0.4,0.4091,0.5,0.194,114,130,244,244,True
16459,2012-11-23,4,1,11,12,0,5,1,1,0.44,0.4394,0.38,0.2537,114,193,307,307,True
16460,2012-11-23,4,1,11,13,0,5,1,1,0.46,0.4545,0.38,0.2836,114,200,314,314,True
16461,2012-11-23,4,1,11,14,0,5,1,1,0.5,0.4848,0.36,0.2537,114,195,309,309,True
16462,2012-11-23,4,1,11,15,0,5,1,1,0.48,0.4697,0.41,0.2537,114,214,328,328,True
16463,2012-11-23,4,1,11,16,0,5,1,2,0.48,0.4697,0.41,0.1045,114,199,313,313,True
16464,2012-11-23,4,1,11,17,0,5,1,2,0.48,0.4697,0.39,0.0896,114,183,297,297,True
16465,2012-11-23,4,1,11,18,0,5,1,2,0.46,0.4545,0.44,0.0,50,158,208,208,True
16466,2012-11-23,4,1,11,19,0,5,1,2,0.46,0.4545,0.47,0.1642,33,121,154,154,True
16467,2012-11-23,4,1,11,20,0,5,1,1,0.46,0.4545,0.41,0.0896,42,100,142,142,True
16468,2012-11-23,4,1,11,21,0,5,1,1,0.46,0.4545,0.47,0.2537,23,75,98,98,True
16469,2012-11-23,4,1,11,22,0,5,1,1,0.44,0.4394,0.33,0.4775,16,63,79,79,True
16470,2012-11-23,4,1,11,23,0,5,1,1,0.42,0.4242,0.38,0.4478,20,47,67,67,True
16471,2012-11-24,4,1,11,0,0,6,0,1,0.4,0.4091,0.37,0.4179,9,33,42,42,True
16472,2012-11-24,4,1,11,1,0,6,0,1,0.34,0.2879,0.42,0.4775,1,19,20,20,True
16473,2012-11-24,4,1,11,2,0,6,0,1,0.32,0.2727,0.39,0.4775,10,22,32,32,True
16474,2012-11-24,4,1,11,3,0,6,0,1,0.28,0.2576,0.41,0.3582,6,5,11,11,True
16475,2012-11-24,4,1,11,4,0,6,0,1,0.26,0.2121,0.41,0.4478,1,2,3,3,True
16476,2012-11-24,4,1,11,5,0,6,0,1,0.26,0.2273,0.41,0.3284,1,2,3,3,True
16477,2012-11-24,4,1,11,6,0,6,0,1,0.24,0.2121,0.44,0.2836,1,9,10,10,True
16478,2012-11-24,4,1,11,7,0,6,0,2,0.26,0.2273,0.41,0.3284,4,21,25,25,True
16479,2012-11-24,4,1,11,8,0,6,0,2,0.26,0.2121,0.44,0.4627,7,55,62,62,True
16480,2012-11-24,4,1,11,9,0,6,0,2,0.26,0.2121,0.41,0.4478,26,96,122,122,True
16481,2012-11-24,4,1,11,10,0,6,0,2,0.26,0.2273,0.44,0.2985,46,96,142,142,True
16482,2012-11-24,4,1,11,11,0,6,0,2,0.28,0.2576,0.41,0.2985,55,131,186,186,True
16483,2012-11-24,4,1,11,12,0,6,0,2,0.3,0.2576,0.36,0.4775,53,146,199,199,True
16484,2012-11-24,4,1,11,13,0,6,0,1,0.32,0.303,0.36,0.3284,64,161,225,225,True
16485,2012-11-24,4,1,11,14,0,6,0,1,0.32,0.2879,0.33,0.4627,58,149,207,207,True
16486,2012-11-24,4,1,11,15,0,6,0,1,0.3,0.2727,0.36,0.4627,59,139,198,198,True
16487,2012-11-24,4,1,11,16,0,6,0,1,0.28,0.2424,0.38,0.4478,43,127,170,170,True
16488,2012-11-24,4,1,11,17,0,6,0,1,0.26,0.2273,0.41,0.3881,29,97,126,126,True
16489,2012-11-24,4,1,11,18,0,6,0,1,0.26,0.2273,0.38,0.3881,22,123,145,145,True
16490,2012-11-24,4,1,11,19,0,6,0,1,0.26,0.2424,0.41,0.2537,9,74,83,83,True
16491,2012-11-24,4,1,11,20,0,6,0,1,0.24,0.2121,0.44,0.2836,3,55,58,58,True
16492,2012-11-24,4,1,11,21,0,6,0,1,0.24,0.2273,0.44,0.194,9,66,75,75,True
16493,2012-11-24,4,1,11,22,0,6,0,1,0.24,0.2273,0.44,0.2537,7,69,76,76,True
16494,2012-11-24,4,1,11,23,0,6,0,1,0.24,0.2273,0.44,0.194,9,48,57,57,True
16495,2012-11-25,4,1,11,0,0,0,0,1,0.22,0.2121,0.47,0.2537,3,31,34,34,True
16496,2012-11-25,4,1,11,1,0,0,0,1,0.22,0.2273,0.44,0.194,4,32,36,36,True
16497,2012-11-25,4,1,11,2,0,0,0,1,0.22,0.197,0.44,0.3582,1,27,28,28,True
16498,2012-11-25,4,1,11,3,0,0,0,1,0.22,0.2727,0.44,0.0,0,8,8,8,True
16499,2012-11-25,4,1,11,4,0,0,0,1,0.22,0.2727,0.44,0.0,1,1,2,2,True
16500,2012-11-25,4,1,11,5,0,0,0,2,0.22,0.2273,0.47,0.1642,0,3,3,3,True
16501,2012-11-25,4,1,11,6,0,0,0,2,0.22,0.2424,0.47,0.1045,1,10,11,11,True
16502,2012-11-25,4,1,11,7,0,0,0,2,0.22,0.2424,0.51,0.1045,2,19,21,21,True
16503,2012-11-25,4,1,11,8,0,0,0,2,0.22,0.2273,0.51,0.194,2,32,34,34,True
16504,2012-11-25,4,1,11,9,0,0,0,2,0.24,0.2273,0.48,0.2239,13,83,96,96,True
16505,2012-11-25,4,1,11,10,0,0,0,1,0.24,0.2273,0.48,0.2537,15,124,139,139,True
16506,2012-11-25,4,1,11,11,0,0,0,2,0.26,0.2576,0.41,0.2239,49,155,204,204,True
16507,2012-11-25,4,1,11,12,0,0,0,2,0.26,0.2576,0.41,0.2239,37,165,202,202,True
16508,2012-11-25,4,1,11,13,0,0,0,2,0.26,0.2576,0.41,0.1642,37,158,195,195,True
16509,2012-11-25,4,1,11,14,0,0,0,2,0.3,0.2879,0.42,0.2537,33,170,203,203,True
16510,2012-11-25,4,1,11,15,0,0,0,1,0.3,0.2879,0.42,0.2537,36,209,245,245,True
16511,2012-11-25,4,1,11,16,0,0,0,1,0.3,0.2879,0.39,0.2239,25,203,228,228,True
16512,2012-11-25,4,1,11,17,0,0,0,1,0.28,0.2727,0.41,0.1642,11,170,181,181,True
16513,2012-11-25,4,1,11,18,0,0,0,1,0.26,0.2576,0.44,0.1642,9,132,141,141,True
16514,2012-11-25,4,1,11,19,0,0,0,1,0.26,0.303,0.41,0.0,13,114,127,127,True
16515,2012-11-25,4,1,11,20,0,0,0,1,0.24,0.2879,0.6,0.0,9,110,119,119,True
16516,2012-11-25,4,1,11,21,0,0,0,1,0.26,0.303,0.48,0.0,4,60,64,64,True
16517,2012-11-25,4,1,11,22,0,0,0,1,0.24,0.2879,0.6,0.0,3,59,62,62,True
16518,2012-11-25,4,1,11,23,0,0,0,1,0.22,0.2576,0.69,0.0896,1,40,41,41,True
16519,2012-11-26,4,1,11,0,0,1,1,1,0.22,0.2727,0.69,0.0,4,19,23,23,True
16520,2012-11-26,4,1,11,1,0,1,1,1,0.2,0.2576,0.69,0.0,1,9,10,10,True
16521,2012-11-26,4,1,11,2,0,1,1,1,0.2,0.2576,0.69,0.0,0,5,5,5,True
16522,2012-11-26,4,1,11,3,0,1,1,1,0.2,0.2576,0.69,0.0,1,4,5,5,True
16523,2012-11-26,4,1,11,4,0,1,1,1,0.22,0.2727,0.69,0.0,0,10,10,10,True
16524,2012-11-26,4,1,11,5,0,1,1,1,0.22,0.2273,0.69,0.1642,0,41,41,41,True
16525,2012-11-26,4,1,11,6,0,1,1,1,0.22,0.2727,0.69,0.0,1,123,124,124,True
16526,2012-11-26,4,1,11,7,0,1,1,1,0.24,0.2879,0.65,0.0,2,363,365,365,True
16527,2012-11-26,4,1,11,8,0,1,1,1,0.24,0.2879,0.65,0.0,9,499,508,508,True
16528,2012-11-26,4,1,11,9,0,1,1,1,0.28,0.303,0.56,0.0896,10,276,286,286,True
16529,2012-11-26,4,1,11,10,0,1,1,1,0.32,0.3485,0.49,0.0,20,127,147,147,True
16530,2012-11-26,4,1,11,11,0,1,1,1,0.4,0.4091,0.37,0.2985,18,112,130,130,True
16531,2012-11-26,4,1,11,12,0,1,1,1,0.42,0.4242,0.35,0.1045,22,188,210,210,True
16532,2012-11-26,4,1,11,13,0,1,1,1,0.42,0.4242,0.35,0.1045,20,197,217,217,True
16533,2012-11-26,4,1,11,14,0,1,1,1,0.42,0.4242,0.35,0.0,51,177,228,228,True
16534,2012-11-26,4,1,11,15,0,1,1,1,0.42,0.4242,0.35,0.0896,49,181,230,230,True
16535,2012-11-26,4,1,11,16,0,1,1,1,0.44,0.4394,0.3,0.0,49,297,346,346,True
16536,2012-11-26,4,1,11,17,0,1,1,1,0.42,0.4242,0.32,0.0,13,499,512,512,True
16537,2012-11-26,4,1,11,18,0,1,1,1,0.36,0.3485,0.5,0.1642,19,499,518,518,True
16538,2012-11-26,4,1,11,19,0,1,1,1,0.34,0.3636,0.53,0.0,16,355,371,371,True
16539,2012-11-26,4,1,11,20,0,1,1,1,0.34,0.3636,0.49,0.0,12,265,277,277,True
16540,2012-11-26,4,1,11,21,0,1,1,1,0.34,0.3636,0.49,0.0,9,172,181,181,True
16541,2012-11-26,4,1,11,22,0,1,1,1,0.32,0.3485,0.61,0.0,3,101,104,104,True
16542,2012-11-26,4,1,11,23,0,1,1,2,0.32,0.3333,0.66,0.1045,8,57,65,65,True
16543,2012-11-27,4,1,11,0,0,2,1,2,0.32,0.3333,0.66,0.0896,2,24,26,26,True
16544,2012-11-27,4,1,11,1,0,2,1,2,0.32,0.3333,0.7,0.1343,0,6,6,6,True
16545,2012-11-27,4,1,11,2,0,2,1,2,0.32,0.3182,0.7,0.1642,0,5,5,5,True
16546,2012-11-27,4,1,11,3,0,2,1,3,0.32,0.3333,0.7,0.1343,1,3,4,4,True
16547,2012-11-27,4,1,11,4,0,2,1,3,0.3,0.2879,0.81,0.194,0,5,5,5,True
16548,2012-11-27,4,1,11,5,0,2,1,2,0.3,0.2879,0.81,0.2239,0,31,31,31,True
16549,2012-11-27,4,1,11,6,0,2,1,2,0.3,0.303,0.81,0.1642,3,97,100,100,True
16550,2012-11-27,4,1,11,7,0,2,1,3,0.3,0.303,0.81,0.1343,4,289,293,293,True
16551,2012-11-27,4,1,11,8,0,2,1,3,0.32,0.3182,0.81,0.1642,6,494,500,500,True
16552,2012-11-27,4,1,11,9,0,2,1,2,0.32,0.3333,0.81,0.1343,11,257,268,268,True
16553,2012-11-27,4,1,11,10,0,2,1,3,0.32,0.3182,0.81,0.194,5,52,57,57,True
16554,2012-11-27,4,1,11,11,0,2,1,3,0.3,0.2727,0.87,0.2985,6,59,65,65,True
16555,2012-11-27,4,1,11,12,0,2,1,3,0.28,0.2576,0.87,0.3881,6,70,76,76,True
16556,2012-11-27,4,1,11,13,0,2,1,3,0.28,0.2727,0.87,0.2537,4,73,77,77,True
16557,2012-11-27,4,1,11,14,0,2,1,3,0.28,0.2576,0.87,0.3582,8,86,94,94,True
16558,2012-11-27,4,1,11,15,0,2,1,2,0.3,0.2727,0.75,0.2985,9,146,155,155,True
16559,2012-11-27,4,1,11,16,0,2,1,2,0.3,0.2727,0.75,0.2985,5,252,257,257,True
16560,2012-11-27,4,1,11,17,0,2,1,2,0.3,0.2727,0.75,0.3881,13,499,512,512,True
16561,2012-11-27,4,1,11,18,0,2,1,1,0.26,0.2273,0.81,0.3582,13,469,482,482,True
16562,2012-11-27,4,1,11,19,0,2,1,1,0.26,0.2576,0.73,0.2985,12,338,350,350,True
16563,2012-11-27,4,1,11,20,0,2,1,1,0.26,0.2273,0.75,0.3284,4,228,232,232,True
16564,2012-11-27,4,1,11,21,0,2,1,1,0.24,0.2121,0.81,0.2836,6,179,185,185,True
16565,2012-11-27,4,1,11,22,0,2,1,1,0.24,0.2424,0.81,0.1642,2,95,97,97,True
16566,2012-11-27,4,1,11,23,0,2,1,2,0.26,0.2424,0.81,0.2537,3,64,67,67,True
16567,2012-11-28,4,1,11,0,0,3,1,2,0.26,0.2424,0.75,0.2537,1,22,23,23,True
16568,2012-11-28,4,1,11,1,0,3,1,2,0.26,0.2576,0.75,0.2239,0,12,12,12,True
16569,2012-11-28,4,1,11,2,0,3,1,2,0.26,0.2576,0.75,0.2239,0,1,1,1,True
16570,2012-11-28,4,1,11,3,0,3,1,2,0.26,0.2576,0.7,0.2239,0,3,3,3,True
16571,2012-11-28,4,1,11,4,0,3,1,2,0.26,0.2576,0.7,0.194,0,4,4,4,True
16572,2012-11-28,4,1,11,5,0,3,1,2,0.26,0.2727,0.7,0.1343,0,39,39,39,True
16573,2012-11-28,4,1,11,6,0,3,1,2,0.26,0.2576,0.65,0.2239,4,132,136,136,True
16574,2012-11-28,4,1,11,7,0,3,1,2,0.26,0.2576,0.56,0.194,6,403,409,409,True
16575,2012-11-28,4,1,11,8,0,3,1,1,0.24,0.2121,0.6,0.2836,9,499,508,508,True
16576,2012-11-28,4,1,11,9,0,3,1,1,0.28,0.2727,0.52,0.194,13,309,322,322,True
16577,2012-11-28,4,1,11,10,0,3,1,1,0.3,0.3182,0.49,0.1045,17,144,161,161,True
16578,2012-11-28,4,1,11,11,0,3,1,1,0.32,0.3182,0.45,0.1642,19,127,146,146,True
16579,2012-11-28,4,1,11,12,0,3,1,1,0.34,0.303,0.42,0.3881,19,189,208,208,True
16580,2012-11-28,4,1,11,13,0,3,1,1,0.34,0.3333,0.42,0.194,21,193,214,214,True
16581,2012-11-28,4,1,11,14,0,3,1,1,0.36,0.3333,0.4,0.2985,15,161,176,176,True
16582,2012-11-28,4,1,11,15,0,3,1,1,0.36,0.3333,0.32,0.3284,7,172,179,179,True
16583,2012-11-28,4,1,11,16,0,3,1,1,0.36,0.3333,0.29,0.2537,9,316,325,325,True
16584,2012-11-28,4,1,11,17,0,3,1,1,0.34,0.3333,0.31,0.1343,17,499,516,516,True
16585,2012-11-28,4,1,11,18,0,3,1,1,0.32,0.303,0.33,0.2836,12,499,511,511,True
16586,2012-11-28,4,1,11,19,0,3,1,1,0.32,0.3182,0.36,0.1642,9,378,387,387,True
16587,2012-11-28,4,1,11,20,0,3,1,1,0.32,0.3333,0.36,0.1343,5,258,263,263,True
16588,2012-11-28,4,1,11,21,0,3,1,1,0.3,0.303,0.39,0.1642,4,219,223,223,True
16589,2012-11-28,4,1,11,22,0,3,1,1,0.28,0.2727,0.45,0.1642,6,148,154,154,True
16590,2012-11-28,4,1,11,23,0,3,1,1,0.26,0.2727,0.48,0.1343,5,73,78,78,True
16591,2012-11-29,4,1,11,0,0,4,1,1,0.24,0.2576,0.56,0.0896,4,25,29,29,True
16592,2012-11-29,4,1,11,1,0,4,1,1,0.22,0.2576,0.64,0.0896,1,15,16,16,True
16593,2012-11-29,4,1,11,2,0,4,1,1,0.22,0.2727,0.64,0.0,1,6,7,7,True
16594,2012-11-29,4,1,11,4,0,4,1,1,0.2,0.2273,0.75,0.0896,0,7,7,7,True
16595,2012-11-29,4,1,11,5,0,4,1,1,0.2,0.2576,0.69,0.0,0,42,42,42,True
16596,2012-11-29,4,1,11,6,0,4,1,1,0.22,0.2727,0.69,0.0,1,120,121,121,True
16597,2012-11-29,4,1,11,7,0,4,1,1,0.2,0.2576,0.64,0.0,8,354,362,362,True
16598,2012-11-29,4,1,11,8,0,4,1,1,0.2,0.2273,0.69,0.1045,15,499,514,514,True
16599,2012-11-29,4,1,11,9,0,4,1,1,0.24,0.2879,0.6,0.0,13,286,299,299,True
16600,2012-11-29,4,1,11,10,0,4,1,1,0.28,0.303,0.65,0.0896,25,153,178,178,True
16601,2012-11-29,4,1,11,11,0,4,1,1,0.36,0.3485,0.37,0.2239,13,150,163,163,True
16602,2012-11-29,4,1,11,12,0,4,1,1,0.36,0.3485,0.4,0.1642,11,225,236,236,True
16603,2012-11-29,4,1,11,13,0,4,1,1,0.38,0.3939,0.32,0.1343,15,209,224,224,True
16604,2012-11-29,4,1,11,14,0,4,1,1,0.36,0.3485,0.43,0.2239,13,174,187,187,True
16605,2012-11-29,4,1,11,15,0,4,1,1,0.36,0.3333,0.43,0.2836,19,201,220,220,True
16606,2012-11-29,4,1,11,16,0,4,1,1,0.36,0.3485,0.4,0.2239,24,346,370,370,True
16607,2012-11-29,4,1,11,17,0,4,1,1,0.34,0.3333,0.39,0.194,17,499,516,516,True
16608,2012-11-29,4,1,11,18,0,4,1,1,0.32,0.3182,0.49,0.1642,17,499,516,516,True
16609,2012-11-29,4,1,11,19,0,4,1,1,0.3,0.2879,0.52,0.194,18,326,344,344,True
16610,2012-11-29,4,1,11,20,0,4,1,1,0.3,0.303,0.52,0.1642,11,241,252,252,True
16611,2012-11-29,4,1,11,21,0,4,1,1,0.26,0.2727,0.65,0.1343,7,201,208,208,True
16612,2012-11-29,4,1,11,22,0,4,1,1,0.26,0.2879,0.7,0.0896,4,147,151,151,True
16613,2012-11-29,4,1,11,23,0,4,1,1,0.28,0.3182,0.61,0.0,6,124,130,130,True
16614,2012-11-30,4,1,11,0,0,5,1,1,0.26,0.2576,0.7,0.1642,4,48,52,52,True
16615,2012-11-30,4,1,11,1,0,5,1,1,0.24,0.2576,0.7,0.0896,2,17,19,19,True
16616,2012-11-30,4,1,11,2,0,5,1,1,0.24,0.2879,0.75,0.0,2,10,12,12,True
16617,2012-11-30,4,1,11,3,0,5,1,1,0.24,0.2879,0.75,0.0,0,4,4,4,True
16618,2012-11-30,4,1,11,4,0,5,1,1,0.22,0.2727,0.75,0.0,0,3,3,3,True
16619,2012-11-30,4,1,11,5,0,5,1,1,0.2,0.2576,0.8,0.0,1,39,40,40,True
16620,2012-11-30,4,1,11,6,0,5,1,1,0.2,0.2576,0.86,0.0,2,104,106,106,True
16621,2012-11-30,4,1,11,7,0,5,1,1,0.22,0.2727,0.8,0.0,6,346,352,352,True
16622,2012-11-30,4,1,11,8,0,5,1,2,0.22,0.2576,0.8,0.0896,20,499,519,519,True
16623,2012-11-30,4,1,11,9,0,5,1,1,0.24,0.2576,0.75,0.0896,17,313,330,330,True
16624,2012-11-30,4,1,11,10,0,5,1,2,0.3,0.3333,0.65,0.0,10,159,169,169,True
16625,2012-11-30,4,1,11,11,0,5,1,2,0.34,0.3485,0.53,0.0896,31,170,201,201,True
16626,2012-11-30,4,1,11,12,0,5,1,2,0.38,0.3939,0.46,0.0,25,243,268,268,True
16627,2012-11-30,4,1,11,13,0,5,1,2,0.4,0.4091,0.4,0.1642,21,241,262,262,True
16628,2012-11-30,4,1,11,14,0,5,1,2,0.4,0.4091,0.4,0.1045,26,225,251,251,True
16629,2012-11-30,4,1,11,15,0,5,1,2,0.42,0.4242,0.38,0.1045,34,262,296,296,True
16630,2012-11-30,4,1,11,16,0,5,1,1,0.4,0.4091,0.43,0.1343,37,368,405,405,True
16631,2012-11-30,4,1,11,17,0,5,1,1,0.36,0.3485,0.5,0.194,31,499,530,530,True
16632,2012-11-30,4,1,11,18,0,5,1,2,0.34,0.3636,0.61,0.0,20,489,509,509,True
16633,2012-11-30,4,1,11,19,0,5,1,1,0.32,0.3485,0.66,0.0,18,359,377,377,True
16634,2012-11-30,4,1,11,20,0,5,1,1,0.32,0.3485,0.66,0.0,12,233,245,245,True
16635,2012-11-30,4,1,11,21,0,5,1,1,0.3,0.3182,0.75,0.0896,14,169,183,183,True
16636,2012-11-30,4,1,11,22,0,5,1,1,0.3,0.3333,0.75,0.0,18,145,163,163,True
16637,2012-11-30,4,1,11,23,0,5,1,2,0.3,0.3182,0.75,0.0896,11,99,110,110,True
16638,2012-12-01,4,1,12,0,0,6,0,1,0.26,0.303,0.81,0.0,9,99,108,108,True
16639,2012-12-01,4,1,12,1,0,6,0,1,0.26,0.303,0.81,0.0,5,64,69,69,True
16640,2012-12-01,4,1,12,2,0,6,0,2,0.26,0.303,0.81,0.0,3,47,50,50,True
16641,2012-12-01,4,1,12,3,0,6,0,2,0.26,0.2727,0.81,0.1343,1,14,15,15,True
16642,2012-12-01,4,1,12,4,0,6,0,1,0.26,0.2879,0.81,0.0896,0,5,5,5,True
16643,2012-12-01,4,1,12,5,0,6,0,1,0.24,0.2576,0.87,0.0896,1,12,13,13,True
16644,2012-12-01,4,1,12,6,0,6,0,1,0.24,0.2424,0.87,0.1343,7,20,27,27,True
16645,2012-12-01,4,1,12,7,0,6,0,2,0.24,0.2424,0.87,0.1343,7,56,63,63,True
16646,2012-12-01,4,1,12,8,0,6,0,2,0.24,0.2424,0.87,0.1343,11,133,144,144,True
16647,2012-12-01,4,1,12,9,0,6,0,2,0.26,0.2424,0.93,0.2537,34,159,193,193,True
16648,2012-12-01,4,1,12,10,0,6,0,2,0.28,0.2727,0.89,0.1642,45,211,256,256,True
16649,2012-12-01,4,1,12,11,0,6,0,2,0.32,0.3333,0.76,0.1045,74,318,392,392,True
16650,2012-12-01,4,1,12,12,0,6,0,2,0.32,0.3333,0.81,0.0896,114,327,441,441,True
16651,2012-12-01,4,1,12,13,0,6,0,2,0.34,0.3636,0.76,0.0,114,386,500,500,True
16652,2012-12-01,4,1,12,14,0,6,0,2,0.36,0.3788,0.71,0.0,110,369,479,479,True
16653,2012-12-01,4,1,12,15,0,6,0,2,0.4,0.4091,0.62,0.0,113,371,484,484,True
16654,2012-12-01,4,1,12,16,0,6,0,2,0.38,0.3939,0.66,0.0,89,354,443,443,True
16655,2012-12-01,4,1,12,17,0,6,0,2,0.34,0.3485,0.76,0.1045,50,270,320,320,True
16656,2012-12-01,4,1,12,18,0,6,0,2,0.34,0.3636,0.76,0.0,42,255,297,297,True
16657,2012-12-01,4,1,12,19,0,6,0,2,0.32,0.3485,0.81,0.0,30,219,249,249,True
16658,2012-12-01,4,1,12,20,0,6,0,1,0.32,0.3485,0.81,0.0,28,170,198,198,True
16659,2012-12-01,4,1,12,21,0,6,0,2,0.3,0.3333,0.87,0.0,23,135,158,158,True
16660,2012-12-01,4,1,12,22,0,6,0,2,0.3,0.3333,0.87,0.0,17,130,147,147,True
16661,2012-12-01,4,1,12,23,0,6,0,2,0.32,0.3485,0.81,0.0,10,116,126,126,True
16662,2012-12-02,4,1,12,0,0,0,0,2,0.3,0.3182,0.87,0.0896,9,108,117,117,True
16663,2012-12-02,4,1,12,1,0,0,0,2,0.3,0.3182,0.87,0.0896,10,84,94,94,True
16664,2012-12-02,4,1,12,2,0,0,0,2,0.3,0.3333,0.87,0.0,2,72,74,74,True
16665,2012-12-02,4,1,12,3,0,0,0,2,0.26,0.303,0.93,0.0,4,21,25,25,True
16666,2012-12-02,4,1,12,4,0,0,0,2,0.26,0.303,0.93,0.0,1,6,7,7,True
16667,2012-12-02,4,1,12,5,0,0,0,2,0.26,0.303,0.93,0.0,1,7,8,8,True
16668,2012-12-02,4,1,12,6,0,0,0,2,0.24,0.2424,0.93,0.1343,1,15,16,16,True
16669,2012-12-02,4,1,12,7,0,0,0,2,0.24,0.2424,0.93,0.1343,5,26,31,31,True
16670,2012-12-02,4,1,12,8,0,0,0,2,0.26,0.2879,0.93,0.0896,12,81,93,93,True
16671,2012-12-02,4,1,12,9,0,0,0,2,0.28,0.2727,0.93,0.1642,37,135,172,172,True
16672,2012-12-02,4,1,12,10,0,0,0,2,0.3,0.3333,0.87,0.0,63,230,293,293,True
16673,2012-12-02,4,1,12,11,0,0,0,2,0.32,0.3182,0.81,0.1642,81,274,355,355,True
16674,2012-12-02,4,1,12,12,0,0,0,2,0.34,0.3333,0.81,0.1642,111,409,520,520,True
16675,2012-12-02,4,1,12,13,0,0,0,1,0.4,0.4091,0.71,0.2239,84,347,431,431,True
16676,2012-12-02,4,1,12,14,0,0,0,1,0.44,0.4394,0.62,0.2537,114,331,445,445,True
16677,2012-12-02,4,1,12,15,0,0,0,1,0.44,0.4394,0.67,0.1343,106,311,417,417,True
16678,2012-12-02,4,1,12,16,0,0,0,2,0.44,0.4394,0.67,0.1045,85,358,443,443,True
16679,2012-12-02,4,1,12,17,0,0,0,3,0.4,0.4091,0.76,0.194,59,244,303,303,True
16680,2012-12-02,4,1,12,18,0,0,0,2,0.44,0.4394,0.72,0.1045,25,178,203,203,True
16681,2012-12-02,4,1,12,19,0,0,0,2,0.4,0.4091,0.82,0.194,16,158,174,174,True
16682,2012-12-02,4,1,12,20,0,0,0,2,0.42,0.4242,0.82,0.194,12,142,154,154,True
16683,2012-12-02,4,1,12,21,0,0,0,2,0.44,0.4394,0.77,0.2239,8,91,99,99,True
16684,2012-12-02,4,1,12,22,0,0,0,2,0.44,0.4394,0.77,0.194,11,85,96,96,True
16685,2012-12-02,4,1,12,23,0,0,0,2,0.42,0.4242,0.82,0.1343,7,44,51,51,True
16686,2012-12-03,4,1,12,0,0,1,1,2,0.42,0.4242,0.82,0.1642,3,18,21,21,True
16687,2012-12-03,4,1,12,1,0,1,1,1,0.4,0.4091,0.82,0.1343,2,11,13,13,True
16688,2012-12-03,4,1,12,2,0,1,1,1,0.42,0.4242,0.77,0.1642,1,9,10,10,True
16689,2012-12-03,4,1,12,3,0,1,1,1,0.38,0.3939,0.87,0.0,2,6,8,8,True
16690,2012-12-03,4,1,12,4,0,1,1,1,0.36,0.3788,0.93,0.0,1,4,5,5,True
16691,2012-12-03,4,1,12,5,0,1,1,1,0.34,0.3485,0.93,0.0896,0,38,38,38,True
16692,2012-12-03,4,1,12,6,0,1,1,1,0.36,0.3788,0.93,0.0,2,136,138,138,True
16693,2012-12-03,4,1,12,7,0,1,1,2,0.34,0.3636,0.93,0.0,9,387,396,396,True
16694,2012-12-03,4,1,12,8,0,1,1,1,0.36,0.3788,0.93,0.0,19,499,518,518,True
16695,2012-12-03,4,1,12,9,0,1,1,1,0.4,0.4091,0.87,0.0896,19,289,308,308,True
16696,2012-12-03,4,1,12,10,0,1,1,1,0.44,0.4394,0.77,0.1343,31,105,136,136,True
16697,2012-12-03,4,1,12,11,0,1,1,1,0.48,0.4697,0.77,0.1343,51,182,233,233,True
16698,2012-12-03,4,1,12,12,0,1,1,1,0.52,0.5,0.68,0.1642,40,228,268,268,True
16699,2012-12-03,4,1,12,13,0,1,1,1,0.58,0.5455,0.56,0.0896,81,240,321,321,True
16700,2012-12-03,4,1,12,14,0,1,1,1,0.6,0.6212,0.53,0.0,51,209,260,260,True
16701,2012-12-03,4,1,12,15,0,1,1,1,0.6,0.6212,0.56,0.0,58,210,268,268,True
16702,2012-12-03,4,1,12,16,0,1,1,1,0.6,0.6212,0.53,0.1343,45,397,442,442,True
16703,2012-12-03,4,1,12,17,0,1,1,1,0.52,0.5,0.63,0.1045,43,499,542,542,True
16704,2012-12-03,4,1,12,18,0,1,1,1,0.5,0.4848,0.68,0.0896,26,499,525,525,True
16705,2012-12-03,4,1,12,19,0,1,1,1,0.5,0.4848,0.68,0.0896,27,444,471,471,True
16706,2012-12-03,4,1,12,20,0,1,1,2,0.46,0.4545,0.77,0.0,16,284,300,300,True
16707,2012-12-03,4,1,12,21,0,1,1,1,0.44,0.4394,0.82,0.194,14,207,221,221,True
16708,2012-12-03,4,1,12,22,0,1,1,1,0.42,0.4242,0.82,0.1045,5,139,144,144,True
16709,2012-12-03,4,1,12,23,0,1,1,1,0.42,0.4242,0.82,0.1045,9,93,102,102,True
16710,2012-12-04,4,1,12,0,0,2,1,1,0.42,0.4242,0.88,0.1045,6,49,55,55,True
16711,2012-12-04,4,1,12,1,0,2,1,1,0.42,0.4242,0.82,0.1045,3,22,25,25,True
16712,2012-12-04,4,1,12,2,0,2,1,1,0.42,0.4242,0.88,0.0896,3,5,8,8,True
16713,2012-12-04,4,1,12,3,0,2,1,2,0.4,0.4091,0.87,0.1343,1,3,4,4,True
16714,2012-12-04,4,1,12,4,0,2,1,2,0.4,0.4091,0.87,0.1343,0,7,7,7,True
16715,2012-12-04,4,1,12,5,0,2,1,2,0.44,0.4394,0.88,0.0,1,45,46,46,True
16716,2012-12-04,4,1,12,6,0,2,1,2,0.36,0.3788,0.93,0.0,3,150,153,153,True
16717,2012-12-04,4,1,12,7,0,2,1,1,0.42,0.4242,0.88,0.1343,7,495,502,502,True
16718,2012-12-04,4,1,12,8,0,2,1,2,0.44,0.4394,0.88,0.1642,21,499,520,520,True
16719,2012-12-04,4,1,12,9,0,2,1,1,0.46,0.4545,0.82,0.1045,19,317,336,336,True
16720,2012-12-04,4,1,12,10,0,2,1,1,0.46,0.4545,0.82,0.194,26,130,156,156,True
16721,2012-12-04,4,1,12,11,0,2,1,1,0.48,0.4697,0.77,0.194,24,183,207,207,True
16722,2012-12-04,4,1,12,12,0,2,1,1,0.52,0.5,0.68,0.194,39,273,312,312,True
16723,2012-12-04,4,1,12,13,0,2,1,2,0.54,0.5152,0.64,0.1642,39,233,272,272,True
16724,2012-12-04,4,1,12,14,0,2,1,2,0.58,0.5455,0.56,0.2239,39,231,270,270,True
16725,2012-12-04,4,1,12,15,0,2,1,2,0.6,0.6212,0.49,0.2537,56,244,300,300,True
16726,2012-12-04,4,1,12,16,0,2,1,1,0.58,0.5455,0.49,0.2836,44,391,435,435,True
16727,2012-12-04,4,1,12,17,0,2,1,1,0.52,0.5,0.59,0.2239,43,499,542,542,True
16728,2012-12-04,4,1,12,18,0,2,1,1,0.5,0.4848,0.63,0.2239,38,499,537,537,True
16729,2012-12-04,4,1,12,19,0,2,1,1,0.48,0.4697,0.67,0.2239,46,414,460,460,True
16730,2012-12-04,4,1,12,20,0,2,1,2,0.5,0.4848,0.63,0.2239,34,272,306,306,True
16731,2012-12-04,4,1,12,21,0,2,1,2,0.5,0.4848,0.63,0.2537,28,252,280,280,True
16732,2012-12-04,4,1,12,22,0,2,1,2,0.5,0.4848,0.63,0.2985,26,155,181,181,True
16733,2012-12-04,4,1,12,23,0,2,1,1,0.48,0.4697,0.67,0.2537,5,91,96,96,True
16734,2012-12-05,4,1,12,0,0,3,1,1,0.5,0.4848,0.59,0.2836,6,31,37,37,True
16735,2012-12-05,4,1,12,1,0,3,1,1,0.52,0.5,0.55,0.3284,0,11,11,11,True
16736,2012-12-05,4,1,12,2,0,3,1,1,0.46,0.4545,0.67,0.1642,2,7,9,9,True
16737,2012-12-05,4,1,12,3,0,3,1,1,0.48,0.4697,0.67,0.1343,0,7,7,7,True
16738,2012-12-05,4,1,12,4,0,3,1,1,0.5,0.4848,0.63,0.4478,1,9,10,10,True
16739,2012-12-05,4,1,12,5,0,3,1,1,0.5,0.4848,0.59,0.2836,1,48,49,49,True
16740,2012-12-05,4,1,12,6,0,3,1,3,0.48,0.4697,0.55,0.3881,5,119,124,124,True
16741,2012-12-05,4,1,12,7,0,3,1,3,0.46,0.4545,0.59,0.2985,9,389,398,398,True
16742,2012-12-05,4,1,12,8,0,3,1,2,0.44,0.4394,0.58,0.2836,22,499,521,521,True
16743,2012-12-05,4,1,12,9,0,3,1,2,0.44,0.4394,0.51,0.2239,26,362,388,388,True
16744,2012-12-05,4,1,12,10,0,3,1,2,0.44,0.4394,0.47,0.3582,14,127,141,141,True
16745,2012-12-05,4,1,12,11,0,3,1,1,0.44,0.4394,0.44,0.2836,11,161,172,172,True
16746,2012-12-05,4,1,12,12,0,3,1,1,0.44,0.4394,0.41,0.2836,24,208,232,232,True
16747,2012-12-05,4,1,12,13,0,3,1,1,0.46,0.4545,0.41,0.2836,14,200,214,214,True
16748,2012-12-05,4,1,12,14,0,3,1,1,0.48,0.4697,0.33,0.4775,39,179,218,218,True
16749,2012-12-05,4,1,12,15,0,3,1,1,0.48,0.4697,0.33,0.2836,20,265,285,285,True
16750,2012-12-05,4,1,12,16,0,3,1,1,0.46,0.4545,0.33,0.2836,23,354,377,377,True
16751,2012-12-05,4,1,12,17,0,3,1,1,0.44,0.4394,0.35,0.2836,29,499,528,528,True
16752,2012-12-05,4,1,12,18,0,3,1,1,0.42,0.4242,0.35,0.4478,29,499,528,528,True
16753,2012-12-05,4,1,12,19,0,3,1,1,0.38,0.3939,0.43,0.3582,14,400,414,414,True
16754,2012-12-05,4,1,12,20,0,3,1,1,0.34,0.303,0.46,0.3881,19,274,293,293,True
16755,2012-12-05,4,1,12,21,0,3,1,1,0.34,0.303,0.46,0.4179,14,184,198,198,True
16756,2012-12-05,4,1,12,22,0,3,1,1,0.32,0.2879,0.45,0.3881,4,101,105,105,True
16757,2012-12-05,4,1,12,23,0,3,1,1,0.3,0.2727,0.49,0.3881,5,69,74,74,True
16758,2012-12-06,4,1,12,0,0,4,1,1,0.26,0.2424,0.48,0.2836,1,43,44,44,True
16759,2012-12-06,4,1,12,1,0,4,1,1,0.26,0.2424,0.48,0.2836,0,16,16,16,True
16760,2012-12-06,4,1,12,2,0,4,1,1,0.24,0.2121,0.52,0.2836,0,9,9,9,True
16761,2012-12-06,4,1,12,3,0,4,1,1,0.22,0.2273,0.55,0.194,0,2,2,2,True
16762,2012-12-06,4,1,12,4,0,4,1,1,0.22,0.2121,0.55,0.2985,1,8,9,9,True
16763,2012-12-06,4,1,12,5,0,4,1,1,0.22,0.2121,0.55,0.2836,0,32,32,32,True
16764,2012-12-06,4,1,12,6,0,4,1,1,0.22,0.2121,0.55,0.2985,2,122,124,124,True
16765,2012-12-06,4,1,12,7,0,4,1,1,0.22,0.2121,0.51,0.2985,8,381,389,389,True
16766,2012-12-06,4,1,12,8,0,4,1,1,0.22,0.2121,0.51,0.2985,13,499,512,512,True
16767,2012-12-06,4,1,12,9,0,4,1,1,0.24,0.2273,0.48,0.194,19,257,276,276,True
16768,2012-12-06,4,1,12,10,0,4,1,1,0.24,0.2273,0.52,0.194,23,122,145,145,True
16769,2012-12-06,4,1,12,11,0,4,1,1,0.26,0.2576,0.48,0.1642,16,162,178,178,True
16770,2012-12-06,4,1,12,12,0,4,1,1,0.28,0.3182,0.41,0.0,29,206,235,235,True
16771,2012-12-06,4,1,12,13,0,4,1,1,0.3,0.3333,0.39,0.0,33,212,245,245,True
16772,2012-12-06,4,1,12,14,0,4,1,1,0.3,0.3182,0.42,0.0896,37,175,212,212,True
16773,2012-12-06,4,1,12,15,0,4,1,1,0.32,0.3485,0.39,0.0,38,232,270,270,True
16774,2012-12-06,4,1,12,16,0,4,1,1,0.32,0.3485,0.42,0.0,39,292,331,331,True
16775,2012-12-06,4,1,12,17,0,4,1,1,0.3,0.3182,0.45,0.1045,31,499,530,530,True
16776,2012-12-06,4,1,12,18,0,4,1,1,0.28,0.2727,0.45,0.1642,23,499,522,522,True
16777,2012-12-06,4,1,12,19,0,4,1,1,0.26,0.2576,0.6,0.194,13,360,373,373,True
16778,2012-12-06,4,1,12,20,0,4,1,2,0.24,0.2576,0.6,0.1045,5,222,227,227,True
16779,2012-12-06,4,1,12,21,0,4,1,2,0.24,0.2424,0.6,0.1343,7,184,191,191,True
16780,2012-12-06,4,1,12,22,0,4,1,1,0.24,0.2424,0.65,0.1642,2,131,133,133,True
16781,2012-12-06,4,1,12,23,0,4,1,1,0.24,0.2424,0.65,0.1642,0,93,93,93,True
16782,2012-12-07,4,1,12,0,0,5,1,1,0.24,0.2576,0.7,0.1045,3,45,48,48,True
16783,2012-12-07,4,1,12,1,0,5,1,2,0.24,0.2273,0.7,0.194,2,26,28,28,True
16784,2012-12-07,4,1,12,2,0,5,1,2,0.26,0.2727,0.7,0.1343,0,11,11,11,True
16785,2012-12-07,4,1,12,3,0,5,1,2,0.26,0.2576,0.81,0.194,0,5,5,5,True
16786,2012-12-07,4,1,12,4,0,5,1,1,0.26,0.2727,0.75,0.1045,0,10,10,10,True
16787,2012-12-07,4,1,12,5,0,5,1,2,0.26,0.2727,0.81,0.1045,1,25,26,26,True
16788,2012-12-07,4,1,12,6,0,5,1,2,0.28,0.2727,0.75,0.1642,0,84,84,84,True
16789,2012-12-07,4,1,12,7,0,5,1,3,0.28,0.2727,0.81,0.1642,3,212,215,215,True
16790,2012-12-07,4,1,12,8,0,5,1,2,0.3,0.2879,0.75,0.194,11,430,441,441,True
16791,2012-12-07,4,1,12,9,0,5,1,2,0.3,0.303,0.81,0.1343,10,291,301,301,True
16792,2012-12-07,4,1,12,10,0,5,1,2,0.32,0.3182,0.76,0.1642,16,150,166,166,True
16793,2012-12-07,4,1,12,11,0,5,1,2,0.32,0.3182,0.76,0.194,20,183,203,203,True
16794,2012-12-07,4,1,12,12,0,5,1,2,0.34,0.3333,0.71,0.194,36,204,240,240,True
16795,2012-12-07,4,1,12,13,0,5,1,2,0.36,0.3485,0.66,0.1343,23,197,220,220,True
16796,2012-12-07,4,1,12,14,0,5,1,2,0.36,0.3485,0.71,0.1642,40,175,215,215,True
16797,2012-12-07,4,1,12,15,0,5,1,2,0.36,0.3485,0.71,0.1642,34,269,303,303,True
16798,2012-12-07,4,1,12,16,0,5,1,1,0.36,0.3485,0.76,0.1343,39,336,375,375,True
16799,2012-12-07,4,1,12,17,0,5,1,2,0.38,0.3939,0.66,0.0,29,499,528,528,True
16800,2012-12-07,4,1,12,18,0,5,1,2,0.38,0.3939,0.71,0.1045,25,473,498,498,True
16801,2012-12-07,4,1,12,19,0,5,1,2,0.38,0.3939,0.76,0.0,15,337,352,352,True
16802,2012-12-07,4,1,12,20,0,5,1,3,0.38,0.3939,0.76,0.1045,12,229,241,241,True
16803,2012-12-07,4,1,12,21,0,5,1,2,0.36,0.3636,0.93,0.1045,9,162,171,171,True
16804,2012-12-07,4,1,12,22,0,5,1,2,0.36,0.3636,0.93,0.0896,15,150,165,165,True
16805,2012-12-07,4,1,12,23,0,5,1,2,0.36,0.3636,0.93,0.0896,6,116,122,122,True
16806,2012-12-08,4,1,12,0,0,6,0,2,0.36,0.3636,0.93,0.0896,5,98,103,103,True
16807,2012-12-08,4,1,12,1,0,6,0,2,0.36,0.3485,0.93,0.1343,16,84,100,100,True
16808,2012-12-08,4,1,12,2,0,6,0,2,0.36,0.3485,0.93,0.1343,3,67,70,70,True
16809,2012-12-08,4,1,12,3,0,6,0,2,0.36,0.3636,0.93,0.1045,6,23,29,29,True
16810,2012-12-08,4,1,12,4,0,6,0,2,0.36,0.3788,0.93,0.0,3,9,12,12,True
16811,2012-12-08,4,1,12,5,0,6,0,2,0.36,0.3636,0.93,0.1045,2,4,6,6,True
16812,2012-12-08,4,1,12,6,0,6,0,2,0.36,0.3636,0.93,0.1045,1,19,20,20,True
16813,2012-12-08,4,1,12,7,0,6,0,2,0.36,0.3636,1.0,0.0896,3,36,39,39,True
16814,2012-12-08,4,1,12,8,0,6,0,2,0.38,0.3939,0.94,0.0896,5,106,111,111,True
16815,2012-12-08,4,1,12,9,0,6,0,2,0.38,0.3939,0.94,0.0,17,153,170,170,True
16816,2012-12-08,4,1,12,10,0,6,0,2,0.4,0.4091,0.87,0.1343,43,244,287,287,True
16817,2012-12-08,4,1,12,11,0,6,0,2,0.4,0.4091,0.87,0.1045,63,341,404,404,True
16818,2012-12-08,4,1,12,12,0,6,0,2,0.4,0.4091,0.87,0.2239,114,364,478,478,True
16819,2012-12-08,4,1,12,13,0,6,0,2,0.4,0.4091,0.87,0.1642,114,399,513,513,True
16820,2012-12-08,4,1,12,14,0,6,0,2,0.4,0.4091,0.87,0.2836,114,378,492,492,True
16821,2012-12-08,4,1,12,15,0,6,0,1,0.42,0.4242,0.82,0.1642,114,374,488,488,True
16822,2012-12-08,4,1,12,16,0,6,0,1,0.42,0.4242,0.82,0.1642,114,368,482,482,True
16823,2012-12-08,4,1,12,17,0,6,0,1,0.38,0.3939,0.87,0.1343,77,268,345,345,True
16824,2012-12-08,4,1,12,18,0,6,0,1,0.4,0.4091,0.87,0.1045,40,264,304,304,True
16825,2012-12-08,4,1,12,19,0,6,0,1,0.4,0.4091,0.87,0.0,34,212,246,246,True
16826,2012-12-08,4,1,12,20,0,6,0,2,0.36,0.3788,1.0,0.0,20,162,182,182,True
16827,2012-12-08,4,1,12,21,0,6,0,2,0.36,0.3788,1.0,0.0,34,175,209,209,True
16828,2012-12-08,4,1,12,22,0,6,0,2,0.38,0.3939,0.94,0.1045,23,137,160,160,True
16829,2012-12-08,4,1,12,23,0,6,0,2,0.4,0.4091,0.94,0.0,18,144,162,162,True
16830,2012-12-09,4,1,12,0,0,0,0,2,0.4,0.4091,0.87,0.1343,15,103,118,118,True
16831,2012-12-09,4,1,12,1,0,0,0,2,0.4,0.4091,0.87,0.1045,17,85,102,102,True
16832,2012-12-09,4,1,12,2,0,0,0,2,0.4,0.4091,0.87,0.1045,8,70,78,78,True
16833,2012-12-09,4,1,12,3,0,0,0,2,0.4,0.4091,0.87,0.1045,14,34,48,48,True
16834,2012-12-09,4,1,12,4,0,0,0,2,0.4,0.4091,0.94,0.1045,1,11,12,12,True
16835,2012-12-09,4,1,12,5,0,0,0,2,0.4,0.4091,0.87,0.1045,0,8,8,8,True
16836,2012-12-09,4,1,12,6,0,0,0,3,0.4,0.4091,0.94,0.1045,0,6,6,6,True
16837,2012-12-09,4,1,12,7,0,0,0,3,0.4,0.4091,0.87,0.2239,1,22,23,23,True
16838,2012-12-09,4,1,12,8,0,0,0,3,0.4,0.4091,0.87,0.1642,1,68,69,69,True
16839,2012-12-09,4,1,12,9,0,0,0,2,0.4,0.4091,0.87,0.2537,9,94,103,103,True
16840,2012-12-09,4,1,12,10,0,0,0,2,0.4,0.4091,0.87,0.2836,39,180,219,219,True
16841,2012-12-09,4,1,12,11,0,0,0,2,0.4,0.4091,0.87,0.2985,40,210,250,250,True
16842,2012-12-09,4,1,12,12,0,0,0,2,0.4,0.4091,0.82,0.2985,60,255,315,315,True
16843,2012-12-09,4,1,12,13,0,0,0,2,0.38,0.3939,0.87,0.2836,65,220,285,285,True
16844,2012-12-09,4,1,12,14,0,0,0,2,0.38,0.3939,0.87,0.194,42,190,232,232,True
16845,2012-12-09,4,1,12,15,0,0,0,3,0.36,0.3485,0.93,0.1642,25,200,225,225,True
16846,2012-12-09,4,1,12,16,0,0,0,3,0.36,0.3485,0.93,0.1642,33,220,253,253,True
16847,2012-12-09,4,1,12,17,0,0,0,3,0.36,0.3485,0.93,0.1343,20,209,229,229,True
16848,2012-12-09,4,1,12,18,0,0,0,3,0.36,0.3636,0.93,0.0896,17,181,198,198,True
16849,2012-12-09,4,1,12,19,0,0,0,3,0.38,0.3939,0.94,0.0896,12,110,122,122,True
16850,2012-12-09,4,1,12,20,0,0,0,3,0.36,0.3636,1.0,0.0896,6,102,108,108,True
16851,2012-12-09,4,1,12,21,0,0,0,2,0.36,0.3636,1.0,0.1045,10,86,96,96,True
16852,2012-12-09,4,1,12,22,0,0,0,3,0.36,0.3636,0.93,0.1045,3,75,78,78,True
16853,2012-12-09,4,1,12,23,0,0,0,3,0.36,0.3636,1.0,0.0896,3,48,51,51,True
16854,2012-12-10,4,1,12,0,0,1,1,3,0.36,0.3636,1.0,0.0896,0,20,20,20,True
16855,2012-12-10,4,1,12,1,0,1,1,2,0.36,0.3788,1.0,0.0,0,4,4,4,True
16856,2012-12-10,4,1,12,2,0,1,1,2,0.38,0.3939,0.94,0.1045,2,3,5,5,True
16857,2012-12-10,4,1,12,3,0,1,1,2,0.38,0.3939,0.94,0.1045,0,4,4,4,True
16858,2012-12-10,4,1,12,4,0,1,1,2,0.38,0.3939,0.94,0.1045,3,9,12,12,True
16859,2012-12-10,4,1,12,5,0,1,1,2,0.38,0.3939,0.94,0.1045,0,27,27,27,True
16860,2012-12-10,4,1,12,6,0,1,1,2,0.38,0.3939,0.94,0.1642,2,121,123,123,True
16861,2012-12-10,4,1,12,7,0,1,1,2,0.38,0.3939,0.94,0.2537,3,291,294,294,True
16862,2012-12-10,4,1,12,8,0,1,1,2,0.42,0.4242,1.0,0.2537,9,499,508,508,True
16863,2012-12-10,4,1,12,9,0,1,1,2,0.42,0.4242,1.0,0.2239,11,273,284,284,True
16864,2012-12-10,4,1,12,10,0,1,1,2,0.44,0.4394,0.94,0.2239,12,121,133,133,True
16865,2012-12-10,4,1,12,11,0,1,1,3,0.46,0.4545,0.94,0.2239,8,126,134,134,True
16866,2012-12-10,4,1,12,12,0,1,1,3,0.44,0.4394,1.0,0.2239,23,150,173,173,True
16867,2012-12-10,4,1,12,13,0,1,1,3,0.44,0.4394,1.0,0.2239,30,190,220,220,True
16868,2012-12-10,4,1,12,14,0,1,1,2,0.5,0.4848,0.94,0.2239,31,179,210,210,True
16869,2012-12-10,4,1,12,15,0,1,1,2,0.5,0.4848,0.87,0.1642,29,207,236,236,True
16870,2012-12-10,4,1,12,16,0,1,1,2,0.5,0.4848,0.88,0.1045,37,308,345,345,True
16871,2012-12-10,4,1,12,17,0,1,1,2,0.48,0.4697,0.82,0.2836,38,499,537,537,True
16872,2012-12-10,4,1,12,18,0,1,1,2,0.46,0.4545,0.88,0.2836,20,499,519,519,True
16873,2012-12-10,4,1,12,19,0,1,1,1,0.52,0.5,0.77,0.2836,18,409,427,427,True
16874,2012-12-10,4,1,12,20,0,1,1,1,0.46,0.4545,0.88,0.2537,13,287,300,300,True
16875,2012-12-10,4,1,12,21,0,1,1,2,0.46,0.4545,0.94,0.194,21,224,245,245,True
16876,2012-12-10,4,1,12,22,0,1,1,2,0.5,0.4848,0.82,0.2239,11,115,126,126,True
16877,2012-12-10,4,1,12,23,0,1,1,1,0.46,0.4545,0.88,0.2537,8,76,84,84,True
16878,2012-12-11,4,1,12,0,0,2,1,3,0.46,0.4545,0.77,0.4627,2,29,31,31,True
16879,2012-12-11,4,1,12,1,0,2,1,1,0.42,0.4242,0.71,0.4478,1,7,8,8,True
16880,2012-12-11,4,1,12,2,0,2,1,2,0.4,0.4091,0.66,0.3284,0,1,1,1,True
16881,2012-12-11,4,1,12,3,0,2,1,3,0.36,0.3333,0.76,0.2836,0,3,3,3,True
16882,2012-12-11,4,1,12,4,0,2,1,2,0.34,0.3182,0.76,0.2836,0,8,8,8,True
16883,2012-12-11,4,1,12,5,0,2,1,3,0.34,0.303,0.71,0.3284,1,40,41,41,True
16884,2012-12-11,4,1,12,6,0,2,1,2,0.34,0.303,0.71,0.2985,0,118,118,118,True
16885,2012-12-11,4,1,12,7,0,2,1,1,0.34,0.303,0.66,0.4179,8,372,380,380,True
16886,2012-12-11,4,1,12,8,0,2,1,2,0.34,0.303,0.61,0.2985,16,499,515,515,True
16887,2012-12-11,4,1,12,9,0,2,1,1,0.34,0.303,0.61,0.3881,12,322,334,334,True
16888,2012-12-11,4,1,12,10,0,2,1,1,0.36,0.3333,0.57,0.3284,12,142,154,154,True
16889,2012-12-11,4,1,12,11,0,2,1,2,0.36,0.3333,0.53,0.3582,28,145,173,173,True
16890,2012-12-11,4,1,12,12,0,2,1,2,0.36,0.3182,0.53,0.4478,13,213,226,226,True
16891,2012-12-11,4,1,12,13,0,2,1,2,0.38,0.3939,0.5,0.2239,28,226,254,254,True
16892,2012-12-11,4,1,12,14,0,2,1,2,0.38,0.3939,0.5,0.2239,19,185,204,204,True
16893,2012-12-11,4,1,12,15,0,2,1,2,0.38,0.3939,0.5,0.2239,20,250,270,270,True
16894,2012-12-11,4,1,12,16,0,2,1,2,0.38,0.3939,0.5,0.2239,24,334,358,358,True
16895,2012-12-11,4,1,12,17,0,2,1,1,0.32,0.303,0.53,0.2239,21,499,520,520,True
16896,2012-12-11,4,1,12,18,0,2,1,1,0.32,0.303,0.53,0.2239,23,499,522,522,True
16897,2012-12-11,4,1,12,19,0,2,1,1,0.32,0.303,0.53,0.2239,21,412,433,433,True
16898,2012-12-11,4,1,12,20,0,2,1,1,0.32,0.303,0.53,0.2239,9,248,257,257,True
16899,2012-12-11,4,1,12,21,0,2,1,1,0.32,0.3182,0.53,0.194,14,193,207,207,True
16900,2012-12-11,4,1,12,22,0,2,1,1,0.3,0.2879,0.56,0.2239,6,100,106,106,True
16901,2012-12-11,4,1,12,23,0,2,1,1,0.3,0.2879,0.52,0.2239,4,60,64,64,True
16902,2012-12-12,4,1,12,0,0,3,1,1,0.3,0.303,0.52,0.1642,1,33,34,34,True
16903,2012-12-12,4,1,12,1,0,3,1,1,0.28,0.2727,0.61,0.2239,3,18,21,21,True
16904,2012-12-12,4,1,12,2,0,3,1,1,0.28,0.2727,0.56,0.1642,5,4,9,9,True
16905,2012-12-12,4,1,12,3,0,3,1,1,0.26,0.2727,0.6,0.1343,3,7,10,10,True
16906,2012-12-12,4,1,12,4,0,3,1,1,0.26,0.303,0.6,0.0,0,4,4,4,True
16907,2012-12-12,4,1,12,5,0,3,1,1,0.26,0.2576,0.6,0.194,0,37,37,37,True
16908,2012-12-12,4,1,12,6,0,3,1,2,0.26,0.2424,0.6,0.2537,2,126,128,128,True
16909,2012-12-12,4,1,12,7,0,3,1,2,0.26,0.2576,0.6,0.194,3,366,369,369,True
16910,2012-12-12,4,1,12,8,0,3,1,2,0.26,0.2576,0.65,0.1642,18,499,517,517,True
16911,2012-12-12,4,1,12,9,0,3,1,2,0.28,0.2879,0.61,0.1343,13,272,285,285,True
16912,2012-12-12,4,1,12,10,0,3,1,2,0.3,0.303,0.56,0.1642,20,116,136,136,True
16913,2012-12-12,4,1,12,11,0,3,1,2,0.32,0.303,0.49,0.2239,24,148,172,172,True
16914,2012-12-12,4,1,12,12,0,3,1,2,0.34,0.3636,0.42,0.0,14,218,232,232,True
16915,2012-12-12,4,1,12,13,0,3,1,2,0.34,0.3636,0.42,0.0,18,220,238,238,True
16916,2012-12-12,4,1,12,14,0,3,1,2,0.34,0.3636,0.46,0.0,34,191,225,225,True
16917,2012-12-12,4,1,12,15,0,3,1,2,0.34,0.3485,0.46,0.1045,21,207,228,228,True
16918,2012-12-12,4,1,12,16,0,3,1,2,0.34,0.3333,0.46,0.1343,19,310,329,329,True
16919,2012-12-12,4,1,12,17,0,3,1,2,0.32,0.303,0.53,0.2239,21,499,520,520,True
16920,2012-12-12,4,1,12,18,0,3,1,2,0.32,0.303,0.49,0.2239,25,499,524,524,True
16921,2012-12-12,4,1,12,19,0,3,1,2,0.3,0.2879,0.56,0.2239,18,384,402,402,True
16922,2012-12-12,4,1,12,20,0,3,1,1,0.3,0.2879,0.52,0.2836,25,243,268,268,True
16923,2012-12-12,4,1,12,21,0,3,1,2,0.3,0.2879,0.52,0.2537,16,186,202,202,True
16924,2012-12-12,4,1,12,22,0,3,1,2,0.3,0.2879,0.52,0.2239,4,118,122,122,True
16925,2012-12-12,4,1,12,23,0,3,1,2,0.28,0.2727,0.56,0.2239,3,76,79,79,True
16926,2012-12-13,4,1,12,0,0,4,1,2,0.28,0.2727,0.52,0.2239,1,31,32,32,True
16927,2012-12-13,4,1,12,1,0,4,1,2,0.28,0.2576,0.52,0.2836,4,19,23,23,True
16928,2012-12-13,4,1,12,2,0,4,1,2,0.26,0.2424,0.56,0.2537,3,5,8,8,True
16929,2012-12-13,4,1,12,3,0,4,1,2,0.26,0.2424,0.56,0.2836,0,2,2,2,True
16930,2012-12-13,4,1,12,4,0,4,1,2,0.26,0.2576,0.56,0.194,0,8,8,8,True
16931,2012-12-13,4,1,12,5,0,4,1,2,0.26,0.2576,0.56,0.1642,2,31,33,33,True
16932,2012-12-13,4,1,12,6,0,4,1,1,0.26,0.2424,0.56,0.2537,2,112,114,114,True
16933,2012-12-13,4,1,12,7,0,4,1,1,0.24,0.2273,0.6,0.2239,5,380,385,385,True
16934,2012-12-13,4,1,12,8,0,4,1,1,0.24,0.2273,0.6,0.194,24,499,523,523,True
16935,2012-12-13,4,1,12,9,0,4,1,1,0.28,0.2727,0.52,0.2537,25,300,325,325,True
16936,2012-12-13,4,1,12,10,0,4,1,1,0.32,0.303,0.45,0.2836,28,139,167,167,True
16937,2012-12-13,4,1,12,11,0,4,1,1,0.34,0.3182,0.42,0.2537,25,164,189,189,True
16938,2012-12-13,4,1,12,12,0,4,1,1,0.36,0.3333,0.4,0.2537,30,252,282,282,True
16939,2012-12-13,4,1,12,13,0,4,1,1,0.36,0.3485,0.34,0.194,41,230,271,271,True
16940,2012-12-13,4,1,12,14,0,4,1,1,0.36,0.3485,0.34,0.1642,31,211,242,242,True
16941,2012-12-13,4,1,12,15,0,4,1,1,0.36,0.3485,0.34,0.1343,40,240,280,280,True
16942,2012-12-13,4,1,12,16,0,4,1,1,0.34,0.3485,0.39,0.1045,50,356,406,406,True
16943,2012-12-13,4,1,12,17,0,4,1,1,0.32,0.3333,0.42,0.1045,43,499,542,542,True
16944,2012-12-13,4,1,12,18,0,4,1,1,0.32,0.3333,0.42,0.1045,20,446,466,466,True
16945,2012-12-13,4,1,12,19,0,4,1,1,0.3,0.303,0.45,0.1642,20,328,348,348,True
16946,2012-12-13,4,1,12,20,0,4,1,1,0.3,0.3333,0.45,0.0,6,235,241,241,True
16947,2012-12-13,4,1,12,21,0,4,1,1,0.28,0.3182,0.48,0.0,13,200,213,213,True
16948,2012-12-13,4,1,12,22,0,4,1,1,0.26,0.2879,0.6,0.0896,7,141,148,148,True
16949,2012-12-13,4,1,12,23,0,4,1,1,0.26,0.303,0.6,0.0,5,115,120,120,True
16950,2012-12-14,4,1,12,0,0,5,1,1,0.22,0.2576,0.64,0.0896,4,43,47,47,True
16951,2012-12-14,4,1,12,1,0,5,1,1,0.22,0.2576,0.69,0.0896,0,26,26,26,True
16952,2012-12-14,4,1,12,2,0,5,1,1,0.22,0.2727,0.69,0.0,3,6,9,9,True
16953,2012-12-14,4,1,12,3,0,5,1,1,0.2,0.2273,0.69,0.1045,0,12,12,12,True
16954,2012-12-14,4,1,12,4,0,5,1,1,0.2,0.2273,0.75,0.0896,1,9,10,10,True
16955,2012-12-14,4,1,12,5,0,5,1,1,0.2,0.2273,0.69,0.1045,0,34,34,34,True
16956,2012-12-14,4,1,12,6,0,5,1,1,0.16,0.1818,0.8,0.1045,1,112,113,113,True
16957,2012-12-14,4,1,12,7,0,5,1,1,0.2,0.2121,0.72,0.1045,3,305,308,308,True
16958,2012-12-14,4,1,12,8,0,5,1,1,0.2,0.2273,0.69,0.0896,13,499,512,512,True
16959,2012-12-14,4,1,12,9,0,5,1,1,0.24,0.2424,0.75,0.1343,13,330,343,343,True
16960,2012-12-14,4,1,12,10,0,5,1,1,0.26,0.2576,0.81,0.194,28,162,190,190,True
16961,2012-12-14,4,1,12,11,0,5,1,1,0.32,0.303,0.65,0.194,31,180,211,211,True
16962,2012-12-14,4,1,12,12,0,5,1,1,0.36,0.3485,0.5,0.194,29,244,273,273,True
16963,2012-12-14,4,1,12,13,0,5,1,1,0.36,0.3485,0.5,0.2239,39,274,313,313,True
16964,2012-12-14,4,1,12,14,0,5,1,1,0.4,0.4091,0.43,0.194,48,251,299,299,True
16965,2012-12-14,4,1,12,15,0,5,1,1,0.4,0.4091,0.47,0.1642,57,252,309,309,True
16966,2012-12-14,4,1,12,16,0,5,1,1,0.38,0.3939,0.54,0.194,45,372,417,417,True
16967,2012-12-14,4,1,12,17,0,5,1,1,0.34,0.3333,0.57,0.1642,40,499,539,539,True
16968,2012-12-14,4,1,12,18,0,5,1,1,0.36,0.3485,0.46,0.1343,23,432,455,455,True
16969,2012-12-14,4,1,12,19,0,5,1,1,0.34,0.3485,0.53,0.0896,17,302,319,319,True
16970,2012-12-14,4,1,12,20,0,5,1,1,0.32,0.3333,0.61,0.1343,12,209,221,221,True
16971,2012-12-14,4,1,12,21,0,5,1,1,0.3,0.303,0.75,0.1642,7,165,172,172,True
16972,2012-12-14,4,1,12,22,0,5,1,1,0.28,0.2879,0.75,0.1045,4,134,138,138,True
16973,2012-12-14,4,1,12,23,0,5,1,1,0.28,0.303,0.75,0.0896,11,123,134,134,True
16974,2012-12-15,4,1,12,0,0,6,0,1,0.3,0.3333,0.7,0.0,4,90,94,94,True
16975,2012-12-15,4,1,12,1,0,6,0,2,0.26,0.2879,0.81,0.0896,9,86,95,95,True
16976,2012-12-15,4,1,12,2,0,6,0,1,0.26,0.303,0.81,0.0,6,63,69,69,True
16977,2012-12-15,4,1,12,3,0,6,0,2,0.24,0.2879,0.81,0.0,5,18,23,23,True
16978,2012-12-15,4,1,12,4,0,6,0,2,0.24,0.2576,0.87,0.1045,1,5,6,6,True
16979,2012-12-15,4,1,12,5,0,6,0,2,0.26,0.303,0.75,0.0,0,3,3,3,True
16980,2012-12-15,4,1,12,6,0,6,0,2,0.24,0.2879,0.75,0.0,0,11,11,11,True
16981,2012-12-15,4,1,12,7,0,6,0,2,0.24,0.2576,0.75,0.0896,1,47,48,48,True
16982,2012-12-15,4,1,12,8,0,6,0,2,0.26,0.2879,0.75,0.0896,8,111,119,119,True
16983,2012-12-15,4,1,12,9,0,6,0,1,0.26,0.2727,0.75,0.1045,17,203,220,220,True
16984,2012-12-15,4,1,12,10,0,6,0,1,0.32,0.3182,0.61,0.1642,23,250,273,273,True
16985,2012-12-15,4,1,12,11,0,6,0,1,0.34,0.3485,0.61,0.0896,66,327,393,393,True
16986,2012-12-15,4,1,12,12,0,6,0,1,0.38,0.3939,0.5,0.0896,89,364,453,453,True
16987,2012-12-15,4,1,12,13,0,6,0,1,0.38,0.3939,0.54,0.2537,88,368,456,456,True
16988,2012-12-15,4,1,12,14,0,6,0,1,0.4,0.4091,0.5,0.1642,92,334,426,426,True
16989,2012-12-15,4,1,12,15,0,6,0,1,0.42,0.4242,0.47,0.0,95,352,447,447,True
16990,2012-12-15,4,1,12,16,0,6,0,1,0.4,0.4091,0.5,0.1343,85,328,413,413,True
16991,2012-12-15,4,1,12,17,0,6,0,1,0.4,0.4091,0.5,0.2239,35,274,309,309,True
16992,2012-12-15,4,1,12,18,0,6,0,1,0.38,0.3939,0.58,0.1642,40,232,272,272,True
16993,2012-12-15,4,1,12,19,0,6,0,1,0.36,0.3485,0.62,0.1343,32,225,257,257,True
16994,2012-12-15,4,1,12,20,0,6,0,2,0.36,0.3485,0.57,0.194,23,178,201,201,True
16995,2012-12-15,4,1,12,21,0,6,0,1,0.36,0.3485,0.62,0.1343,15,169,184,184,True
16996,2012-12-15,4,1,12,22,0,6,0,1,0.36,0.3485,0.62,0.194,22,134,156,156,True
16997,2012-12-15,4,1,12,23,0,6,0,2,0.36,0.3485,0.62,0.1343,11,108,119,119,True
16998,2012-12-16,4,1,12,0,0,0,0,2,0.36,0.3788,0.62,0.0,8,102,110,110,True
16999,2012-12-16,4,1,12,1,0,0,0,3,0.34,0.3485,0.76,0.1045,14,82,96,96,True
17000,2012-12-16,4,1,12,2,0,0,0,2,0.34,0.3485,0.87,0.0896,8,79,87,87,True
17001,2012-12-16,4,1,12,3,0,0,0,2,0.34,0.3333,0.87,0.194,1,37,38,38,True
17002,2012-12-16,4,1,12,4,0,0,0,2,0.34,0.3636,0.87,0.0,1,10,11,11,True
17003,2012-12-16,4,1,12,5,0,0,0,2,0.34,0.3636,0.87,0.0,0,9,9,9,True
17004,2012-12-16,4,1,12,6,0,0,0,2,0.34,0.3636,0.87,0.0,0,6,6,6,True
17005,2012-12-16,4,1,12,7,0,0,0,2,0.34,0.3485,0.87,0.0896,5,22,27,27,True
17006,2012-12-16,4,1,12,8,0,0,0,2,0.36,0.3485,0.87,0.1343,12,76,88,88,True
17007,2012-12-16,4,1,12,9,0,0,0,2,0.36,0.3485,0.87,0.1343,19,113,132,132,True
17008,2012-12-16,4,1,12,10,0,0,0,2,0.36,0.3485,0.87,0.1343,42,215,257,257,True
17009,2012-12-16,4,1,12,11,0,0,0,2,0.36,0.3485,0.87,0.1343,47,248,295,295,True
17010,2012-12-16,4,1,12,12,0,0,0,2,0.38,0.3939,0.82,0.194,67,350,417,417,True
17011,2012-12-16,4,1,12,13,0,0,0,2,0.38,0.3939,0.76,0.194,67,289,356,356,True
17012,2012-12-16,4,1,12,14,0,0,0,2,0.38,0.3939,0.76,0.1343,50,260,310,310,True
17013,2012-12-16,4,1,12,15,0,0,0,2,0.38,0.3939,0.82,0.1045,46,292,338,338,True
17014,2012-12-16,4,1,12,16,0,0,0,2,0.38,0.3939,0.82,0.1045,66,334,400,400,True
17015,2012-12-16,4,1,12,17,0,0,0,2,0.38,0.3939,0.82,0.1045,29,214,243,243,True
17016,2012-12-16,4,1,12,18,0,0,0,3,0.38,0.3939,0.82,0.1045,8,99,107,107,True
17017,2012-12-16,4,1,12,19,0,0,0,1,0.36,0.3485,0.93,0.1343,10,99,109,109,True
17018,2012-12-16,4,1,12,20,0,0,0,2,0.38,0.3939,0.82,0.0,14,108,122,122,True
17019,2012-12-16,4,1,12,21,0,0,0,2,0.36,0.3788,0.93,0.0,14,92,106,106,True
17020,2012-12-16,4,1,12,22,0,0,0,2,0.4,0.4091,0.82,0.194,6,83,89,89,True
17021,2012-12-16,4,1,12,23,0,0,0,2,0.36,0.3485,0.93,0.1343,4,29,33,33,True
17022,2012-12-17,4,1,12,0,0,1,1,2,0.38,0.3939,0.87,0.0,2,26,28,28,True
17023,2012-12-17,4,1,12,1,0,1,1,2,0.38,0.3939,0.87,0.1045,1,14,15,15,True
17024,2012-12-17,4,1,12,2,0,1,1,2,0.38,0.3939,0.94,0.0,1,4,5,5,True
17025,2012-12-17,4,1,12,3,0,1,1,2,0.36,0.3788,0.93,0.0,0,3,3,3,True
17026,2012-12-17,4,1,12,4,0,1,1,3,0.36,0.3788,1.0,0.0,2,3,5,5,True
17027,2012-12-17,4,1,12,5,0,1,1,2,0.38,0.3939,0.87,0.0,0,24,24,24,True
17028,2012-12-17,4,1,12,6,0,1,1,2,0.36,0.3485,0.93,0.1343,1,107,108,108,True
17029,2012-12-17,4,1,12,7,0,1,1,2,0.36,0.3485,0.93,0.1343,5,314,319,319,True
17030,2012-12-17,4,1,12,8,0,1,1,2,0.38,0.3939,0.87,0.1045,10,499,509,509,True
17031,2012-12-17,4,1,12,9,0,1,1,2,0.4,0.4091,0.87,0.0,11,271,282,282,True
17032,2012-12-17,4,1,12,10,0,1,1,2,0.38,0.3939,0.87,0.0896,15,120,135,135,True
17033,2012-12-17,4,1,12,11,0,1,1,2,0.4,0.4091,0.87,0.0896,22,148,170,170,True
17034,2012-12-17,4,1,12,12,0,1,1,2,0.4,0.4091,0.87,0.0,21,211,232,232,True
17035,2012-12-17,4,1,12,13,0,1,1,2,0.4,0.4091,0.87,0.1343,16,194,210,210,True
17036,2012-12-17,4,1,12,14,0,1,1,2,0.4,0.4091,0.87,0.0896,12,169,181,181,True
17037,2012-12-17,4,1,12,15,0,1,1,2,0.42,0.4242,0.88,0.0,15,196,211,211,True
17038,2012-12-17,4,1,12,16,0,1,1,3,0.4,0.4091,0.94,0.2537,15,287,302,302,True
17039,2012-12-17,4,1,12,17,0,1,1,2,0.4,0.4091,0.94,0.2537,17,478,495,495,True
17040,2012-12-17,4,1,12,18,0,1,1,2,0.4,0.4091,0.94,0.0896,14,493,507,507,True
17041,2012-12-17,4,1,12,19,0,1,1,2,0.42,0.4242,0.88,0.1343,7,333,340,340,True
17042,2012-12-17,4,1,12,20,0,1,1,2,0.42,0.4242,0.94,0.2537,8,192,200,200,True
17043,2012-12-17,4,1,12,21,0,1,1,2,0.42,0.4242,0.94,0.1343,6,114,120,120,True
17044,2012-12-17,4,1,12,22,0,1,1,2,0.42,0.4242,0.94,0.1343,5,49,54,54,True
17045,2012-12-17,4,1,12,23,0,1,1,3,0.42,0.4242,0.94,0.2239,6,41,47,47,True
17046,2012-12-18,4,1,12,0,0,2,1,2,0.44,0.4394,0.94,0.1343,0,18,18,18,True
17047,2012-12-18,4,1,12,1,0,2,1,2,0.44,0.4394,0.94,0.1343,0,15,15,15,True
17048,2012-12-18,4,1,12,2,0,2,1,2,0.44,0.4394,0.88,0.2239,2,5,7,7,True
17049,2012-12-18,4,1,12,3,0,2,1,1,0.42,0.4242,0.88,0.194,0,5,5,5,True
17050,2012-12-18,4,1,12,4,0,2,1,1,0.42,0.4242,0.82,0.1642,3,5,8,8,True
17051,2012-12-18,4,1,12,5,0,2,1,1,0.38,0.3939,0.87,0.0896,0,36,36,36,True
17052,2012-12-18,4,1,12,6,0,2,1,1,0.36,0.3485,0.93,0.1642,1,117,118,118,True
17053,2012-12-18,4,1,12,7,0,2,1,1,0.36,0.3485,0.93,0.1343,4,351,355,355,True
17054,2012-12-18,4,1,12,8,0,2,1,1,0.38,0.3939,0.94,0.0,10,499,509,509,True
17055,2012-12-18,4,1,12,9,0,2,1,1,0.4,0.4091,0.87,0.0896,19,307,326,326,True
17056,2012-12-18,4,1,12,10,0,2,1,1,0.44,0.4394,0.77,0.0896,22,162,184,184,True
17057,2012-12-18,4,1,12,11,0,2,1,1,0.48,0.4697,0.63,0.2239,58,211,269,269,True
17058,2012-12-18,4,1,12,12,0,2,1,3,0.48,0.4697,0.48,0.2537,49,264,313,313,True
17059,2012-12-18,4,1,12,13,0,2,1,1,0.5,0.4848,0.42,0.2836,51,235,286,286,True
17060,2012-12-18,4,1,12,14,0,2,1,1,0.46,0.4545,0.47,0.4478,56,191,247,247,True
17061,2012-12-18,4,1,12,15,0,2,1,1,0.46,0.4545,0.44,0.4775,28,218,246,246,True
17062,2012-12-18,4,1,12,16,0,2,1,1,0.44,0.4394,0.41,0.4627,40,323,363,363,True
17063,2012-12-18,4,1,12,17,0,2,1,1,0.4,0.4091,0.47,0.4478,39,499,538,538,True
17064,2012-12-18,4,1,12,18,0,2,1,1,0.38,0.3939,0.46,0.3284,13,499,512,512,True
17065,2012-12-18,4,1,12,19,0,2,1,1,0.38,0.3939,0.46,0.3881,19,334,353,353,True
17066,2012-12-18,4,1,12,20,0,2,1,1,0.36,0.3333,0.5,0.2537,4,264,268,268,True
17067,2012-12-18,4,1,12,21,0,2,1,1,0.36,0.3485,0.5,0.2239,9,159,168,168,True
17068,2012-12-18,4,1,12,22,0,2,1,1,0.34,0.3333,0.49,0.0,5,127,132,132,True
17069,2012-12-18,4,1,12,23,0,2,1,1,0.34,0.3485,0.49,0.0896,1,80,81,81,True
17070,2012-12-19,4,1,12,0,0,3,1,1,0.3,0.3182,0.61,0.0,6,35,41,41,True
17071,2012-12-19,4,1,12,1,0,3,1,1,0.3,0.3182,0.65,0.0896,1,14,15,15,True
17072,2012-12-19,4,1,12,2,0,3,1,1,0.28,0.303,0.65,0.0896,1,2,3,3,True
17073,2012-12-19,4,1,12,3,0,3,1,1,0.26,0.2727,0.75,0.1343,0,5,5,5,True
17074,2012-12-19,4,1,12,4,0,3,1,1,0.24,0.2424,0.75,0.1343,1,6,7,7,True
17075,2012-12-19,4,1,12,5,0,3,1,1,0.26,0.2879,0.75,0.0896,2,29,31,31,True
17076,2012-12-19,4,1,12,6,0,3,1,1,0.24,0.2576,0.75,0.0896,3,109,112,112,True
17077,2012-12-19,4,1,12,7,0,3,1,1,0.26,0.2727,0.75,0.1343,3,360,363,363,True
17078,2012-12-19,4,1,12,8,0,3,1,1,0.24,0.2576,0.87,0.1045,13,499,512,512,True
17079,2012-12-19,4,1,12,9,0,3,1,1,0.28,0.2879,0.75,0.1045,8,309,317,317,True
17080,2012-12-19,4,1,12,10,0,3,1,1,0.32,0.3333,0.7,0.1045,17,147,164,164,True
17081,2012-12-19,4,1,12,11,0,3,1,1,0.4,0.4091,0.54,0.2239,31,169,200,200,True
17082,2012-12-19,4,1,12,12,0,3,1,1,0.4,0.4091,0.54,0.2836,33,203,236,236,True
17083,2012-12-19,4,1,12,13,0,3,1,1,0.42,0.4242,0.5,0.194,30,183,213,213,True
17084,2012-12-19,4,1,12,14,0,3,1,1,0.42,0.4242,0.5,0.194,33,185,218,218,True
17085,2012-12-19,4,1,12,15,0,3,1,1,0.42,0.4242,0.5,0.2836,28,209,237,237,True
17086,2012-12-19,4,1,12,16,0,3,1,1,0.42,0.4242,0.5,0.3582,37,297,334,334,True
17087,2012-12-19,4,1,12,17,0,3,1,1,0.4,0.4091,0.5,0.3881,26,499,525,525,True
17088,2012-12-19,4,1,12,18,0,3,1,1,0.38,0.3939,0.5,0.3582,23,499,522,522,True
17089,2012-12-19,4,1,12,19,0,3,1,1,0.38,0.3939,0.5,0.3881,7,329,336,336,True
17090,2012-12-19,4,1,12,20,0,3,1,1,0.36,0.3485,0.57,0.2239,10,231,241,241,True
17091,2012-12-19,4,1,12,21,0,3,1,1,0.34,0.3182,0.61,0.2239,4,164,168,168,True
17092,2012-12-19,4,1,12,22,0,3,1,1,0.34,0.3485,0.61,0.0896,12,117,129,129,True
17093,2012-12-19,4,1,12,23,0,3,1,1,0.32,0.3333,0.66,0.1343,4,84,88,88,True
17094,2012-12-20,4,1,12,0,0,4,1,1,0.32,0.3333,0.61,0.1343,2,40,42,42,True
17095,2012-12-20,4,1,12,1,0,4,1,1,0.32,0.3485,0.66,0.0,1,19,20,20,True
17096,2012-12-20,4,1,12,2,0,4,1,1,0.32,0.3485,0.66,0.0,2,6,8,8,True
17097,2012-12-20,4,1,12,3,0,4,1,2,0.3,0.3182,0.7,0.0896,1,3,4,4,True
17098,2012-12-20,4,1,12,4,0,4,1,2,0.3,0.3182,0.7,0.0896,0,6,6,6,True
17099,2012-12-20,4,1,12,5,0,4,1,2,0.3,0.3182,0.7,0.1045,0,35,35,35,True
17100,2012-12-20,4,1,12,6,0,4,1,2,0.3,0.3333,0.65,0.0,4,114,118,118,True
17101,2012-12-20,4,1,12,7,0,4,1,2,0.3,0.3333,0.7,0.0,4,346,350,350,True
17102,2012-12-20,4,1,12,8,0,4,1,2,0.3,0.3333,0.7,0.0,14,499,513,513,True
17103,2012-12-20,4,1,12,9,0,4,1,2,0.3,0.3333,0.7,0.0,14,303,317,317,True
17104,2012-12-20,4,1,12,10,0,4,1,2,0.32,0.3333,0.66,0.0,23,138,161,161,True
17105,2012-12-20,4,1,12,11,0,4,1,2,0.34,0.3182,0.57,0.2239,22,168,190,190,True
17106,2012-12-20,4,1,12,12,0,4,1,2,0.36,0.3485,0.53,0.1642,31,181,212,212,True
17107,2012-12-20,4,1,12,13,0,4,1,2,0.36,0.3485,0.57,0.194,46,171,217,217,True
17108,2012-12-20,4,1,12,14,0,4,1,2,0.36,0.3485,0.53,0.194,43,171,214,214,True
17109,2012-12-20,4,1,12,15,0,4,1,2,0.34,0.3333,0.57,0.194,33,216,249,249,True
17110,2012-12-20,4,1,12,16,0,4,1,2,0.34,0.303,0.53,0.3284,21,281,302,302,True
17111,2012-12-20,4,1,12,17,0,4,1,2,0.34,0.3333,0.66,0.194,25,450,475,475,True
17112,2012-12-20,4,1,12,18,0,4,1,2,0.34,0.3333,0.71,0.194,22,359,381,381,True
17113,2012-12-20,4,1,12,19,0,4,1,3,0.34,0.3182,0.71,0.2537,3,115,118,118,True
17114,2012-12-20,4,1,12,20,0,4,1,3,0.34,0.3333,0.76,0.1642,1,49,50,50,True
17115,2012-12-20,4,1,12,21,0,4,1,3,0.34,0.3333,0.76,0.1642,1,25,26,26,True
17116,2012-12-20,4,1,12,22,0,4,1,3,0.34,0.3333,0.87,0.194,1,20,21,21,True
17117,2012-12-20,4,1,12,23,0,4,1,3,0.4,0.4091,0.82,0.2985,0,13,13,13,True
17118,2012-12-21,1,1,12,0,0,5,1,3,0.42,0.4242,0.88,0.2985,0,17,17,17,True
17119,2012-12-21,1,1,12,1,0,5,1,3,0.44,0.4394,0.88,0.3881,2,7,9,9,True
17120,2012-12-21,1,1,12,2,0,5,1,3,0.46,0.4545,0.94,0.3881,0,3,3,3,True
17121,2012-12-21,1,1,12,3,0,5,1,3,0.46,0.4545,0.94,0.3881,0,3,3,3,True
17122,2012-12-21,1,1,12,4,0,5,1,2,0.36,0.3182,0.71,0.4775,1,5,6,6,True
17123,2012-12-21,1,1,12,5,0,5,1,2,0.34,0.303,0.76,0.4179,0,13,13,13,True
17124,2012-12-21,1,1,12,6,0,5,1,2,0.34,0.2879,0.57,0.4775,4,76,80,80,True
17125,2012-12-21,1,1,12,7,0,5,1,2,0.32,0.3182,0.57,0.194,3,205,208,208,True
17126,2012-12-21,1,1,12,8,0,5,1,2,0.32,0.303,0.57,0.2836,8,464,472,472,True
17127,2012-12-21,1,1,12,9,0,5,1,2,0.32,0.2727,0.45,0.4775,2,265,267,267,True
17128,2012-12-21,1,1,12,10,0,5,1,1,0.32,0.2879,0.42,0.4627,8,146,154,154,True
17129,2012-12-21,1,1,12,11,0,5,1,2,0.32,0.2879,0.42,0.4179,12,150,162,162,True
17130,2012-12-21,1,1,12,12,0,5,1,2,0.32,0.2879,0.39,0.3582,25,199,224,224,True
17131,2012-12-21,1,1,12,13,0,5,1,2,0.32,0.2879,0.39,0.4179,26,214,240,240,True
17132,2012-12-21,1,1,12,14,0,5,1,2,0.32,0.2879,0.39,0.4478,20,199,219,219,True
17133,2012-12-21,1,1,12,15,0,5,1,2,0.3,0.2727,0.42,0.3881,29,234,263,263,True
17134,2012-12-21,1,1,12,16,0,5,1,2,0.3,0.2727,0.39,0.3284,28,253,281,281,True
17135,2012-12-21,1,1,12,17,0,5,1,2,0.26,0.2273,0.56,0.3284,24,297,321,321,True
17136,2012-12-21,1,1,12,18,0,5,1,2,0.26,0.2273,0.56,0.2985,7,236,243,243,True
17137,2012-12-21,1,1,12,19,0,5,1,1,0.28,0.2576,0.45,0.2985,5,148,153,153,True
17138,2012-12-21,1,1,12,20,0,5,1,1,0.28,0.2727,0.41,0.2537,8,104,112,112,True
17139,2012-12-21,1,1,12,21,0,5,1,1,0.26,0.2273,0.41,0.4179,2,68,70,70,True
17140,2012-12-21,1,1,12,22,0,5,1,1,0.26,0.2273,0.44,0.2985,6,57,63,63,True
17141,2012-12-21,1,1,12,23,0,5,1,1,0.26,0.2424,0.44,0.2836,1,39,40,40,True
17142,2012-12-22,1,1,12,0,0,6,0,1,0.26,0.2121,0.44,0.4775,1,30,31,31,True
17143,2012-12-22,1,1,12,1,0,6,0,1,0.26,0.2121,0.44,0.4478,1,34,35,35,True
17144,2012-12-22,1,1,12,2,0,6,0,1,0.26,0.2121,0.44,0.4775,0,23,23,23,True
17145,2012-12-22,1,1,12,3,0,6,0,1,0.26,0.2121,0.48,0.4478,0,7,7,7,True
17146,2012-12-22,1,1,12,4,0,6,0,1,0.26,0.2576,0.48,0.194,3,2,5,5,True
17147,2012-12-22,1,1,12,5,0,6,0,1,0.26,0.2273,0.48,0.4179,0,5,5,5,True
17148,2012-12-22,1,1,12,6,0,6,0,1,0.26,0.2273,0.44,0.4179,0,13,13,13,True
17149,2012-12-22,1,1,12,7,0,6,0,1,0.26,0.2273,0.44,0.4179,2,18,20,20,True
17150,2012-12-22,1,1,12,8,0,6,0,1,0.26,0.2121,0.44,0.4775,0,29,29,29,True
17151,2012-12-22,1,1,12,9,0,6,0,1,0.26,0.2273,0.48,0.3881,13,77,90,90,True
17152,2012-12-22,1,1,12,10,0,6,0,1,0.26,0.2273,0.48,0.3284,13,105,118,118,True
17153,2012-12-22,1,1,12,11,0,6,0,1,0.28,0.2576,0.41,0.3582,29,130,159,159,True
17154,2012-12-22,1,1,12,12,0,6,0,1,0.3,0.2576,0.36,0.4775,18,128,146,146,True
17155,2012-12-22,1,1,12,13,0,6,0,1,0.32,0.2879,0.36,0.4478,23,135,158,158,True
17156,2012-12-22,1,1,12,14,0,6,0,1,0.32,0.2879,0.36,0.4627,20,141,161,161,True
17157,2012-12-22,1,1,12,15,0,6,0,1,0.32,0.2727,0.33,0.4775,14,139,153,153,True
17158,2012-12-22,1,1,12,16,0,6,0,1,0.3,0.2727,0.39,0.4478,23,124,147,147,True
17159,2012-12-22,1,1,12,17,0,6,0,1,0.28,0.2576,0.41,0.2985,15,99,114,114,True
17160,2012-12-22,1,1,12,18,0,6,0,1,0.26,0.2121,0.44,0.4627,7,75,82,82,True
17161,2012-12-22,1,1,12,19,0,6,0,1,0.24,0.2121,0.48,0.3582,9,51,60,60,True
17162,2012-12-22,1,1,12,20,0,6,0,1,0.24,0.2424,0.48,0.1642,6,55,61,61,True
17163,2012-12-22,1,1,12,21,0,6,0,1,0.22,0.2121,0.51,0.2836,4,49,53,53,True
17164,2012-12-22,1,1,12,22,0,6,0,1,0.22,0.2121,0.51,0.2836,1,38,39,39,True
17165,2012-12-22,1,1,12,23,0,6,0,1,0.22,0.2273,0.51,0.194,3,37,40,40,True
17166,2012-12-23,1,1,12,0,0,0,0,1,0.22,0.2121,0.47,0.2836,3,24,27,27,True
17167,2012-12-23,1,1,12,1,0,0,0,1,0.22,0.2273,0.47,0.194,1,19,20,20,True
17168,2012-12-23,1,1,12,2,0,0,0,1,0.2,0.2121,0.51,0.1642,1,17,18,18,True
17169,2012-12-23,1,1,12,3,0,0,0,1,0.2,0.2121,0.51,0.1343,0,9,9,9,True
17170,2012-12-23,1,1,12,4,0,0,0,1,0.2,0.2121,0.47,0.1343,1,3,4,4,True
17171,2012-12-23,1,1,12,5,0,0,0,1,0.2,0.2576,0.51,0.0,0,6,6,6,True
17172,2012-12-23,1,1,12,6,0,0,0,1,0.16,0.197,0.64,0.0896,4,5,9,9,True
17173,2012-12-23,1,1,12,7,0,0,0,1,0.16,0.197,0.64,0.0896,3,16,19,19,True
17174,2012-12-23,1,1,12,8,0,0,0,1,0.14,0.1667,0.69,0.1045,5,43,48,48,True
17175,2012-12-23,1,1,12,9,0,0,0,1,0.2,0.2273,0.59,0.1045,7,49,56,56,True
17176,2012-12-23,1,1,12,10,0,0,0,1,0.22,0.2273,0.64,0.194,26,67,93,93,True
17177,2012-12-23,1,1,12,11,0,0,0,1,0.24,0.2273,0.52,0.194,48,104,152,152,True
17178,2012-12-23,1,1,12,12,0,0,0,1,0.3,0.2879,0.42,0.194,52,144,196,196,True
17179,2012-12-23,1,1,12,13,0,0,0,1,0.32,0.303,0.39,0.2239,63,123,186,186,True
17180,2012-12-23,1,1,12,14,0,0,0,1,0.34,0.303,0.31,0.2985,57,118,175,175,True
17181,2012-12-23,1,1,12,15,0,0,0,1,0.34,0.3333,0.34,0.1343,39,98,137,137,True
17182,2012-12-23,1,1,12,16,0,0,0,1,0.34,0.3333,0.34,0.194,53,137,190,190,True
17183,2012-12-23,1,1,12,17,0,0,0,1,0.32,0.3182,0.49,0.194,21,93,114,114,True
17184,2012-12-23,1,1,12,18,0,0,0,1,0.3,0.303,0.45,0.1642,8,85,93,93,True
17185,2012-12-23,1,1,12,19,0,0,0,1,0.3,0.3333,0.42,0.0,4,54,58,58,True
17186,2012-12-23,1,1,12,20,0,0,0,1,0.26,0.303,0.65,0.0,0,52,52,52,True
17187,2012-12-23,1,1,12,21,0,0,0,1,0.24,0.2879,0.7,0.0,4,38,42,42,True
17188,2012-12-23,1,1,12,22,0,0,0,1,0.24,0.2576,0.6,0.1045,5,53,58,58,True
17189,2012-12-23,1,1,12,23,0,0,0,1,0.24,0.2879,0.6,0.0,3,22,25,25,True
17190,2012-12-24,1,1,12,0,0,1,1,1,0.22,0.2727,0.69,0.0,0,12,12,12,True
17191,2012-12-24,1,1,12,1,0,1,1,1,0.22,0.2727,0.69,0.0,0,11,11,11,True
17192,2012-12-24,1,1,12,2,0,1,1,1,0.2,0.2576,0.75,0.0,0,5,5,5,True
17193,2012-12-24,1,1,12,3,0,1,1,1,0.2,0.2576,0.75,0.0,1,2,3,3,True
17194,2012-12-24,1,1,12,5,0,1,1,1,0.18,0.197,0.8,0.1343,0,9,9,9,True
17195,2012-12-24,1,1,12,6,0,1,1,1,0.2,0.2576,0.75,0.0,1,16,17,17,True
17196,2012-12-24,1,1,12,7,0,1,1,1,0.2,0.2576,0.69,0.0,3,27,30,30,True
17197,2012-12-24,1,1,12,8,0,1,1,1,0.22,0.2727,0.69,0.0,4,62,66,66,True
17198,2012-12-24,1,1,12,9,0,1,1,2,0.24,0.2576,0.65,0.1045,17,68,85,85,True
17199,2012-12-24,1,1,12,10,0,1,1,2,0.26,0.303,0.65,0.0,21,82,103,103,True
17200,2012-12-24,1,1,12,11,0,1,1,2,0.26,0.2576,0.6,0.1642,20,104,124,124,True
17201,2012-12-24,1,1,12,12,0,1,1,2,0.28,0.303,0.56,0.0896,22,113,135,135,True
17202,2012-12-24,1,1,12,13,0,1,1,3,0.24,0.2576,0.81,0.1045,16,54,70,70,True
17203,2012-12-24,1,1,12,14,0,1,1,3,0.24,0.2576,0.87,0.1045,13,33,46,46,True
17204,2012-12-24,1,1,12,15,0,1,1,3,0.24,0.2273,0.87,0.2239,6,27,33,33,True
17205,2012-12-24,1,1,12,16,0,1,1,3,0.24,0.2273,0.87,0.2239,6,27,33,33,True
17206,2012-12-24,1,1,12,17,0,1,1,3,0.24,0.2424,0.93,0.1642,7,19,26,26,True
17207,2012-12-24,1,1,12,18,0,1,1,3,0.24,0.2576,0.93,0.1045,6,20,26,26,True
17208,2012-12-24,1,1,12,19,0,1,1,2,0.24,0.2424,0.93,0.1343,4,14,18,18,True
17209,2012-12-24,1,1,12,20,0,1,1,3,0.24,0.2424,0.93,0.1343,6,17,23,23,True
17210,2012-12-24,1,1,12,21,0,1,1,3,0.24,0.2576,0.93,0.0896,13,9,22,22,True
17211,2012-12-24,1,1,12,22,0,1,1,2,0.24,0.2879,0.93,0.0,7,5,12,12,True
17212,2012-12-24,1,1,12,23,0,1,1,3,0.24,0.2879,0.93,0.0,1,10,11,11,True
17213,2012-12-25,1,1,12,0,1,2,0,3,0.24,0.2576,0.93,0.0896,3,10,13,13,True
17214,2012-12-25,1,1,12,1,1,2,0,2,0.26,0.2576,0.87,0.1642,0,13,13,13,True
17215,2012-12-25,1,1,12,2,1,2,0,2,0.26,0.2576,0.87,0.1642,0,7,7,7,True
17216,2012-12-25,1,1,12,4,1,2,0,2,0.24,0.2576,0.87,0.0896,0,1,1,1,True
17217,2012-12-25,1,1,12,5,1,2,0,2,0.22,0.2273,0.93,0.1343,2,1,3,3,True
17218,2012-12-25,1,1,12,6,1,2,0,2,0.22,0.2273,0.93,0.1343,1,6,7,7,True
17219,2012-12-25,1,1,12,7,1,2,0,2,0.22,0.2273,0.93,0.1642,0,6,6,6,True
17220,2012-12-25,1,1,12,8,1,2,0,2,0.24,0.2879,0.87,0.0,1,10,11,11,True
17221,2012-12-25,1,1,12,9,1,2,0,2,0.24,0.2576,0.87,0.0,7,21,28,28,True
17222,2012-12-25,1,1,12,10,1,2,0,1,0.28,0.3182,0.81,0.0,11,21,32,32,True
17223,2012-12-25,1,1,12,11,1,2,0,1,0.3,0.3182,0.75,0.0896,43,43,86,86,True
17224,2012-12-25,1,1,12,12,1,2,0,1,0.32,0.3333,0.76,0.0896,62,52,114,114,True
17225,2012-12-25,1,1,12,13,1,2,0,1,0.4,0.4091,0.5,0.3284,75,46,121,121,True
17226,2012-12-25,1,1,12,14,1,2,0,1,0.38,0.3939,0.46,0.2985,58,68,126,126,True
17227,2012-12-25,1,1,12,15,1,2,0,1,0.36,0.3333,0.5,0.2537,51,56,107,107,True
17228,2012-12-25,1,1,12,16,1,2,0,2,0.36,0.3333,0.5,0.2537,48,38,86,86,True
17229,2012-12-25,1,1,12,17,1,2,0,2,0.32,0.303,0.57,0.2537,16,34,50,50,True
17230,2012-12-25,1,1,12,18,1,2,0,2,0.32,0.303,0.66,0.2537,20,23,43,43,True
17231,2012-12-25,1,1,12,19,1,2,0,2,0.32,0.303,0.66,0.2239,16,20,36,36,True
17232,2012-12-25,1,1,12,20,1,2,0,2,0.32,0.303,0.66,0.2836,11,29,40,40,True
17233,2012-12-25,1,1,12,21,1,2,0,2,0.3,0.2879,0.65,0.194,8,26,34,34,True
17234,2012-12-25,1,1,12,22,1,2,0,2,0.3,0.303,0.7,0.1642,3,16,19,19,True
17235,2012-12-25,1,1,12,23,1,2,0,2,0.28,0.2727,0.65,0.2537,4,26,30,30,True
17236,2012-12-26,1,1,12,0,0,3,1,2,0.28,0.2727,0.65,0.2537,1,8,9,9,True
17237,2012-12-26,1,1,12,1,0,3,1,2,0.26,0.2273,0.65,0.2985,0,7,7,7,True
17238,2012-12-26,1,1,12,2,0,3,1,2,0.26,0.2273,0.65,0.2985,0,1,1,1,True
17239,2012-12-26,1,1,12,3,0,3,1,2,0.24,0.2121,0.7,0.3582,0,2,2,2,True
17240,2012-12-26,1,1,12,4,0,3,1,1,0.22,0.197,0.69,0.3582,0,2,2,2,True
17241,2012-12-26,1,1,12,5,0,3,1,2,0.22,0.2121,0.69,0.2836,0,11,11,11,True
17242,2012-12-26,1,1,12,6,0,3,1,2,0.22,0.2121,0.69,0.2239,0,36,36,36,True
17243,2012-12-26,1,1,12,7,0,3,1,3,0.2,0.1818,0.86,0.3284,0,26,26,26,True
17244,2012-12-26,1,1,12,8,0,3,1,3,0.2,0.1818,0.86,0.3284,0,31,31,31,True
17245,2012-12-26,1,1,12,9,0,3,1,3,0.2,0.1818,0.86,0.3284,1,22,23,23,True
17246,2012-12-26,1,1,12,10,0,3,1,3,0.2,0.1818,0.86,0.2985,0,8,8,8,True
17247,2012-12-26,1,1,12,11,0,3,1,3,0.2,0.1667,0.86,0.4627,0,10,10,10,True
17248,2012-12-26,1,1,12,12,0,3,1,3,0.22,0.197,0.87,0.3284,0,10,10,10,True
17249,2012-12-26,1,1,12,13,0,3,1,3,0.22,0.197,0.87,0.3284,0,15,15,15,True
17250,2012-12-26,1,1,12,14,0,3,1,3,0.22,0.2121,0.93,0.2537,0,20,20,20,True
17251,2012-12-26,1,1,12,15,0,3,1,3,0.26,0.2273,0.87,0.3582,0,13,13,13,True
17252,2012-12-26,1,1,12,16,0,3,1,3,0.26,0.2273,0.87,0.3582,0,13,13,13,True
17253,2012-12-26,1,1,12,17,0,3,1,3,0.26,0.2273,0.93,0.3582,2,51,53,53,True
17254,2012-12-26,1,1,12,18,0,3,1,3,0.28,0.2576,0.93,0.2985,1,42,43,43,True
17255,2012-12-26,1,1,12,19,0,3,1,3,0.3,0.2879,0.87,0.194,2,33,35,35,True
17256,2012-12-26,1,1,12,20,0,3,1,3,0.32,0.303,0.93,0.2537,0,32,32,32,True
17257,2012-12-26,1,1,12,21,0,3,1,2,0.3,0.2727,0.87,0.2985,0,20,20,20,True
17258,2012-12-26,1,1,12,22,0,3,1,3,0.24,0.197,0.93,0.4478,0,11,11,11,True
17259,2012-12-26,1,1,12,23,0,3,1,3,0.26,0.2273,0.87,0.2985,2,8,10,10,True
17260,2012-12-27,1,1,12,0,0,4,1,3,0.26,0.2273,0.87,0.2985,0,3,3,3,True
17261,2012-12-27,1,1,12,1,0,4,1,3,0.24,0.197,0.93,0.4478,0,5,5,5,True
17262,2012-12-27,1,1,12,2,0,4,1,2,0.24,0.197,0.87,0.4478,0,2,2,2,True
17263,2012-12-27,1,1,12,3,0,4,1,2,0.24,0.2273,0.87,0.2239,0,1,1,1,True
17264,2012-12-27,1,1,12,4,0,4,1,2,0.24,0.2121,0.87,0.3284,0,3,3,3,True
17265,2012-12-27,1,1,12,5,0,4,1,1,0.24,0.2424,0.75,0.1642,1,10,11,11,True
17266,2012-12-27,1,1,12,6,0,4,1,1,0.24,0.197,0.7,0.4775,0,45,45,45,True
17267,2012-12-27,1,1,12,7,0,4,1,1,0.24,0.2273,0.7,0.2239,0,90,90,90,True
17268,2012-12-27,1,1,12,8,0,4,1,1,0.26,0.2273,0.65,0.3582,2,206,208,208,True
17269,2012-12-27,1,1,12,9,0,4,1,1,0.26,0.2121,0.6,0.4775,6,127,133,133,True
17270,2012-12-27,1,1,12,10,0,4,1,1,0.28,0.2273,0.56,0.4775,8,67,75,75,True
17271,2012-12-27,1,1,12,11,0,4,1,2,0.28,0.2424,0.56,0.4478,23,80,103,103,True
17272,2012-12-27,1,1,12,12,0,4,1,1,0.3,0.2727,0.49,0.4627,22,87,109,109,True
17273,2012-12-27,1,1,12,13,0,4,1,1,0.3,0.2727,0.49,0.4627,19,99,118,118,True
17274,2012-12-27,1,1,12,14,0,4,1,2,0.26,0.2121,0.56,0.4775,25,94,119,119,True
17275,2012-12-27,1,1,12,15,0,4,1,2,0.26,0.2121,0.56,0.4478,31,89,120,120,True
17276,2012-12-27,1,1,12,16,0,4,1,2,0.26,0.2424,0.52,0.2836,23,151,174,174,True
17277,2012-12-27,1,1,12,17,0,4,1,2,0.26,0.2424,0.52,0.2836,30,227,257,257,True
17278,2012-12-27,1,1,12,18,0,4,1,2,0.24,0.2273,0.6,0.2537,9,188,197,197,True
17279,2012-12-27,1,1,12,19,0,4,1,1,0.24,0.2121,0.6,0.2836,11,106,117,117,True
17280,2012-12-27,1,1,12,20,0,4,1,1,0.24,0.2424,0.6,0.1642,12,79,91,91,True
17281,2012-12-27,1,1,12,21,0,4,1,2,0.24,0.2273,0.6,0.2537,12,51,63,63,True
17282,2012-12-27,1,1,12,22,0,4,1,2,0.24,0.2121,0.6,0.2836,11,33,44,44,True
17283,2012-12-27,1,1,12,23,0,4,1,2,0.24,0.2273,0.6,0.2537,2,24,26,26,True
17284,2012-12-28,1,1,12,0,0,5,1,2,0.24,0.2424,0.6,0.1642,3,22,25,25,True
17285,2012-12-28,1,1,12,1,0,5,1,1,0.24,0.2273,0.6,0.194,0,9,9,9,True
17286,2012-12-28,1,1,12,2,0,5,1,1,0.24,0.2273,0.6,0.2537,0,5,5,5,True
17287,2012-12-28,1,1,12,3,0,5,1,2,0.24,0.2424,0.6,0.1642,0,2,2,2,True
17288,2012-12-28,1,1,12,4,0,5,1,2,0.24,0.2576,0.6,0.1045,0,4,4,4,True
17289,2012-12-28,1,1,12,5,0,5,1,2,0.24,0.2576,0.6,0.0896,0,15,15,15,True
17290,2012-12-28,1,1,12,6,0,5,1,1,0.22,0.2121,0.64,0.2836,2,49,51,51,True
17291,2012-12-28,1,1,12,7,0,5,1,1,0.22,0.2273,0.64,0.1642,1,111,112,112,True
17292,2012-12-28,1,1,12,8,0,5,1,2,0.24,0.2424,0.6,0.1343,1,238,239,239,True
17293,2012-12-28,1,1,12,9,0,5,1,2,0.24,0.2121,0.6,0.2836,18,173,191,191,True
17294,2012-12-28,1,1,12,10,0,5,1,2,0.26,0.2424,0.56,0.2537,77,85,162,162,True
17295,2012-12-28,1,1,12,11,0,5,1,2,0.28,0.2727,0.52,0.2239,71,107,178,178,True
17296,2012-12-28,1,1,12,12,0,5,1,2,0.3,0.303,0.49,0.1343,72,150,222,222,True
17297,2012-12-28,1,1,12,13,0,5,1,2,0.3,0.303,0.49,0.1343,76,146,222,222,True
17298,2012-12-28,1,1,12,14,0,5,1,2,0.3,0.303,0.49,0.1343,84,177,261,261,True
17299,2012-12-28,1,1,12,15,0,5,1,2,0.3,0.3182,0.49,0.0,74,151,225,225,True
17300,2012-12-28,1,1,12,16,0,5,1,1,0.3,0.303,0.49,0.1343,42,208,250,250,True
17301,2012-12-28,1,1,12,17,0,5,1,1,0.24,0.2424,0.6,0.1343,43,228,271,271,True
17302,2012-12-28,1,1,12,18,0,5,1,1,0.24,0.2424,0.6,0.1343,16,197,213,213,True
17303,2012-12-28,1,1,12,19,0,5,1,2,0.24,0.2273,0.65,0.194,15,113,128,128,True
17304,2012-12-28,1,1,12,20,0,5,1,2,0.24,0.2576,0.65,0.1045,14,83,97,97,True
17305,2012-12-28,1,1,12,21,0,5,1,2,0.24,0.2424,0.7,0.1343,17,75,92,92,True
17306,2012-12-28,1,1,12,22,0,5,1,2,0.24,0.2576,0.7,0.0896,13,49,62,62,True
17307,2012-12-28,1,1,12,23,0,5,1,2,0.24,0.2576,0.65,0.0896,5,54,59,59,True
17308,2012-12-29,1,1,12,0,0,6,0,2,0.24,0.2424,0.7,0.0,1,25,26,26,True
17309,2012-12-29,1,1,12,1,0,6,0,2,0.24,0.2424,0.75,0.0896,6,31,37,37,True
17310,2012-12-29,1,1,12,2,0,6,0,2,0.24,0.2424,0.7,0.0,1,18,19,19,True
17311,2012-12-29,1,1,12,3,0,6,0,2,0.24,0.2424,0.75,0.0,1,5,6,6,True
17312,2012-12-29,1,1,12,4,0,6,0,2,0.24,0.2424,0.75,0.0896,0,3,3,3,True
17313,2012-12-29,1,1,12,5,0,6,0,2,0.24,0.2424,0.75,0.0896,0,3,3,3,True
17314,2012-12-29,1,1,12,6,0,6,0,2,0.26,0.2424,0.7,0.1045,0,7,7,7,True
17315,2012-12-29,1,1,12,7,0,6,0,2,0.26,0.2424,0.7,0.1343,1,17,18,18,True
17316,2012-12-29,1,1,12,8,0,6,0,2,0.26,0.2424,0.81,0.0,9,35,44,44,True
17317,2012-12-29,1,1,12,9,0,6,0,2,0.26,0.2424,0.81,0.0,16,33,49,49,True
17318,2012-12-29,1,1,12,10,0,6,0,3,0.26,0.2424,0.81,0.1343,6,35,41,41,True
17319,2012-12-29,1,1,12,11,0,6,0,3,0.2,0.2424,0.93,0.0896,7,38,45,45,True
17320,2012-12-29,1,1,12,12,0,6,0,3,0.2,0.2424,1.0,0.0,5,43,48,48,True
17321,2012-12-29,1,1,12,13,0,6,0,3,0.2,0.2424,1.0,0.0,13,71,84,84,True
17322,2012-12-29,1,1,12,14,0,6,0,2,0.24,0.2424,0.87,0.0896,10,88,98,98,True
17323,2012-12-29,1,1,12,15,0,6,0,2,0.24,0.2424,0.87,0.0,19,110,129,129,True
17324,2012-12-29,1,1,12,16,0,6,0,1,0.3,0.2424,0.75,0.1045,22,125,147,147,True
17325,2012-12-29,1,1,12,17,0,6,0,1,0.26,0.2424,0.79,0.1045,18,100,118,118,True
17326,2012-12-29,1,1,12,18,0,6,0,1,0.3,0.2424,0.7,0.194,8,102,110,110,True
17327,2012-12-29,1,1,12,19,0,6,0,2,0.3,0.2424,0.61,0.2537,7,90,97,97,True
17328,2012-12-29,1,1,12,20,0,6,0,2,0.3,0.2424,0.56,0.4775,2,64,66,66,True
17329,2012-12-29,1,1,12,21,0,6,0,2,0.28,0.2424,0.56,0.4775,4,56,60,60,True
17330,2012-12-29,1,1,12,22,0,6,0,2,0.26,0.2424,0.6,0.4627,3,51,54,54,True
17331,2012-12-29,1,1,12,23,0,6,0,2,0.26,0.2424,0.6,0.0,0,32,32,32,True
17332,2012-12-30,1,1,12,0,0,0,0,2,0.26,0.2576,0.6,0.1642,0,41,41,41,True
17333,2012-12-30,1,1,12,1,0,0,0,2,0.26,0.2273,0.56,0.4179,1,27,28,28,True
17334,2012-12-30,1,1,12,2,0,0,0,2,0.26,0.2424,0.56,0.2836,0,19,19,19,True
17335,2012-12-30,1,1,12,3,0,0,0,2,0.26,0.2273,0.56,0.4179,1,14,15,15,True
17336,2012-12-30,1,1,12,4,0,0,0,2,0.26,0.2576,0.56,0.2239,0,7,7,7,True
17337,2012-12-30,1,1,12,5,0,0,0,2,0.26,0.2273,0.48,0.2985,0,2,2,2,True
17338,2012-12-30,1,1,12,6,0,0,0,2,0.24,0.197,0.52,0.4179,1,7,8,8,True
17339,2012-12-30,1,1,12,7,0,0,0,1,0.24,0.2121,0.56,0.3582,0,13,13,13,True
17340,2012-12-30,1,1,12,8,0,0,0,1,0.24,0.197,0.52,0.4627,1,32,33,33,True
17341,2012-12-30,1,1,12,9,0,0,0,1,0.24,0.2121,0.52,0.3881,9,65,74,74,True
17342,2012-12-30,1,1,12,10,0,0,0,1,0.26,0.2121,0.41,0.4775,31,91,122,122,True
17343,2012-12-30,1,1,12,11,0,0,0,1,0.26,0.2273,0.41,0.4179,33,103,136,136,True
17344,2012-12-30,1,1,12,12,0,0,0,1,0.28,0.2273,0.36,0.4775,47,97,144,144,True
17345,2012-12-30,1,1,12,13,0,0,0,1,0.3,0.2576,0.36,0.4775,49,120,169,169,True
17346,2012-12-30,1,1,12,14,0,0,0,1,0.3,0.2727,0.36,0.4627,39,121,160,160,True
17347,2012-12-30,1,1,12,15,0,0,0,1,0.28,0.2576,0.38,0.3284,37,101,138,138,True
17348,2012-12-30,1,1,12,16,0,0,0,1,0.28,0.2424,0.38,0.4179,31,102,133,133,True
17349,2012-12-30,1,1,12,17,0,0,0,1,0.26,0.2273,0.41,0.3284,26,97,123,123,True
17350,2012-12-30,1,1,12,18,0,0,0,2,0.24,0.2121,0.44,0.2985,12,113,125,125,True
17351,2012-12-30,1,1,12,19,0,0,0,1,0.34,0.3636,0.61,0.0,16,86,102,102,True
17352,2012-12-30,1,1,12,20,0,0,0,1,0.22,0.197,0.47,0.3284,9,63,72,72,True
17353,2012-12-30,1,1,12,21,0,0,0,1,0.2,0.2121,0.51,0.1642,5,42,47,47,True
17354,2012-12-30,1,1,12,22,0,0,0,1,0.2,0.197,0.55,0.194,6,30,36,36,True
17355,2012-12-30,1,1,12,23,0,0,0,1,0.2,0.197,0.51,0.2239,10,39,49,49,True
17356,2012-12-31,1,1,12,0,0,1,1,1,0.18,0.1818,0.55,0.194,4,30,34,34,True
17357,2012-12-31,1,1,12,1,0,1,1,1,0.18,0.1818,0.55,0.194,6,13,19,19,True
17358,2012-12-31,1,1,12,2,0,1,1,1,0.16,0.1667,0.59,0.1642,3,8,11,11,True
17359,2012-12-31,1,1,12,3,0,1,1,1,0.16,0.1818,0.59,0.1045,0,1,1,1,True
17360,2012-12-31,1,1,12,4,0,1,1,1,0.14,0.1667,0.69,0.1045,0,3,3,3,True
17361,2012-12-31,1,1,12,5,0,1,1,1,0.16,0.1515,0.64,0.194,0,9,9,9,True
17362,2012-12-31,1,1,12,6,0,1,1,1,0.16,0.1667,0.64,0.1642,0,40,40,40,True
17363,2012-12-31,1,1,12,7,0,1,1,1,0.16,0.1818,0.64,0.1343,2,83,85,85,True
17364,2012-12-31,1,1,12,8,0,1,1,1,0.14,0.1515,0.69,0.1343,9,187,196,196,True
17365,2012-12-31,1,1,12,9,0,1,1,2,0.18,0.2121,0.64,0.1045,13,144,157,157,True
17366,2012-12-31,1,1,12,10,0,1,1,2,0.2,0.2121,0.69,0.1343,33,87,120,120,True
17367,2012-12-31,1,1,12,11,0,1,1,2,0.22,0.2273,0.6,0.194,43,114,157,157,True
17368,2012-12-31,1,1,12,12,0,1,1,2,0.24,0.2273,0.56,0.194,52,172,224,224,True
17369,2012-12-31,1,1,12,13,0,1,1,2,0.26,0.2576,0.44,0.1642,38,165,203,203,True
17370,2012-12-31,1,1,12,14,0,1,1,2,0.28,0.2727,0.45,0.2239,62,185,247,247,True
17371,2012-12-31,1,1,12,15,0,1,1,2,0.28,0.2879,0.45,0.1343,69,246,315,315,True
17372,2012-12-31,1,1,12,16,0,1,1,2,0.26,0.2576,0.48,0.194,30,184,214,214,True
17373,2012-12-31,1,1,12,17,0,1,1,2,0.26,0.2879,0.48,0.0896,14,150,164,164,True
17374,2012-12-31,1,1,12,18,0,1,1,2,0.26,0.2727,0.48,0.1343,10,112,122,122,True
17375,2012-12-31,1,1,12,19,0,1,1,2,0.26,0.2576,0.6,0.1642,11,108,119,119,True
17376,2012-12-31,1,1,12,20,0,1,1,2,0.26,0.2576,0.6,0.1642,8,81,89,89,True
17377,2012-12-31,1,1,12,21,0,1,1,1,0.26,0.2576,0.6,0.1642,7,83,90,90,True
17378,2012-12-31,1,1,12,22,0,1,1,1,0.26,0.2727,0.56,0.1343,13,48,61,61,True
17379,2012-12-31,1,1,12,23,0,1,1,1,0.26,0.2727,0.65,0.1343,12,37,49,49,True
